Rank,Release Group,Worldwide,Domestic,Foreign,filename,year,Domestic %,Foreign %
1,Avengers: Endgame,2797501328,858373000,1939128328,2019.csv,2019,0.30683560054417247,0.6931643994558275
2,Star Wars: Episode VII - The Force Awakens,2068223624,936662225,1131561399,2015.csv,2015,0.4528824707980417,0.5471175292019583
3,Avengers: Infinity War,2048359754,678815482,1369544272,2018.csv,2018,0.3313946589091205,0.6686053410908794
4,Jurassic World,1670400637,652270625,1018130012,2015.csv,2015,0.39048753368022093,0.6095124663197791
5,The Lion King,1656943394,543638043,1113305351,2019.csv,2019,0.32809693135479556,0.6719030686452044
6,The Avengers,1518812988,623357910,895455078,2012.csv,2012,0.41042440045291473,0.5895755995470853
7,Furious 7,1515047671,353007020,1162040651,2015.csv,2015,0.23300060239490641,0.7669993976050936
8,Frozen II,1450026933,477373578,972653355,2019.csv,2019,0.329217042205105,0.6707829577948949
9,Avengers: Age of Ultron,1402805868,459005868,943800000,2015.csv,2015,0.3272055517235689,0.6727944482764311
10,Black Panther,1346913161,700059566,646853595,2018.csv,2018,0.5197510769589992,0.4802489230410007
11,Harry Potter and the Deathly Hallows: Part 2,1341511219,381011219,960500000,2011.csv,2011,0.2840164238686102,0.7159835761313897
12,Star Wars: Episode VIII - The Last Jedi,1332539889,620181382,712358507,2017.csv,2017,0.465412995978239,0.5345870040217611
13,Jurassic World: Fallen Kingdom,1308467944,417719760,890748184,2018.csv,2018,0.3192434036427567,0.6807565963572433
14,Frozen,1280802282,400738009,880064273,2013.csv,2013,0.31288046143565507,0.6871195385643449
15,Beauty and the Beast,1263521126,504014165,759506961,2017.csv,2017,0.3988965080430321,0.6011034919569679
16,Incredibles 2,1242805359,608581744,634223615,2018.csv,2018,0.48968387494698595,0.510316125053014
17,The Fate of the Furious,1236005118,226008385,1009996733,2017.csv,2017,0.1828539232634472,0.8171460767365528
18,Iron Man 3,1214811252,409013994,805797258,2013.csv,2013,0.33668933616363966,0.6633106638363603
19,Minions,1159398397,336045770,823352627,2015.csv,2015,0.28984494964762314,0.7101550503523768
20,Captain America: Civil War,1153296293,408084349,745211944,2016.csv,2016,0.35384172434862754,0.6461582756513724
21,Aquaman,1148461807,335061807,813400000,2018.csv,2018,0.2917483236776023,0.7082516763223977
22,Spider-Man: Far from Home,1131927996,390532085,741395911,2019.csv,2019,0.345014953583673,0.654985046416327
23,Captain Marvel,1128274794,426829839,701444955,2019.csv,2019,0.3783030882811692,0.6216969117188308
24,Transformers: Dark of the Moon,1123794079,352390543,771403536,2011.csv,2011,0.3135721655639725,0.6864278344360275
25,Skyfall,1108561013,304360277,804200736,2012.csv,2012,0.2745543758356943,0.7254456241643057
26,Transformers: Age of Extinction,1104054072,245439076,858614996,2014.csv,2014,0.22230711540729683,0.7776928845927031
27,The Dark Knight Rises,1081041287,448139099,632902188,2012.csv,2012,0.4145439257399981,0.5854560742600019
28,Joker,1074251311,335451311,738800000,2019.csv,2019,0.3122652097931673,0.6877347902068327
29,Star Wars: Episode IX - The Rise of Skywalker,1074144248,515202542,558941706,2019.csv,2019,0.4796399952420543,0.5203600047579457
30,Toy Story 4,1073394593,434038008,639356585,2019.csv,2019,0.4043601587249657,0.5956398412750342
31,Toy Story 3,1066969703,415004880,651964823,2010.csv,2010,0.3889565737744289,0.6110434262255711
32,Rogue One: A Star Wars Story,1056057273,532177324,523879949,2016.csv,2016,0.5039284682810948,0.49607153171890517
33,Aladdin,1050693953,355559216,695134737,2019.csv,2019,0.3384041708670612,0.6615958291329388
34,Pirates of the Caribbean: On Stranger Tides,1045713802,241071802,804642000,2011.csv,2011,0.23053325062644625,0.7694667493735537
35,Despicable Me 3,1034799409,264624300,770175109,2017.csv,2017,0.2557252136969475,0.7442747863030524
36,Finding Dory,1028570889,486295561,542275328,2016.csv,2016,0.47278759898871686,0.5272124010112832
37,Alice in Wonderland,1025467110,334191110,691276000,2010.csv,2010,0.32589159295416115,0.6741084070458389
38,Zootopia,1023784195,341268248,682515947,2016.csv,2016,0.3333400238709487,0.6666599761290513
39,The Hobbit: An Unexpected Journey,1017003568,303003568,714000000,2012.csv,2012,0.29793756633113405,0.7020624336688659
40,Harry Potter and the Deathly Hallows: Part 1,976536918,295983305,680553613,2010.csv,2010,0.30309484418283916,0.6969051558171608
41,Despicable Me 2,970766005,368065385,602700620,2013.csv,2013,0.3791494377679614,0.6208505622320386
42,The Jungle Book,966550600,364001123,602549477,2016.csv,2016,0.3765981036067848,0.6234018963932152
43,Jumanji: Welcome to the Jungle,962077546,404515480,557562066,2017.csv,2017,0.42046036900231326,0.5795396309976868
44,The Hobbit: The Desolation of Smaug,958366855,258366855,700000000,2013.csv,2013,0.2695907664711547,0.7304092335288452
45,The Hobbit: The Battle of the Five Armies,956019788,255119788,700900000,2014.csv,2014,0.26685617934092387,0.7331438206590761
46,Bohemian Rhapsody,903655259,216428042,687227217,2018.csv,2018,0.23950288546929155,0.7604971145307085
47,Spectre,880674609,200074609,680600000,2015.csv,2015,0.22718335121207064,0.7728166487879293
48,Spider-Man: Homecoming,880166924,334201140,545965784,2017.csv,2017,0.37970199843592395,0.620298001564076
49,Ice Age: Continental Drift,877244782,161321843,715922939,2012.csv,2012,0.18389604168657225,0.8161039583134277
50,The Secret Life of Pets,875457937,368384330,507073607,2016.csv,2016,0.42079043941548044,0.5792095605845196
51,Batman v Superman: Dawn of Justice,873634919,330360194,543274725,2016.csv,2016,0.3781444477724682,0.6218555522275317
52,Wolf Warrior 2,870325439,2721100,867604339,2017.csv,2017,0.003126531614572282,0.9968734683854277
53,The Hunger Games: Catching Fire,865011746,424668047,440343699,2013.csv,2013,0.490939052520103,0.5090609474798969
54,Guardians of the Galaxy Vol. 2,863756051,389813101,473942950,2017.csv,2017,0.4512999944240043,0.5487000055759956
55,Inside Out,857611174,356461711,501149463,2015.csv,2015,0.4156449004009829,0.5843550995990171
56,Venom,856085151,213515506,642569645,2018.csv,2018,0.24940919224050412,0.7505908077594958
57,Thor: Ragnarok,853977126,315058289,538918837,2017.csv,2017,0.36893059475225337,0.6310694052477467
58,The Twilight Saga: Breaking Dawn - Part 2,829746820,292324737,537422083,2012.csv,2012,0.35230594436023266,0.6476940556397673
59,Inception,826137188,292576195,533560993,2010.csv,2010,0.3541496488111125,0.6458503511888876
60,Wonder Woman,821847012,412563408,409283604,2017.csv,2017,0.501995385973369,0.49800461402663104
61,"Hi, Mom",821551072,0,821551072,2021.csv,2021,0.0,1.0
62,Fantastic Beasts and Where to Find Them,814037575,234037575,580000000,2016.csv,2016,0.287502177034027,0.7124978229659731
63,Coco,807816196,210460015,597356181,2017.csv,2017,0.2605295809147159,0.7394704190852841
64,Jumanji: The Next Level,800059707,320314960,479744747,2019.csv,2019,0.4003638193467978,0.5996361806532021
65,Pirates of the Caribbean: Dead Men Tell No Tales,794861794,172558876,622302918,2017.csv,2017,0.21709293024593404,0.782907069754066
66,Mission: Impossible - Fallout,791115104,220159104,570956000,2018.csv,2018,0.27828959766643513,0.7217104023335649
67,Fast & Furious 6,788679850,238679850,550000000,2013.csv,2013,0.30263211365169274,0.6973678863483073
68,Deadpool,782612155,363070709,419541446,2016.csv,2016,0.463921633059737,0.536078366940263
69,Guardians of the Galaxy,772776600,333176600,439600000,2014.csv,2014,0.4311421955581988,0.5688578044418011
70,Fast & Furious Presents: Hobbs & Shaw,759056935,173956935,585100000,2019.csv,2019,0.22917508157671992,0.77082491842328
71,Maleficent,758410378,241410378,517000000,2014.csv,2014,0.31831101604466705,0.681688983955333
72,The Amazing Spider-Man,757930663,262030663,495900000,2012.csv,2012,0.34571851462354675,0.6542814853764533
73,The Hunger Games: Mockingjay - Part 1,755356711,337135885,418220826,2014.csv,2014,0.44632672231596815,0.5536732776840319
74,Shrek Forever After,752600867,238736787,513864080,2010.csv,2010,0.31721566831519477,0.6827843316848052
75,Madagascar 3: Europe's Most Wanted,746921274,216391482,530529792,2012.csv,2012,0.2897112313338661,0.7102887686661339
76,Suicide Squad,746846894,325100054,421746840,2016.csv,2016,0.43529678788488074,0.5647032121151193
77,X-Men: Days of Future Past,746045700,233921534,512124166,2014.csv,2014,0.3135485319465014,0.6864514680534985
78,Monsters University,743559607,268492764,475066843,2013.csv,2013,0.3610911102114238,0.6389088897885762
79,Deadpool 2,734546611,318491426,416055185,2018.csv,2018,0.43358912998919275,0.5664108700108073
80,Ne Zha,726063471,3695533,722367938,2019.csv,2019,0.005089820859476899,0.9949101791405232
81,Gravity,723192705,274092705,449100000,2013.csv,2013,0.37900369169238235,0.6209963083076177
82,Captain America: The Winter Soldier,714421503,259766572,454654931,2014.csv,2014,0.3636040781376089,0.6363959218623911
83,The Twilight Saga: Breaking Dawn - Part 1,712205856,281287133,430918723,2011.csv,2011,0.394952008089077,0.6050479919109231
84,Dawn of the Planet of the Apes,710644566,208545589,502098977,2014.csv,2014,0.29345976734028806,0.7065402326597119
85,The Amazing Spider-Man 2,708982323,202853933,506128390,2014.csv,2014,0.28611987410580336,0.7138801258941967
86,It,700381748,327481748,372900000,2017.csv,2017,0.4675760739555994,0.5324239260444006
87,The Wandering Earth,699856699,5971413,693885286,2019.csv,2019,0.008532336703402763,0.9914676632965972
88,The Twilight Saga: Eclipse,698491347,300531751,397959596,2010.csv,2010,0.4302583736946422,0.5697416263053579
89,Mission: Impossible - Ghost Protocol,694713380,209397903,485315477,2011.csv,2011,0.3014162516921727,0.6985837483078273
90,The Hunger Games,694394724,408010692,286384032,2012.csv,2012,0.5875774655223331,0.4124225344776669
91,Detective Chinatown 3,686257563,0,686257563,2021.csv,2021,0.0,1.0
92,Mission: Impossible - Rogue Nation,682714267,195042377,487671890,2015.csv,2015,0.2856866868434727,0.7143133131565274
93,Interstellar,677896797,188020017,489876780,2014.csv,2014,0.2773578778245798,0.7226421221754201
94,Doctor Strange,677718395,232641920,445076475,2016.csv,2016,0.3432722524817996,0.6567277475182004
95,Man of Steel,668045518,291045518,377000000,2013.csv,2013,0.4356671965577052,0.5643328034422948
96,Kung Fu Panda 2,665692281,165249063,500443218,2011.csv,2011,0.24823641150196843,0.7517635884980316
97,The Hunger Games: Mockingjay - Part 2,658344137,281723902,376620235,2015.csv,2015,0.4279280184430351,0.5720719815569649
98,Justice League,657924295,229024295,428900000,2017.csv,2017,0.3481012887660578,0.6518987112339422
99,Big Hero 6,657827828,222527828,435300000,2014.csv,2014,0.33827670178769026,0.6617232982123098
100,Fantastic Beasts: The Crimes of Grindelwald,654855901,159555901,495300000,2018.csv,2018,0.24365039813545178,0.7563496018645482
101,Thor: The Dark World,644783140,206362140,438421000,2013.csv,2013,0.32004890822672566,0.6799510917732744
102,Moana,643331111,248757044,394574067,2016.csv,2016,0.38667031602642327,0.6133296839735767
103,Sing,634151679,270395425,363756254,2016.csv,2016,0.42638919670825315,0.5736108032917469
104,The Martian,630161890,228433663,401728227,2015.csv,2015,0.36249996488997455,0.6375000351100255
105,Fast Five,626137675,209837675,416300000,2011.csv,2011,0.33513024911014977,0.6648697508898502
106,Men in Black 3,624026776,179020854,445005922,2012.csv,2012,0.2868800841328001,0.7131199158671999
107,Iron Man 2,623933331,312433331,311500000,2010.csv,2010,0.5007479412892594,0.4992520587107407
108,Ant-Man and the Wasp,622674139,216648740,406025399,2018.csv,2018,0.3479327732285988,0.6520672267714012
109,How to Train Your Dragon 2,621537519,177002924,444534595,2014.csv,2014,0.2847823640393944,0.7152176359606056
110,Logan,619021436,226277068,392744368,2017.csv,2017,0.36553995522701094,0.6344600447729891
111,Life of Pi,609016565,124987023,484029542,2012.csv,2012,0.20522762463776334,0.7947723753622367
112,Transformers: The Last Knight,605425157,130168683,475256474,2017.csv,2017,0.21500375644284633,0.7849962435571537
113,Tangled,592461732,200821936,391639796,2010.csv,2010,0.33896186901738995,0.66103813098261
114,The Croods,587204668,187168425,400036243,2013.csv,2013,0.3187447838885368,0.6812552161114632
115,The Hangover Part II,586764305,254464305,332300000,2011.csv,2011,0.43367379854505633,0.5663262014549436
116,Ready Player One,582890172,137690172,445200000,2018.csv,2018,0.23621975221774713,0.7637802477822528
117,Operation Red Sea,579330426,1543547,577786879,2018.csv,2018,0.0026643637736368433,0.9973356362263631
118,Fifty Shades of Grey,569651467,166167230,403484237,2015.csv,2015,0.2916998193212763,0.7083001806787237
119,Kong: Skull Island,566652812,168052812,398600000,2017.csv,2017,0.29657103686975084,0.7034289631302492
120,The Smurfs,563749323,142614158,421135165,2011.csv,2011,0.2529744199799243,0.7470255800200757
121,Cars 2,559852396,191452396,368400000,2011.csv,2011,0.3419694143811434,0.6580305856188566
122,Puss in Boots,554987477,149260504,405726973,2011.csv,2011,0.26894391348581725,0.7310560865141827
123,Mei ren yu,553810228,3232685,550577543,2016.csv,2016,0.005837170995693492,0.9941628290043065
124,Ted,549368315,218815487,330552828,2012.csv,2012,0.398303799155217,0.6016962008447829
125,American Sniper,547426372,350126372,197300000,2014.csv,2014,0.639586234621521,0.3604137653784791
126,Detective Chinatown 2,544185156,1983984,542201172,2018.csv,2018,0.0036457885301083076,0.9963542114698917
127,X-Men: Apocalypse,543934105,155442489,388491616,2016.csv,2016,0.285774485495812,0.7142255145041879
128,Sherlock Holmes: A Game of Shadows,543848418,186848418,357000000,2011.csv,2011,0.3435670893134785,0.6564329106865214
129,Despicable Me,543113985,251513985,291600000,2010.csv,2010,0.4630961307321151,0.5369038692678849
130,Cinderella,542351353,201151353,341200000,2015.csv,2015,0.3708875286976559,0.6291124713023442
131,World War Z,540007876,202359711,337648165,2013.csv,2013,0.37473473997997764,0.6252652600200224
132,Brave,538983207,237283207,301700000,2012.csv,2012,0.4402423005360907,0.5597576994639093
133,The Revenant,532950503,183637894,349312609,2015.csv,2015,0.34456838480552104,0.6554316151944789
134,The Meg,530243742,145443742,384800000,2018.csv,2018,0.2742960085703378,0.7257039914296621
135,Ralph Breaks the Internet,529323962,201091711,328232251,2018.csv,2018,0.3799029052835511,0.6200970947164489
136,Hotel Transylvania 3: Summer Vacation,528583774,167510016,361073758,2018.csv,2018,0.31690343941583043,0.6830965605841696
137,The Boss Baby,527965936,175003033,352962903,2017.csv,2017,0.331466522870521,0.6685334771294791
138,Dunkirk,525245546,188045546,337200000,2017.csv,2017,0.3580145465907482,0.6419854534092517
139,Godzilla,524976069,200676069,324300000,2014.csv,2014,0.38225755582013016,0.6177424441798699
140,How to Train Your Dragon: The Hidden World,521799505,160799505,361000000,2019.csv,2019,0.3081633912243746,0.6918366087756255
141,Kung Fu Panda 3,521170825,143528619,377642206,2016.csv,2016,0.2753964959569638,0.7246035040430362
142,Ant-Man,519311965,180202163,339109802,2015.csv,2015,0.3470017545234106,0.6529982454765894
143,The Grinch,511595957,270620950,240975007,2018.csv,2018,0.5289739809261237,0.4710260190738763
144,Rio 2,498781117,131538435,367242682,2014.csv,2014,0.2637197570572825,0.7362802429427175
145,How to Train Your Dragon,494878759,217581231,277297528,2010.csv,2010,0.4396657303289107,0.5603342696710892
146,Oz the Great and Powerful,493311825,234911825,258400000,2013.csv,2013,0.47619337930932426,0.5238066206906757
147,Clash of the Titans,493214993,163214888,330000105,2010.csv,2010,0.33092037005452507,0.6690796299454749
148,Maleficent: Mistress of Evil,491730089,113929605,377800484,2019.csv,2019,0.23169134358178353,0.7683086564182164
149,War for the Planet of the Apes,490719763,146880162,343839601,2017.csv,2017,0.2993157665019495,0.7006842334980505
150,Teenage Mutant Ninja Turtles,485004754,191204754,293800000,2014.csv,2014,0.39423274189184543,0.6057672581081546
151,Rio,483866518,143619809,340246709,2011.csv,2011,0.29681700150205476,0.7031829984979453
152,Rise of the Planet of the Apes,481800873,176760185,305040688,2011.csv,2011,0.3668739408863628,0.6331260591136372
153,Hotel Transylvania 2,474800000,169700110,305099890,2015.csv,2015,0.3574138795282224,0.6425861204717775
154,San Andreas,473990832,155190832,318800000,2015.csv,2015,0.32741315131597315,0.6725868486840269
155,It Chapter Two,473093228,211593228,261500000,2019.csv,2019,0.44725482310222375,0.5527451768977762
156,Wreck-It Ralph,471222889,189422889,281800000,2012.csv,2012,0.40198151113156133,0.5980184888684387
157,The Lego Movie,468060692,257760692,210300000,2014.csv,2014,0.5506992926464331,0.44930070735356686
158,Bumblebee,467989645,127195589,340794056,2018.csv,2018,0.2717914602576303,0.7282085397423698
159,Star Trek Into Darkness,467365246,228778661,238586585,2013.csv,2013,0.4895072172311246,0.5104927827688753
160,The Eight Hundred,461341525,372755,460968770,2020.csv,2020,0.0008079805952867563,0.9991920194047132
161,Lucy,458863600,126663600,332200000,2014.csv,2014,0.27603758502526676,0.7239624149747332
162,Dying to Survive,451176639,0,451176639,2018.csv,2018,0.0,1.0
163,"My People, My Country",450064993,2356683,447708310,2019.csv,2019,0.005236317057878794,0.9947636829421213
164,Thor,449326618,181030624,268295994,2011.csv,2011,0.40289316668081304,0.597106833319187
165,La La Land,447407695,151101803,296305892,2016.csv,2016,0.3377273227274287,0.6622726772725712
166,Les Misérables,441809770,148809770,293000000,2012.csv,2012,0.33681864934765926,0.6631813506523407
167,Terminator Genisys,440603537,89760956,350842581,2015.csv,2015,0.20372273134974855,0.7962772686502514
168,Warcraft,439048914,47365290,391683624,2016.csv,2016,0.10788157877097038,0.8921184212290296
169,A Star Is Born,436188866,215288866,220900000,2018.csv,2018,0.4935679995096436,0.5064320004903564
170,The Greatest Showman,434993183,174340174,260653009,2017.csv,2017,0.4007882900546513,0.5992117099453488
171,Pokémon Detective Pikachu,433005346,144105346,288900000,2019.csv,2019,0.3328026947731957,0.6671973052268043
172,The Secret Life of Pets 2,430051293,158874395,271176898,2019.csv,2019,0.36943126921374003,0.63056873078626
173,Rampage,428028233,101028233,327000000,2018.csv,2018,0.2360317035441912,0.7639682964558088
174,The Intouchables,426588510,10198820,416389690,2011.csv,2011,0.023907863810021513,0.9760921361899785
175,Bad Boys for Life,426505244,206305244,220200000,2020.csv,2020,0.4837109200936343,0.5162890799063657
176,Django Unchained,425368238,162805434,262562804,2012.csv,2012,0.38273998727662406,0.6172600127233759
177,The King's Speech,423999102,135453143,288545959,2010.csv,2010,0.3194656365097679,0.6805343634902321
178,"My People, My Homeland",422390820,0,422390820,2020.csv,2020,0.0,1.0
179,The Captain,417277699,706572,416571127,2019.csv,2019,0.001693289628689215,0.9983067103713108
180,The Chronicles of Narnia: The Voyage of the Dawn Treader,415686217,104386950,311299267,2010.csv,2010,0.25111958427045944,0.7488804157295406
181,Jason Bourne,415484914,162434410,253050504,2016.csv,2016,0.39095140287091146,0.6090485971290885
182,The Wolverine,414828246,132556852,282271394,2013.csv,2013,0.3195463502743253,0.6804536497256747
183,Kingsman: The Secret Service,414351546,128261724,286089822,2015.csv,2015,0.3095480763573644,0.6904519236426355
184,Pacific Rim,411002906,101802906,309200000,2013.csv,2013,0.24769388370212642,0.7523061162978736
185,Kingsman: The Golden Circle,410902662,100234838,310667824,2017.csv,2017,0.24393815681826855,0.7560618431817314
186,The Mummy,409231607,80227895,329003712,2017.csv,2017,0.196045206742792,0.803954793257208
187,Ice Age: Collision Course,408579038,64063008,344516030,2016.csv,2016,0.15679465180981703,0.843205348190183
188,Alita: Battle Angel,404980543,85838210,319142333,2019.csv,2019,0.21195638033405473,0.7880436196659453
189,Prometheus,403354469,126477084,276877385,2012.csv,2012,0.3135631156227502,0.6864368843772498
190,TRON: Legacy,400062763,172062763,228000000,2010.csv,2010,0.4300894232438224,0.5699105767561776
191,Snow White and the Huntsman,396592829,155332381,241260448,2012.csv,2012,0.39166714484391246,0.6083328551560876
192,Mamma Mia! Here We Go Again,395044706,120634935,274409771,2018.csv,2018,0.3053703369967449,0.6946296630032551
193,Solo: A Star Wars Story,392924807,213767512,179157295,2018.csv,2018,0.5440417815106289,0.4559582184893712
194,The Wolf of Wall Street,392000694,116900694,275100000,2013.csv,2013,0.2982155281592435,0.7017844718407565
195,Independence Day: Resurgence,389681935,103144286,286537649,2016.csv,2016,0.26468839516514925,0.7353116048348508
196,Monster Hunt,387053506,32766,387020740,2015.csv,2015,8.465496240718718e-05,0.9999153450375928
197,Godzilla: King of the Monsters,386600138,110500138,276100000,2019.csv,2019,0.2858253971963145,0.7141746028036855
198,Home,386041607,177397510,208644097,2015.csv,2015,0.45952950869360565,0.5404704913063944
199,1917,384965466,159227644,225737822,2019.csv,2019,0.4136153968678323,0.5863846031321677
200,Cars 3,383930656,152901115,231029541,2017.csv,2017,0.3982519046356121,0.6017480953643879
201,Fifty Shades Darker,381545846,114581250,266964596,2017.csv,2017,0.3003079477898444,0.6996920522101556
202,Demon Slayer the Movie: Mugen Train,377954723,0,377954723,2020.csv,2020,0.0,1.0
203,Taken 2,376141306,139854287,236287019,2012.csv,2012,0.3718131584304118,0.6281868415695883
204,G.I. Joe: Retaliation,375740705,122523060,253217645,2013.csv,2013,0.3260840743884802,0.6739159256115198
205,Spider-Man: Into the Spider-Verse,375540831,190241310,185299521,2018.csv,2018,0.5065795628491859,0.49342043715081413
206,Mad Max: Fury Road,374736354,153636354,221100000,2015.csv,2015,0.4099851865453118,0.5900148134546882
207,Once Upon a Time... In Hollywood,374375059,142502728,231872331,2019.csv,2019,0.3806416174748436,0.6193583825251564
208,The Adventures of Tintin: The Secret of the Unicorn,373993951,77591831,296402120,2011.csv,2011,0.20746814431766036,0.7925318556823396
209,Penguins of Madagascar,373515621,83850911,289664710,2014.csv,2014,0.22449104210289508,0.775508957897105
210,Fifty Shades Freed,371985018,100407760,271577258,2018.csv,2018,0.26992420431298125,0.7300757956870187
211,Captain America: The First Avenger,370569774,176654505,193915269,2011.csv,2011,0.4767105074252494,0.5232894925747505
212,Edge of Tomorrow,370541256,100206256,270335000,2014.csv,2014,0.2704321162013873,0.7295678837986127
213,Gone Girl,369330363,167767189,201563174,2014.csv,2014,0.4542469447604014,0.5457530552395986
214,Hello Mr. Billionaire,366961907,0,366961907,2018.csv,2018,0.0,1.0
215,Shazam!,365971656,140371656,225600000,2019.csv,2019,0.3835588185550632,0.6164411814449369
216,The Nun,365550119,117450119,248100000,2018.csv,2018,0.32129689718415877,0.6787031028158412
217,Night at the Museum: Secret of the Tomb,363204635,113746621,249458014,2014.csv,2014,0.313175025973994,0.6868249740260061
218,Tenet,363129000,57929000,305200000,2020.csv,2020,0.15952733050789114,0.8404726694921089
219,The Hangover Part III,362000072,112200072,249800000,2013.csv,2013,0.3099448886297459,0.6900551113702541
220,Monster Hunt 2,361682618,706153,360976465,2018.csv,2018,0.0019524106629862981,0.9980475893370137
221,Noah,359200044,101200044,258000000,2014.csv,2014,0.28173728174710355,0.7182627182528964
222,The Karate Kid,359126022,176591618,182534404,2010.csv,2010,0.4917260437340294,0.5082739562659706
223,Hotel Transylvania,358375603,148313048,210062555,2012.csv,2012,0.4138480598524448,0.5861519401475552
224,Your Name.,357986087,5017246,352968841,2016.csv,2016,0.014015198305737508,0.9859848016942625
225,The Legend of Tarzan,356700357,126643061,230057296,2016.csv,2016,0.3550404660794887,0.6449595339205113
226,The Great Gatsby,353641895,144840419,208801476,2013.csv,2013,0.40956804340164504,0.5904319565983549
227,Dumbo,353284621,114766307,238518314,2019.csv,2019,0.32485508900768145,0.6751449109923185
228,Murder on the Orient Express,352789811,102826543,249963268,2017.csv,2017,0.29146687289106543,0.7085331271089346
229,X-Men: First Class,352616690,146408305,206208385,2011.csv,2011,0.41520526155469273,0.5847947384453073
230,The Angry Birds Movie,352333929,107509366,244824563,2016.csv,2016,0.3051348653964007,0.6948651346035993
231,Now You See Me,351723989,117723989,234000000,2013.csv,2013,0.3347056006464205,0.6652943993535795
232,Peter Rabbit,351266433,115253424,236013009,2018.csv,2018,0.3281082767165515,0.6718917232834485
233,Titanic 2012 3D Release,350449521,57884114,292565407,2012.csv,2012,0.16517104613191924,0.8348289538680808
234,Mary Poppins Returns,349537494,171958438,177579056,2018.csv,2018,0.4919599211865952,0.5080400788134047
235,The Lorax,348840316,214030500,134809816,2012.csv,2012,0.6135486358176558,0.3864513641823441
236,The Maze Runner,348319861,102427862,245891999,2014.csv,2014,0.2940626517992323,0.7059373482007677
237,The Smurfs 2,347545360,71017784,276527576,2013.csv,2013,0.2043410506185437,0.7956589493814563
238,Trolls,346864462,153707064,193157398,2016.csv,2016,0.44313292608223437,0.5568670739177656
239,xXx: Return of Xander Cage,346118277,44898413,301219864,2017.csv,2017,0.12971985585147242,0.8702801441485276
240,Star Trek Beyond,343471816,158848340,184623476,2016.csv,2016,0.462478528369268,0.537521471630732
241,Alvin and the Chipmunks: Chipwrecked,342695435,133110742,209584693,2011.csv,2011,0.3884228630007867,0.6115771369992133
242,A Quiet Place,340939361,188024361,152915000,2018.csv,2018,0.5514891576276522,0.44851084237234784
243,Godzilla vs. Kong,338600000,70000000,268600000,2021.csv,2021,0.2067336089781453,0.7932663910218547
244,300: Rise of an Empire,337580051,106580051,231000000,2014.csv,2014,0.31571785916935,0.68428214083065
245,Journey 2: The Mysterious Island,335260290,103860290,231400000,2012.csv,2012,0.30979001420060814,0.6902099857993919
246,The Great Wall,334933831,45540830,289393001,2016.csv,2016,0.13596963276008986,0.8640303672399101
247,Now You See Me 2,334897606,65075540,269822066,2016.csv,2016,0.19431473630778956,0.8056852636922105
248,Never Say Die,334530869,0,334530869,2017.csv,2017,0.0,1.0
249,The Good Dinosaur,332207671,123087120,209120551,2015.csv,2015,0.3705125761530052,0.6294874238469947
250,22 Jump Street,331333876,191719337,139614539,2014.csv,2014,0.5786288420445123,0.4213711579554878
251,Black Swan,329398046,106954678,222443368,2010.csv,2010,0.32469736629828094,0.6753026337017191
252,Crazy Alien,327598891,0,327598891,2019.csv,2019,0.0,1.0
253,John Wick: Chapter 3 - Parabellum,326709727,171015687,155694040,2019.csv,2019,0.5234484096030603,0.47655159039693973
254,Taken 3,326479141,89256424,237222717,2015.csv,2015,0.27339089329446625,0.7266091067055338
255,The SpongeBob Movie: Sponge Out of Water,325186032,162994032,162192000,2015.csv,2015,0.5012331894993571,0.4987668105006429
256,Megamind,321885765,148415853,173469912,2010.csv,2010,0.4610823749848024,0.5389176250151976
257,Green Book,321752656,85080171,236672485,2018.csv,2018,0.26442725308847176,0.7355727469115282
258,Robin Hood,321669741,105269730,216400011,2010.csv,2010,0.327260281532045,0.672739718467955
259,The Conjuring 2,320392818,102470008,217922810,2016.csv,2016,0.31982617038562955,0.6801738296143705
260,Sonic the Hedgehog,319715683,148974665,170741018,2020.csv,2020,0.46595982906475064,0.5340401709352494
261,The Last Airbender,319713881,131772187,187941694,2010.csv,2010,0.4121566026093187,0.5878433973906814
262,The Conjuring,319494638,137400141,182094497,2013.csv,2013,0.4300546070510266,0.5699453929489734
263,The Expendables 2,314975955,85028192,229947763,2012.csv,2012,0.26995137454222495,0.730048625457775
264,Maze Runner: The Scorch Trials,312296056,81697192,230598864,2015.csv,2015,0.2616017411375826,0.7383982588624174
265,Resident Evil: The Final Chapter,312242626,26830068,285412558,2016.csv,2016,0.085926986791355,0.914073013208645
266,The Lego Batman Movie,311950384,175750384,136200000,2017.csv,2017,0.5633921066114155,0.4366078933885845
267,Knives Out,311398301,165363234,146035067,2019.csv,2019,0.5310344772883009,0.46896552271169906
268,Little Fockers,310650585,148438600,162211985,2010.csv,2010,0.47783138731253316,0.5221686126874668
269,The Ex-File 3: The Return of The Exes,307592427,838959,306753468,2017.csv,2017,0.002727502130603495,0.9972724978693965
270,The Fault in Our Stars,307166834,124872350,182294484,2014.csv,2014,0.40652940414784494,0.593470595852155
271,Rise of the Guardians,306941670,103412758,203528912,2012.csv,2012,0.33691338813657984,0.6630866118634202
272,Annabelle: Creation,306515884,102092201,204423683,2017.csv,2017,0.33307311734617967,0.6669268826538203
273,Wonder,305937718,132422809,173514909,2017.csv,2017,0.43284237676114196,0.5671576232388581
274,Skyscraper,304868961,68420120,236448841,2018.csv,2018,0.22442468323300382,0.7755753167669962
275,A Good Day to Die Hard,304654182,67349198,237304984,2013.csv,2013,0.22106769569964413,0.7789323043003559
276,Dangal,303723636,12391761,291331875,2016.csv,2016,0.04079946217949267,0.9592005378205073
277,Passengers,303144152,100014699,203129453,2016.csv,2016,0.3299245535173642,0.6700754464826357
278,Battleship,303025485,65422625,237602860,2012.csv,2012,0.21589809517176417,0.7841019048282358
279,Wrath of the Titans,301970083,83670083,218300000,2012.csv,2012,0.27708070338875257,0.7229192966112474
280,Resident Evil: Afterlife,300228084,60128566,240099518,2010.csv,2010,0.20027628727764188,0.7997237127223581
281,Alice Through the Looking Glass,299457024,77041381,222415643,2016.csv,2016,0.257270241889534,0.7427297581104659
282,Real Steel,299268508,85468508,213800000,2011.csv,2011,0.28559138604720813,0.7144086139527919
283,Ocean's Eight,297718711,140218711,157500000,2018.csv,2018,0.47097715333048046,0.5290228466695195
284,The Divergent Series: Insurgent,297002527,130179072,166823455,2015.csv,2015,0.4383096444159211,0.5616903555840789
285,Miss Peregrine's Home for Peculiar Children,296482446,87242834,209239612,2016.csv,2016,0.29425969455203427,0.7057403054479657
286,Ferdinand,296069199,84410380,211658819,2017.csv,2017,0.28510355107894897,0.7148964489210511
287,Shutter Island,294804195,128012934,166791261,2010.csv,2010,0.4342303677191568,0.5657696322808432
288,Salt,293503354,118311368,175191986,2010.csv,2010,0.4031005655901295,0.5968994344098705
289,Pacific Rim: Uprising,290930148,59874525,231055623,2018.csv,2018,0.20580378283793402,0.794196217162066
290,Sex and the City 2,290745055,95347692,195397363,2010.csv,2010,0.3279426093764518,0.6720573906235482
291,Divergent,288885818,150947895,137937923,2014.csv,2014,0.5225174985917792,0.47748250140822074
292,Bridesmaids,288383523,169106725,119276798,2011.csv,2011,0.5863952393701772,0.4136047606298228
293,Maze Runner: The Death Cure,288175335,58032443,230142892,2018.csv,2018,0.2013789382772818,0.7986210617227182
294,Pitch Perfect 2,287144079,184296230,102847849,2015.csv,2015,0.6418249355578737,0.35817506444212627
295,Oblivion,286168572,89107235,197061337,2013.csv,2013,0.3113802273158074,0.6886197726841926
296,Elysium,286140700,93050117,193090583,2013.csv,2013,0.3251900795657521,0.6748099204342479
297,John Carter,284139100,73078100,211061000,2012.csv,2012,0.2571912841280908,0.7428087158719092
298,Turbo,282570682,83028128,199542554,2013.csv,2013,0.29383136074959115,0.7061686392504088
299,Paddington,282370135,76271832,206098303,2014.csv,2014,0.2701129565277858,0.7298870434722142
300,The Tourist,278780441,67631157,211149284,2010.csv,2010,0.24259649191099458,0.7574035080890055
301,Split,278454358,138291365,140162993,2017.csv,2017,0.4966392553281569,0.5033607446718431
302,The Bourne Legacy,276144750,113203870,162940880,2012.csv,2012,0.4099439514964525,0.5900560485035475
303,Mr. Peabody & Sherman,275698039,111506430,164191609,2014.csv,2014,0.4044512989807664,0.5955487010192336
304,Lincoln,275293450,182207973,93085477,2012.csv,2012,0.6618681737614898,0.33813182623851024
305,Tomb Raider,274650803,58250803,216400000,2018.csv,2018,0.21209041577060309,0.7879095842293969
306,The Expendables,274470394,103068524,171401870,2010.csv,2010,0.3755178199656754,0.6244821800343245
307,Cloudy with a Chance of Meatballs 2,274325949,119793567,154532382,2013.csv,2013,0.43668332302023677,0.5633166769797632
308,Grown Ups,271430189,162001186,109429003,2010.csv,2010,0.5968429178671795,0.40315708213282053
309,Neighbors,270665134,150157400,120507734,2014.csv,2014,0.5547718606416444,0.44522813935835565
310,We're the Millers,269994119,150394119,119600000,2012.csv,2012,0.5570273884373015,0.4429726115626985
311,Epic,268426634,107518682,160907952,2013.csv,2013,0.4005514668861064,0.5994485331138936
312,Exodus: Gods and Kings,268175631,65014513,203161118,2014.csv,2014,0.24243259075243864,0.7575674092475614
313,Knight and Day 2010 Re-release,261930436,76423035,185507401,2010.csv,2010,0.2917684411444266,0.7082315588555734
314,Terminator: Dark Fate,261119292,62253077,198866215,2019.csv,2019,0.23840856998034446,0.7615914300196556
315,The Lone Ranger,260502115,89302115,171200000,2013.csv,2013,0.34280763900899613,0.6571923609910039
316,Super 8,260095986,127004179,133091807,2011.csv,2011,0.4882973434276683,0.5117026565723317
317,Mojin: The Lost Legend,259368448,1243810,258124638,2015.csv,2015,0.004795533186827721,0.9952044668131723
318,Blade Runner 2049,259239658,92054159,167185499,2017.csv,2017,0.35509288860425825,0.6449071113957418
319,Parasite,258774734,53369749,205404985,2019.csv,2019,0.20624018494788598,0.793759815052114
320,Kung Fu Yoga,257743016,362657,257380359,2017.csv,2017,0.0014070487946800467,0.99859295120532
321,Annabelle,257047661,84273813,172773848,2014.csv,2014,0.3278528684997449,0.6721471315002551
322,Lost in Hong Kong,256283912,1302281,254981631,2015.csv,2015,0.005081399725161055,0.9949186002748389
323,Pegasus,255863112,0,255863112,2019.csv,2019,0.0,1.0
324,Halloween,255485178,159342015,96143163,2018.csv,2018,0.6236839892136522,0.37631601078634785
325,Get Out,255407969,176040665,79367304,2017.csv,2017,0.6892528282858708,0.31074717171412924
326,Us,255184580,175084580,80100000,2019.csv,2019,0.6861095603817441,0.3138904396182559
327,Baahubali 2: The Conclusion,254158390,20186659,233971731,2017.csv,2017,0.07942550706274147,0.9205744929372586
328,Men in Black: International,253890701,80001807,173888894,2019.csv,2019,0.31510333653377876,0.6848966634662212
329,X-Men: Dark Phoenix,252442974,65845974,186597000,2019.csv,2019,0.26083504308580996,0.73916495691419
330,True Grit,252276927,171243005,81033922,2010.csv,2010,0.6787898007018296,0.32121019929817046
331,American Hustle,251171807,150117807,101054000,2013.csv,2013,0.5976698133162692,0.4023301866837308
332,Journey to the West: The Demons Strike Back,247585244,880346,246704898,2017.csv,2017,0.0035557288704976295,0.9964442711295024
333,Glass,246999039,111048468,135950571,2019.csv,2019,0.44959068848846817,0.5504093115115318
334,Grown Ups 2,246984278,133668525,113315753,2013.csv,2013,0.5412025659382255,0.4587974340617746
335,The Peanuts Movie,246233113,130178411,116054702,2015.csv,2015,0.5286795484732388,0.47132045152676116
336,Rango,245724603,123477607,122246996,2011.csv,2011,0.5025040451484624,0.4974959548515376
337,Teenage Mutant Ninja Turtles: Out of the Shadows,245623848,82051601,163572247,2016.csv,2016,0.3340538863311025,0.6659461136688974
338,Dark Shadows,245527149,79727149,165800000,2012.csv,2012,0.3247182616045446,0.6752817383954554
339,Dolittle,245509681,77047065,168462616,2020.csv,2020,0.3138249566622996,0.6861750433377004
340,The Bravest,245179562,290217,244889345,2019.csv,2019,0.0011836916488169597,0.9988163083511831
341,Pixels,244874809,78747585,166127224,2015.csv,2015,0.3215830379677805,0.6784169620322195
342,Hercules,244819862,72688614,172131248,2014.csv,2014,0.29690652304999665,0.7030934769500033
343,After Earth,243611982,60522097,183089885,2013.csv,2013,0.24843645416422908,0.7515635458357709
344,Daddy's Home,242786137,150357137,92429000,2015.csv,2015,0.6192986916711806,0.38070130832881943
345,RoboCop,242688965,58607007,184081958,2014.csv,2014,0.24149020125410317,0.7585097987458969
346,Alien: Covenant,240891763,74262031,166629732,2017.csv,2017,0.3082796608533269,0.6917203391466731
347,Sully,240797623,125070033,115727590,2016.csv,2016,0.5193989518742052,0.48060104812579485
348,Assassin's Creed,240697856,54647948,186049908,2016.csv,2016,0.2270396126835463,0.7729603873164537
349,Legend of Deification,240663149,214670,240448479,2020.csv,2020,0.0008919936471038197,0.9991080063528962
350,Resident Evil: Retribution,240159255,42345531,197813724,2012.csv,2012,0.17632271136084263,0.8236772886391573
351,Planes,239258712,90288712,148970000,2013.csv,2013,0.37736854489127236,0.6226314551087276
352,Crazy Rich Asians,238532921,174532921,64000000,2018.csv,2018,0.7316932198218459,0.2683067801781541
353,Gulliver's Travels,237382724,42779261,194603463,2010.csv,2010,0.1802121918526809,0.8197878081473191
354,Silver Linings Playbook,236412453,132092958,104319495,2012.csv,2012,0.5587394247797937,0.44126057522020634
355,Hidden Figures,235956898,169607287,66349611,2016.csv,2016,0.7188062245164792,0.2811937754835207
356,Spy,235666219,110825712,124840507,2015.csv,2015,0.47026558354551445,0.5297344164544856
357,American Reunion,234989584,57011521,177978063,2012.csv,2012,0.24261297045404362,0.7573870295459564
358,Alvin and the Chipmunks: The Road Chip,234798636,85886987,148911649,2015.csv,2015,0.3657899741802589,0.6342100258197412
359,The Imitation Game,233555708,91125683,142430025,2014.csv,2014,0.39016679909188945,0.6098332009081106
360,The Girl with the Dragon Tattoo,232617430,102515793,130101637,2011.csv,2011,0.44070555246010584,0.5592944475398941
361,Argo,232325503,136025503,96300000,2012.csv,2012,0.5854953556261105,0.4145046443738895
362,Annabelle Comes Home,231252591,74152591,157100000,2019.csv,2019,0.32065626023623667,0.6793437397637634
363,Ghostbusters,229147509,128350574,100796935,2016.csv,2016,0.5601220565744837,0.43987794342551634
364,Goodbye Mr. Loser,228122928,1293626,226829302,2015.csv,2015,0.005670740820931423,0.9943292591790686
365,Paddington 2,227978523,40891591,187086932,2017.csv,2017,0.17936597913655225,0.8206340208634477
366,The Green Hornet,227817248,98780042,129037206,2011.csv,2011,0.4335933423267408,0.5664066576732593
367,Youth,227091290,1891956,225199334,2017.csv,2017,0.00833125744276674,0.9916687425572333
368,Baby Driver,226945087,107825862,119119225,2017.csv,2017,0.47511873213628986,0.5248812678637101
369,Immortals,226904017,83504017,143400000,2011.csv,2011,0.3680147143450528,0.6319852856549473
370,Percy Jackson & the Olympians: The Lightning Thief,226497209,88768303,137728906,2010.csv,2010,0.39191786685548075,0.6080821331445192
371,Hansel & Gretel: Witch Hunters,226349749,55703475,170646274,2013.csv,2013,0.2460947062945495,0.7539052937054505
372,Better Days,225879065,1921657,223957408,2019.csv,2019,0.008507459511575364,0.9914925404884246
373,Valerian and the City of a Thousand Planets,225874228,41189488,184684740,2017.csv,2017,0.18235585513545174,0.8176441448645483
374,Ford v Ferrari,225508210,117624357,107883853,2019.csv,2019,0.521596783549477,0.47840321645052303
375,The Social Network,224920315,96962694,127957621,2010.csv,2010,0.4310979824121267,0.5689020175878733
376,Non-Stop,222809600,92168600,130641000,2014.csv,2014,0.4136652998793589,0.5863347001206412
377,Geostorm,221600160,33700160,187900000,2017.csv,2017,0.15207642449355632,0.8479235755064437
378,Inferno,220021259,34343574,185677685,2016.csv,2016,0.15609207108482184,0.8439079289151782
379,Green Lantern,219851172,116601172,103250000,2011.csv,2011,0.5303641137742036,0.46963588622579644
380,Captain Phillips,218791811,107100855,111690956,2013.csv,2013,0.4895103455220269,0.5104896544779731
381,Jack Reacher,218340595,80070736,138269859,2012.csv,2012,0.3667239983476275,0.6332760016523725
382,The Emoji Movie,217776646,86089513,131687133,2017.csv,2017,0.39531104267259215,0.6046889573274078
383,Dracula Untold,217124280,56280355,160843925,2014.csv,2014,0.2592080213230874,0.7407919786769126
384,Central Intelligence,216972543,127440871,89531672,2016.csv,2016,0.5873594383783389,0.412640561621661
385,The Help,216639112,169708112,46931000,2011.csv,2011,0.7833678343363962,0.21663216566360372
386,Little Women,216601214,108101214,108500000,2019.csv,2019,0.4990794465260938,0.5009205534739062
387,Valentine's Day,216485654,110485654,106000000,2010.csv,2010,0.5103601645585254,0.48963983544147455
388,Bad Teacher,216197492,100292856,115904636,2011.csv,2011,0.46389463204318765,0.5361053679568124
389,A Little Red Flower,216000000,0,216000000,2020.csv,2020,0.0,1.0
390,Ted 2,215863606,81476385,134387221,2015.csv,2015,0.37744382441197616,0.6225561755880239
391,The Sorcerer's Apprentice,215283742,63150991,152132751,2010.csv,2010,0.29333841196424393,0.7066615880357561
392,Just Go with It,214945591,103028109,111917482,2011.csv,2011,0.4793218066054679,0.5206781933945321
393,The Expendables 3,214657577,39322544,175335033,2014.csv,2014,0.18318730952599918,0.8168126904740008
394,Creed II,214215889,115715889,98500000,2018.csv,2018,0.5401835015142131,0.45981649848578693
395,Smallfoot,214040103,83240103,130800000,2018.csv,2018,0.3888995652370808,0.6111004347629192
396,Into the Woods,212902372,128002372,84900000,2014.csv,2014,0.6012256735213829,0.39877432647861716
397,Bridget Jones's Baby,211952420,24252420,187700000,2016.csv,2016,0.11442388815376583,0.8855761118462342
398,Battle Los Angeles,211819354,83552429,128266925,2011.csv,2011,0.3944513446113144,0.6055486553886856
399,Fury,211817906,85817906,126000000,2014.csv,2014,0.4051494400100433,0.5948505599899566
400,Due Date,211780824,100539043,111241781,2010.csv,2010,0.47473156965335067,0.5252684303466493
401,Horrible Bosses,209838559,117538559,92300000,2011.csv,2011,0.5601380392628411,0.4398619607371589
402,Us and Them,209221380,0,209221380,2018.csv,2018,0.0,1.0
403,Tomorrowland,209035668,93436322,115599346,2015.csv,2015,0.44698745861878464,0.5530125413812154
404,Me Before You,208314186,56245075,152069111,2016.csv,2016,0.2700011750519957,0.7299988249480043
405,Safe House,208076205,126373434,81702771,2012.csv,2012,0.6073420745058283,0.3926579254941717
406,Paranormal Activity 3,207039844,104028807,103011037,2011.csv,2011,0.5024579085366776,0.4975420914633224
407,London Has Fallen,205754447,62524260,143230187,2016.csv,2016,0.30387804935268303,0.696121950647317
408,Journey to the West,205637183,18058,205619125,2013.csv,2013,8.781485788005567e-05,0.99991218514212
409,White House Down,205366737,73103784,132262953,2013.csv,2013,0.35596701329485503,0.644032986705145
410,A Dog's Purpose,205035819,64508620,140527199,2017.csv,2017,0.3146212223533489,0.6853787776466511
411,Eat Pray Love,204594016,80574010,124020006,2010.csv,2010,0.39382388388133505,0.606176116118665
412,Yogi Bear,203509374,100246011,103263363,2010.csv,2010,0.49258670020772605,0.5074132997922739
413,Everest,203427584,43482270,159945314,2015.csv,2015,0.2137481512831613,0.7862518487168387
414,Arrival,203388186,100546139,102842047,2016.csv,2016,0.49435584719753584,0.5056441528024641
415,Need for Speed,203277636,43577636,159700000,2014.csv,2014,0.2143749644943726,0.7856250355056273
416,The Addams Family,203044905,100044905,103000000,2019.csv,2019,0.49272305059809307,0.5072769494019069
417,Birds of Prey,201858461,84158461,117700000,2020.csv,2020,0.41691817416561006,0.5830818258343899
418,Straight Outta Compton,201634991,161197785,40437206,2015.csv,2015,0.7994534291917617,0.20054657080823834
419,21 Jump Street,201585328,138447667,63137661,2012.csv,2012,0.6867943633278708,0.31320563667212925
420,Percy Jackson: Sea of Monsters,199850315,68559554,131290761,2013.csv,2013,0.34305452057956476,0.6569454794204352
421,RED,199006387,90380162,108626225,2010.csv,2010,0.45415709195303366,0.5458429080469663
422,Shock Wave 2,198903006,0,198903006,2020.csv,2020,0.0,1.0
423,Total Recall,198467168,58877969,139589199,2012.csv,2012,0.296663521696445,0.703336478303555
424,The Island,198326350,670883,197655467,2018.csv,2018,0.0033827224672868736,0.9966172775327131
425,The Impossible,198087212,19019882,179067330,2012.csv,2012,0.09601771769093302,0.903982282309067
426,Lost in Thailand,197757387,57387,197700000,2012.csv,2012,0.00029018890707733716,0.9997098110929227
427,Christopher Robin,197744377,99215042,98529335,2018.csv,2018,0.5017338217409844,0.4982661782590157
428,Jack the Giant Slayer,197687603,65187603,132500000,2013.csv,2013,0.3297505863329225,0.6702494136670776
429,Smurfs: The Lost Village,197183546,45020282,152163264,2017.csv,2017,0.22831662637814618,0.7716833736218538
430,The Other Woman,196710396,83911193,112799203,2014.csv,2014,0.4265722336301941,0.5734277663698059
431,The Vow,196114570,125014030,71100540,2012.csv,2012,0.6374540657535032,0.36254593424649684
432,The Shape of Water,195333312,63859435,131473877,2017.csv,2017,0.3269254708587545,0.6730745291412455
433,The BFG,195243411,55483770,139759641,2016.csv,2016,0.28417742609506036,0.7158225739049396
434,Rocketman,195179299,96368160,98811139,2019.csv,2019,0.4937417056713581,0.5062582943286419
435,The Intern,194564672,75764672,118800000,2015.csv,2015,0.38940610965591943,0.6105938903440805
436,Gnomeo & Juliet,193967670,99967670,94000000,2011.csv,2011,0.5153831563785862,0.48461684362141383
437,Downton Abbey,193820755,96854135,96966620,2019.csv,2019,0.49970982209825776,0.5002901779017422
438,The Monkey King 2,193678298,709982,192968316,2016.csv,2016,0.003665779838689,0.996334220161311
439,Weathering with You,193475960,7798743,185677217,2019.csv,2019,0.04030858924281859,0.9596914107571815
440,The Equalizer,192330738,101530738,90800000,2014.csv,2014,0.527896575741315,0.47210342425868507
441,The Lego Movie 2: The Second Part,192306508,105806508,86500000,2019.csv,2019,0.5501972299346208,0.44980277006537916
442,Sheep Without a Shepherd,191602146,0,191602146,2019.csv,2019,0.0,1.0
443,The Equalizer 2,190400157,102084362,88315795,2018.csv,2018,0.5361569213411941,0.4638430786588059
444,The White Storm 2: Drug Lords,189396380,609461,188786919,2019.csv,2019,0.003217912612690908,0.9967820873873091
445,Breakup Buddies,189017596,777896,188239700,2014.csv,2014,0.004115468699538428,0.9958845313004616
446,The Secret Life of Walter Mitty,188133322,58236838,129896484,2013.csv,2013,0.30955089391341317,0.6904491060865868
447,Project Gutenberg,188116796,0,188116796,2018.csv,2018,0.0,1.0
448,12 Years a Slave,187733202,56671993,131061209,2013.csv,2013,0.30187517389704993,0.6981248261029501
449,Mr. Popper's Penguins,187361754,68224452,119137302,2011.csv,2011,0.3641322230576471,0.635867776942353
450,Jian Bing Man,186683536,0,186683536,2015.csv,2015,0.0,1.0
451,Hugo,185770160,73864507,111905653,2011.csv,2011,0.39761233451055866,0.6023876654894413
452,The Lion King 2011 3D Release,185542001,94242001,91300000,2011.csv,2011,0.5079281267425805,0.49207187325741947
453,Pitch Perfect 3,185400345,104897530,80502815,2017.csv,2017,0.5657892923554161,0.4342107076445839
454,Hop,183953723,108085305,75868418,2011.csv,2011,0.5875679123928359,0.4124320876071641
455,Bad Moms,183936074,113257297,70678777,2016.csv,2016,0.615742711785835,0.3842572882141651
456,Jupiter Ascending,183887723,47387723,136500000,2015.csv,2015,0.25769922117095334,0.7423007788290467
457,Stand by Me Doraemon,183442714,0,183442714,2014.csv,2014,0.0,1.0
458,Storks,183388953,72679278,110709675,2016.csv,2016,0.3963121922616571,0.6036878077383429
459,Mirror Mirror,183018522,64935167,118083355,2012.csv,2012,0.3548010676209045,0.6451989323790955
460,From Vegas to Macau III,181732879,0,181732879,2016.csv,2016,0.0,1.0
461,Daddy's Home 2,180613180,104029443,76583737,2017.csv,2017,0.5759792447040687,0.42402075529593136
462,Hacksaw Ridge,180450918,67209615,113241303,2016.csv,2016,0.3724537161955585,0.6275462838044414
463,The Post,179769457,81903458,97865999,2017.csv,2017,0.4556027445752367,0.5443972554247632
464,The Dictator,179379533,59650222,119729311,2012.csv,2012,0.3325363880839181,0.6674636119160818
465,Allegiant,179246868,66184051,113062817,2016.csv,2016,0.36923407219589466,0.6307659278041053
466,Abominable,179066314,60716390,118349924,2019.csv,2019,0.3390720937049053,0.6609279062950947
467,Baywatch,177856751,58060186,119796565,2017.csv,2017,0.32644353207599075,0.6735564679240093
468,War Horse,177584879,79884879,97700000,2011.csv,2011,0.44984054639021376,0.5501594536097862
469,Paranormal Activity 2,177512032,84752907,92759125,2010.csv,2010,0.4774488018930458,0.5225511981069543
470,Lee Daniels' The Butler,177313795,116632095,60681700,2013.csv,2013,0.6577722562421046,0.34222774375789544
471,The Descendants,177243185,82584160,94659025,2011.csv,2011,0.4659370119082435,0.5340629880917566
472,The A-Team,177238796,77222099,100016697,2010.csv,2010,0.4356952357090036,0.5643047642909964
473,The Hitman's Bodyguard,176586701,75468583,101118118,2017.csv,2017,0.4273741033306919,0.5726258966693081
474,Looper,176506819,66486205,110020614,2012.csv,2012,0.37667782682095696,0.623322173179043
475,Serial (Bad) Weddings,176404493,0,176404493,2014.csv,2014,0.0,1.0
476,Ip Man 4: The Finale,176345966,3956031,172389935,2019.csv,2019,0.02243335126815433,0.9775666487318456
477,The Monkey King Havoc in Heavens Palace,175835580,0,175835580,2014.csv,2014,0.0,1.0
478,Cowboys & Aliens,174822325,100240551,74581774,2011.csv,2011,0.5733852984737504,0.4266147015262496
479,The Mule,174804407,103804407,71000000,2018.csv,2018,0.5938317504775494,0.40616824952245056
480,Identity Thief,173965010,134506920,39458090,2013.csv,2013,0.7731837568945618,0.22681624310543827
481,The Nutcracker and the Four Realms,173961069,54858851,119102218,2018.csv,2018,0.3153513100106323,0.6846486899893677
482,In Time,173930596,37520095,136410501,2011.csv,2011,0.215718774401256,0.784281225598744
483,Operation Mekong,173839072,800012,173039060,2016.csv,2016,0.004602026407504062,0.9953979735924959
484,Creed,173567581,109767581,63800000,2015.csv,2015,0.6324198353608442,0.3675801646391557
485,Gemini Man,173469516,48546770,124922746,2019.csv,2019,0.27985764369112553,0.7201423563088745
486,The Girl on the Train,173185859,75395035,97790824,2016.csv,2016,0.435341750390833,0.564658249609167
487,The Grand Budapest Hotel,172936941,59301324,113635617,2014.csv,2014,0.342907210322403,0.657092789677597
488,Jackass 3D,171685792,117229692,54456100,2010.csv,2010,0.6828153374508708,0.3171846625491293
489,Spies in Disguise,171616764,66757013,104859751,2019.csv,2019,0.3889888810629246,0.6110111189370754
490,John Wick: Chapter 2,171539887,92029184,79510703,2017.csv,2017,0.5364885427492441,0.46351145725075593
491,Anchorman 2: The Legend Continues,171464676,125168368,46296308,2013.csv,2013,0.7299950690718361,0.2700049309281639
492,Chinese Zodiac,170525083,0,170525083,2012.csv,2012,0.0,1.0
493,The Other Guys,170458922,119219978,51238944,2010.csv,2010,0.6994059131736149,0.30059408682638505
494,Olympus Has Fallen,170270201,98925640,71344561,2013.csv,2013,0.5809920903305916,0.4190079096694083
495,Zookeeper,169852759,80360843,89491916,2011.csv,2011,0.47312062207950356,0.5268793779204964
496,Dumb and Dumber To,169837010,86208010,83629000,2014.csv,2014,0.5075926030492411,0.49240739695075886
497,Ghost in the Shell,169801921,40563557,129238364,2017.csv,2017,0.23888750351652382,0.7611124964834762
498,Insidious: The Last Key,167885588,67745330,100140258,2018.csv,2018,0.40352081919026905,0.596479180809731
499,Fantastic Four,167882881,56117548,111765333,2015.csv,2015,0.3342660530110869,0.6657339469889131
500,Unstoppable,167805466,81562942,86242524,2010.csv,2010,0.48605652690717477,0.5139434730928253
501,Magic Mike,167739368,113721571,54017797,2012.csv,2012,0.6779658964733908,0.3220341035266092
502,Wonder Woman 1984,166257000,46257000,120000000,2020.csv,2020,0.27822587921110087,0.7217741207888991
503,Bridge of Spies,165478348,72313754,93164594,2015.csv,2015,0.4369982833041094,0.5630017166958906
504,The Muppets,165184237,88631237,76553000,2011.csv,2011,0.5365598958452676,0.4634401041547324
505,The Huntsman: Winter's War,164989338,48390190,116599148,2016.csv,2016,0.2932928308373478,0.7067071691626522
506,From Vegas to Macau II,163877532,0,163877532,2015.csv,2015,0.0,1.0
507,The Croods: A New Age,162844638,56716638,106128000,2020.csv,2020,0.34828680082177466,0.6517131991782253
508,The Magnificent Seven,162360636,93432655,68927981,2016.csv,2016,0.5754637164638847,0.4245362835361152
509,Jack Reacher: Never Go Back,162146076,58697076,103449000,2016.csv,2016,0.36200121179620776,0.6379987882037922
510,Insidious: Chapter 2,161919318,83586447,78332871,2013.csv,2013,0.5162228203060983,0.4837771796939016
511,Limitless,161849455,79249455,82600000,2011.csv,2011,0.489649192825518,0.510350807174482
512,Flight,161772375,93772375,68000000,2012.csv,2012,0.5796562917494411,0.42034370825055883
513,Into the Storm,161502194,47602194,113900000,2014.csv,2014,0.29474642307336085,0.7052535769266391
514,Unbroken,161459297,115637895,45821402,2014.csv,2014,0.7162046233856698,0.28379537661433024
515,The Sacrifice,161047608,0,161047608,2020.csv,2020,0.0,1.0
516,The Predator,160542134,51024708,109517426,2018.csv,2018,0.3178275181018835,0.6821724818981165
517,"Three Billboards Outside Ebbing, Missouri",160192031,54513740,105678291,2017.csv,2017,0.3403024461310438,0.6596975538689562
518,Underworld: Awakening,160112671,62321039,97791632,2012.csv,2012,0.3892323987275186,0.6107676012724814
519,Johnny English Reborn,160078586,8305970,151772616,2011.csv,2011,0.051886827636021225,0.9481131723639787
520,Step Up 3D,159291809,42400223,116891586,2010.csv,2010,0.26617955603731014,0.7338204439626899
521,Happy Feet Two,159196259,64006466,95189793,2011.csv,2011,0.4020601137367179,0.5979398862632821
522,Johnny English Strikes Again,158970776,4412170,154558606,2018.csv,2018,0.02775459811556811,0.9722454018844319
523,Focus,158762963,53862963,104900000,2015.csv,2015,0.3392665517334795,0.6607334482665205
524,Goosebumps,158260952,80080379,78180573,2015.csv,2015,0.5060021312142745,0.4939978687857255
525,Final Destination 5,157887643,42587643,115300000,2011.csv,2011,0.26973385751283907,0.7302661424871609
526,Don't Breathe,157830487,89217875,68612612,2016.csv,2016,0.565276561555563,0.4347234384444369
527,Hustlers,157563598,104963598,52600000,2019.csv,2019,0.6661665469203109,0.33383345307968915
528,The Book of Eli,157107755,94835059,62272696,2010.csv,2010,0.6036306673722122,0.39636933262778784
529,Ip Man 3,156954938,2679437,154275501,2015.csv,2015,0.01707137751855886,0.9829286224814411
530,The Climbers,156892866,487157,156405709,2019.csv,2019,0.0031050296448788183,0.9968949703551212
531,This Means War,156491279,54760791,101730488,2012.csv,2012,0.3499287075288074,0.6500712924711926
532,The Hateful Eight,155760117,54117416,101642701,2015.csv,2015,0.3474407765114866,0.6525592234885135
533,Escape Room,155712077,57005601,98706476,2019.csv,2019,0.36609620845273294,0.6339037915472671
534,The Monuments Men,155641650,78031620,77610030,2014.csv,2014,0.5013543611237737,0.49864563887622626
535,The Accountant,155160045,86260045,68900000,2016.csv,2016,0.5559423819450426,0.44405761805495736
536,Lone Survivor,154802912,125095601,29707311,2013.csv,2013,0.8080959161801814,0.19190408381981858
537,Ride Along,154468902,134938200,19530702,2014.csv,2014,0.8735622397315933,0.12643776026840664
538,The Town,154026136,92186262,61839874,2010.csv,2010,0.598510515124524,0.4014894848754759
539,Midnight in Paris,153959590,56817045,97142545,2011.csv,2011,0.36903868735945583,0.6309613126405442
540,Monkey King: Hero Is Back,153262397,0,153262397,2015.csv,2015,0.0,1.0
541,Yesterday,153178480,73286650,79891830,2019.csv,2019,0.4784395954314209,0.5215604045685791
542,Tower Heist,152930623,78046570,74884053,2011.csv,2011,0.5103397113604906,0.48966028863950944
543,Duckweed,152894264,471575,152422689,2017.csv,2017,0.0030843210704098096,0.9969156789295902
544,Date Night,152263880,98711404,53552476,2010.csv,2010,0.6482916631311378,0.35170833686886216
545,Bad Grandpa,151826547,102003019,49823528,2013.csv,2013,0.6718391547164674,0.3281608452835327
546,47 Ronin,151783839,38362475,113421364,2013.csv,2013,0.25274413437388416,0.7472558656261158
547,Red Sparrow,151572634,46874505,104698129,2018.csv,2018,0.30925440670246584,0.6907455932975342
548,Darkest Hour,150847207,56468410,94378797,2017.csv,2017,0.37434176689794463,0.6256582331020554
549,Gods of Egypt,150680864,31153464,119527400,2015.csv,2015,0.20675129656808977,0.7932487034319102
550,I Am Number Four,149878437,55100437,94778000,2011.csv,2011,0.36763418476268206,0.6323658152373179
551,Jack and Jill,149673788,74158157,75515631,2011.csv,2011,0.49546522467915355,0.5045347753208465
552,Friends with Benefits,149542245,55802754,93739491,2011.csv,2011,0.37315712359407205,0.626842876405928
553,A Writer's Odyssey,149506203,110779,149395424,2021.csv,2021,0.0007409659116284292,0.9992590340883716
554,No Strings Attached,149228077,70662220,78565857,2011.csv,2011,0.473518264260686,0.526481735739314
555,Lights Out,148868835,67268835,81600000,2016.csv,2016,0.4518664702387172,0.5481335297612828
556,The Secret World of Arrietty,148800274,19202743,129597531,2010.csv,2010,0.12905045457107156,0.8709495454289284
557,King Arthur: Legend of the Sword,148675066,39175066,109500000,2017.csv,2017,0.2634945257061463,0.7365054742938537
558,RED 2,148075565,53262560,94813005,2013.csv,2013,0.35969850933879605,0.640301490661204
559,The Angry Birds Movie 2,147792047,41667116,106124931,2019.csv,2019,0.2819307049722371,0.7180692950277628
560,Arthur Christmas,147419472,46462469,100957003,2011.csv,2011,0.31517185870805453,0.6848281412919455
561,Source Code,147332697,54712227,92620470,2011.csv,2011,0.3713515608826464,0.6286484391173536
562,Planes: Fire & Rescue,146965787,59165787,87800000,2014.csv,2014,0.402582044486313,0.597417955513687
563,The Last Witch Hunter,146936910,27367660,119569250,2015.csv,2015,0.18625449521158435,0.8137455047884157
564,Angel Has Fallen,146661977,69030436,77631541,2019.csv,2019,0.470677113537069,0.529322886462931
565,Mama,146428180,71628180,74800000,2013.csv,2013,0.4891693661698179,0.5108306338301821
566,Time Raiders,145819137,0,145819137,2016.csv,2016,0.0,1.0
567,The Foreigner,145374099,34393507,110980592,2017.csv,2017,0.23658620921186244,0.7634137907881375
568,"Crazy, Stupid, Love.",145051197,84351197,60700000,2011.csv,2011,0.5815270659227997,0.4184729340772003
569,Pete's Dragon,143695338,76233151,67462187,2016.csv,2016,0.5305193060612725,0.4694806939387275
570,The Invisible Man,143151000,70410000,72741000,2020.csv,2020,0.49185824758471824,0.5081417524152818
571,More Than Blue,142958164,722669,142235495,2018.csv,2018,0.005055108290282743,0.9949448917097172
572,Paranormal Activity 4,142802657,53885000,88917657,2012.csv,2012,0.3773389174404507,0.6226610825595493
573,Power Rangers,142337240,85364450,56972790,2017.csv,2017,0.5997337731151735,0.4002662268848265
574,New Year's Eve,142044638,54544638,87500000,2011.csv,2011,0.3839964589159641,0.6160035410840359
575,Onward,141950121,61555145,80394976,2020.csv,2020,0.43363925698943223,0.5663607430105678
576,The Taking of Tiger Mountain,141654055,228984,141425071,2014.csv,2014,0.0016165015537324364,0.9983834984462676
577,Trainwreck,140795793,110212700,30583093,2015.csv,2015,0.7827840424180856,0.2172159575819144
578,Sausage Party,140705322,97685686,43019636,2016.csv,2016,0.6942572221966131,0.3057427778033869
579,Girls Trip,140552359,115171585,25380774,2017.csv,2017,0.8194212165446473,0.18057878345535275
580,Step Up Revolution,140470746,35074677,105396069,2012.csv,2012,0.24969381881121355,0.7503061811887864
581,Lion,140312928,51738905,88574023,2016.csv,2016,0.3687394008341127,0.6312605991658873
582,Legend of the Guardians: The Owls of Ga'Hoole,140073390,55675313,84398077,2010.csv,2010,0.3974724464082721,0.6025275535917278
583,The Wolfman,139789765,61979680,77810085,2010.csv,2010,0.4433778109577622,0.5566221890422378
584,Mr. Six,139191345,1415450,137775895,2015.csv,2015,0.010169094924688026,0.989830905075312
585,The Admiral: Roaring Currents,138342258,2589811,135752447,2014.csv,2014,0.018720317547513212,0.9812796824524868
586,Let's Be Cops,138224951,82390774,55834177,2014.csv,2014,0.5960629640592168,0.40393703594078323
587,Escape Plan,137328301,25135965,112192336,2013.csv,2013,0.18303557836923942,0.8169644216307606
588,The First Purge,137056262,69488745,67567517,2018.csv,2018,0.5070089026650968,0.49299109733490326
589,Annie,136853506,85911262,50942244,2014.csv,2014,0.6277607677804031,0.3722392322195969
590,The Best Exotic Marigold Hotel,136836156,46412041,90424115,2012.csv,2012,0.3391796609662142,0.6608203390337858
591,How Long Will I Love U,136796719,746933,136049786,2018.csv,2018,0.005460167505918033,0.994539832494082
592,Skiptrace,136579287,0,136579287,2016.csv,2016,0.0,1.0
593,Contagion,136515867,75658097,60857770,2011.csv,2011,0.5542073508568788,0.4457926491431212
594,The Wind Rises,136454220,5209580,131244640,2012.csv,2012,0.03817822563494189,0.9618217743650581
595,The Bounty Hunter,136333522,67061228,69272294,2010.csv,2010,0.49189096721201114,0.5081090327879888
596,Saw: The Final Chapter,136150434,45710178,90440256,2010.csv,2010,0.3357328849939619,0.6642671150060381
597,Unknown,135710029,63686397,72023632,2011.csv,2011,0.4692829076029451,0.5307170923970549
598,Soul,135581765,0,135581765,2020.csv,2020,0.0,1.0
599,Jack Ryan: Shadow Recruit,135503748,50577412,84926336,2014.csv,2014,0.3732547087922616,0.6267452912077384
600,American Made,134866593,51342000,83524593,2017.csv,2017,0.3806873063072039,0.6193126936927961
601,Wall Street: Money Never Sleeps,134748021,52474616,82273405,2010.csv,2010,0.38942773044510987,0.6105722695548902
602,Last Vegas,134402450,63914167,70488283,2012.csv,2012,0.4755431690419334,0.5244568309580666
603,Point Break,133718711,28782481,104936230,2015.csv,2015,0.21524647362178057,0.7847535263782194
604,The Big Short,133440870,70259870,63181000,2015.csv,2015,0.5265243699325401,0.47347563006745985
605,The Artist,133432856,44671682,88761174,2011.csv,2011,0.33478772274798646,0.6652122772520136
606,Zero Dark Thirty,132820716,95720716,37100000,2012.csv,2012,0.7206761029657452,0.2793238970342548
607,A Wrinkle in Time,132675864,100478608,32197256,2018.csv,2018,0.7573239394921144,0.2426760605078856
608,Ghost Rider: Spirit of Vengeance,132563930,51774002,80789928,2012.csv,2012,0.39055874399619867,0.6094412560038014
609,The Three Musketeers,132274484,20374484,111900000,2011.csv,2011,0.1540318539439549,0.8459681460560451
610,2 Guns,131940411,75612460,56327951,2013.csv,2013,0.5730803733815867,0.4269196266184134
611,The House with a Clock in Its Walls,131457147,68549695,62907452,2018.csv,2018,0.521460388912898,0.478539611087102
612,A Bad Moms Christmas,130560428,72110659,58449769,2017.csv,2017,0.5523163496369665,0.4476836503630334
613,Cloud Atlas,130482868,27108272,103374596,2012.csv,2012,0.2077534960375028,0.7922465039624972
614,Warm Hug,129240236,0,129240236,2020.csv,2020,0.0,1.0
615,The Woman in Black,128955898,54333290,74622608,2012.csv,2012,0.4213323379749564,0.5786676620250436
616,Pan,128388320,35088320,93300000,2015.csv,2015,0.2732983810365304,0.7267016189634695
617,Blended,127994610,46294610,81700000,2014.csv,2014,0.36169187124364066,0.6383081287563593
618,The Adjustment Bureau,127869379,62495645,65373734,2010.csv,2010,0.4887459803804944,0.5112540196195057
619,Ad Astra,127461872,50188370,77273502,2019.csv,2019,0.393752023350167,0.606247976649833
620,Predators,127233108,52000688,75232420,2010.csv,2010,0.40870406152461514,0.5912959384753849
621,Midway,126696475,56846802,69849673,2019.csv,2019,0.4486849535474448,0.5513150464525552
622,Chronicle,126636097,64575175,62060922,2012.csv,2012,0.5099270786906833,0.49007292130931673
623,Walking with Dinosaurs 3D,126546518,36076121,90470397,2012.csv,2012,0.2850818937586256,0.7149181062413744
624,Sex Tape,126069509,38543473,87526036,2014.csv,2014,0.30573191968249835,0.6942680803175016
625,This Is the End,126041322,101470202,24571120,2013.csv,2013,0.8050550437736602,0.1949449562263398
626,The Upside,125852517,108252517,17600000,2019.csv,2019,0.860153770305603,0.13984622969439697
627,Detective Chinatown,125842935,474252,125368683,2015.csv,2015,0.003768602504383738,0.9962313974956163
628,Wolf Totem,125837070,210591,125626479,2015.csv,2015,0.0016735211651065938,0.9983264788348934
629,Mechanic: Resurrection,125729635,21218403,104511232,2016.csv,2016,0.1687621458536804,0.8312378541463196
630,Ender's Game,125544024,61737191,63806833,2013.csv,2013,0.49175730578780874,0.5082426942121913
631,Happy Death Day,125479266,55683845,69795421,2017.csv,2017,0.44376929173302626,0.5562307082669737
632,Captain Underpants: The First Epic Movie,125427681,73921000,51506681,2017.csv,2017,0.5893515642691345,0.4106484357308655
633,Ride Along 2,124605297,91221830,33383467,2015.csv,2015,0.7320862932496361,0.2679137067503639
634,The Theory of Everything,123726688,35893537,87833151,2014.csv,2014,0.2901034334645731,0.7098965665354269
635,The Curse of la Llorona,123133739,54733739,68400000,2019.csv,2019,0.4445064321485438,0.5554935678514562
636,The Lego Ninjago Movie,123081555,59281555,63800000,2017.csv,2017,0.4816445079849698,0.5183554920150302
637,The Pirates! Band of Misfits,123054041,31051126,92002915,2012.csv,2012,0.25233731251458863,0.7476626874854114
638,Looking Up,122994583,84267,122910316,2019.csv,2019,0.0006851277344466463,0.9993148722655534
639,Zombieland: Double Tap,122810399,73123082,49687317,2019.csv,2019,0.5954144160056023,0.40458558399439776
640,Dragon Blade,122593849,74068,122519781,2015.csv,2015,0.0006041738684621934,0.9993958261315378
641,Prisoners,122126687,61002302,61124385,2013.csv,2013,0.4995001788593512,0.5004998211406488
642,Secret Superstar,122026260,0,122026260,2017.csv,2017,0.0,1.0
643,Deepwater Horizon,121790373,61433527,60356846,2016.csv,2016,0.5044202221139433,0.4955797778860567
644,Last Christmas,121550750,35150750,86400000,2019.csv,2019,0.2891857927655732,0.7108142072344268
645,The Nut Job,120885527,64251541,56633986,2014.csv,2014,0.531507307735855,0.4684926922641451
646,Instant Family,120556201,67363237,53192964,2018.csv,2018,0.5587704028596588,0.4412295971403412
647,We Bought a Zoo,120081841,75624550,44457291,2011.csv,2011,0.629775071486454,0.37022492851354605
648,The Commuter,119942387,36343858,83598529,2017.csv,2017,0.3030109614210029,0.6969890385789971
649,Extreme Job,119932733,1565885,118366848,2019.csv,2019,0.013056360518358236,0.9869436394816418
650,Parental Guidance,119772232,77267296,42504936,2012.csv,2012,0.6451186114658028,0.35488138853419715
651,Dora and the Lost City of Gold,119682635,60477943,59204692,2019.csv,2019,0.505319280445321,0.4946807195546789
652,Wonder Park,119559110,45216793,74342317,2019.csv,2019,0.37819613244026323,0.6218038675597368
653,Allied,119520023,40098064,79421959,2016.csv,2016,0.33549243878575896,0.664507561214241
654,I Belonged to You,119107580,744541,118363039,2016.csv,2016,0.006250995948368693,0.9937490040516314
655,The Shallows,119100758,55124043,63976715,2016.csv,2016,0.46283536667331704,0.537164633326683
656,Forever Young,119055731,0,119055731,2017.csv,2017,0.0,1.0
657,Hankyu Railways - A 15-minute Miracle,118799256,0,118799256,2011.csv,2011,0.0,1.0
658,The Purge: Election Year,118587880,79213375,39374505,2016.csv,2016,0.6679719293405025,0.3320280706594974
659,Jurassic Park 2013 Re-release,118192315,45385935,72806380,2013.csv,2013,0.38400072796611184,0.6159992720338882
660,A Cool Fish,118153135,551876,117601259,2018.csv,2018,0.004670853634141828,0.9953291463658581
661,Why Him?,118102725,60323786,57778939,2016.csv,2016,0.5107738707976467,0.4892261292023533
662,P Storm,117991727,326711,117665016,2019.csv,2019,0.0027689314183866466,0.9972310685816134
663,Saving Mr. Banks,117867984,83301580,34566404,2013.csv,2013,0.7067362753909493,0.29326372460905076
664,Pompeii,117831631,23219748,94611883,2014.csv,2014,0.19705869979852864,0.8029413002014714
665,Magic Mike XXL,117813057,66013057,51800000,2015.csv,2015,0.5603203811271954,0.43967961887280455
666,Game Night,117679066,69179066,48500000,2018.csv,2018,0.5878621266419637,0.41213787335803637
667,Water for Elephants,117094902,58709717,58385185,2011.csv,2011,0.5013857648559286,0.49861423514407144
668,Warm Bodies,116980662,66380662,50600000,2013.csv,2013,0.5674498747493838,0.4325501252506162
669,Abraham Lincoln: Vampire Hunter,116471580,37519139,78952441,2012.csv,2012,0.32213127872052566,0.6778687212794744
670,Personal Tailor,116126458,375892,115750566,2013.csv,2013,0.0032369195312923434,0.9967630804687077
671,The Iron Lady,115890699,30017992,85872707,2011.csv,2011,0.25901985456140875,0.7409801454385913
672,A Nightmare on Elm Street,115694863,63075011,52619852,2010.csv,2010,0.5451841971583474,0.4548158028416525
673,Detective Conan: The Fist of Blue Sapphire,115570314,0,115570314,2019.csv,2019,0.0,1.0
674,Dragon Ball Super: Broly,115560610,30712119,84848491,2018.csv,2018,0.2657663281632037,0.7342336718367963
675,Pitch Perfect,115350426,65001093,50349333,2012.csv,2012,0.5635097784554346,0.4364902215445654
676,The Gentlemen,115171795,36471795,78700000,2019.csv,2019,0.31667297535824634,0.6833270246417537
677,The Monkey King 3,115084576,187074,114897502,2018.csv,2018,0.0016255349457081026,0.998374465054292
678,Dear John,114984666,80014842,34969824,2010.csv,2010,0.6958740220195969,0.3041259779804031
679,So Young,114926694,11186,114915508,2013.csv,2013,9.733160861653256e-05,0.9999026683913834
680,Finding Mr Right 2,114679097,0,114679097,2016.csv,2016,0.0,1.0
681,Office Christmas Party,114501299,54767494,59733805,2016.csv,2016,0.47831329843690246,0.5216867015630976
682,Hope Springs,114281051,63536011,50745040,2012.csv,2012,0.5559627816163504,0.4440372183836496
683,Seventh Son,114178613,17223265,96955348,2014.csv,2014,0.15084493100297164,0.8491550689970284
684,The Dark Tower,113231078,50701325,62529753,2017.csv,2017,0.44776863291895885,0.5522313670810411
685,Pet Sematary,113118226,54724696,58393530,2019.csv,2019,0.4837831880425706,0.5162168119574294
686,Insidious: Chapter 3,112983889,52218558,60765331,2015.csv,2015,0.46217702773534375,0.5378229722646563
687,Cats & Dogs: The Revenge of Kitty Galore,112483764,43585753,68898011,2010.csv,2010,0.3874848373672844,0.6125151626327155
688,Tooth Fairy,112462508,60022256,52440252,2010.csv,2010,0.5337090295016362,0.46629097049836377
689,Boonie Bears: Blast Into the Past,112369259,0,112369259,2019.csv,2019,0.0,1.0
690,How to Be Single,112343513,46843513,65500000,2016.csv,2016,0.4169667811616324,0.5830332188383677
691,The Purge: Anarchy,111928365,71962800,39965565,2014.csv,2014,0.6429362208587609,0.35706377914123916
692,"Dad, Where Are We Going?",111870000,0,111870000,2014.csv,2014,0.0,1.0
693,Get Hard,111711453,90411453,21300000,2015.csv,2015,0.809330203591569,0.19066979640843093
694,Good Boys,111037232,83140306,27896926,2019.csv,2019,0.748760613917321,0.251239386082679
695,The Call of the Wild,110992779,62342368,48650411,2020.csv,2020,0.5616794944831501,0.43832050551684987
696,Free Birds,110387072,55750480,54636592,2013.csv,2013,0.5050453734292364,0.49495462657076367
697,10 Cloverfield Lane,110216998,72082998,38134000,2016.csv,2016,0.6540098107190326,0.34599018928096736
698,Moneyball,110206216,75605492,34600724,2011.csv,2011,0.6860365480654921,0.3139634519345079
699,Buddies in India,110155128,293194,109861934,2017.csv,2017,0.002661646401064506,0.9973383535989355
700,The 5th Wave,109906372,34916787,74989585,2015.csv,2015,0.3176957474312772,0.6823042525687227
701,Along With the Gods: The Two Worlds,109383972,1908823,107475149,2017.csv,2017,0.017450664526974757,0.9825493354730253
702,Sanctum,108609310,23209310,85400000,2010.csv,2010,0.2136954005140075,0.7863045994859925
703,The Boxtrolls,108255770,50837305,57418465,2014.csv,2014,0.4696036525351027,0.5303963474648973
704,Neighbors 2: Sorority Rising,108007109,55455765,52551344,2016.csv,2016,0.5134455084803723,0.48655449151962765
705,Horrible Bosses 2,107645357,54445357,53200000,2014.csv,2014,0.5057845365313806,0.49421546346861944
706,Paul Blart: Mall Cop 2,107588225,71038190,36550035,2015.csv,2015,0.6602784830774929,0.33972151692250707
707,Vacation,107228221,58884188,48344033,2015.csv,2015,0.5491482321617552,0.45085176783824477
708,ParaNorman,107139399,56003051,51136348,2012.csv,2012,0.5227120137196215,0.4772879862803785
709,Harmony,107056263,0,107056263,2010.csv,2010,0.0,1.0
710,The Man from U.N.C.L.E.,107045109,45445109,61600000,2015.csv,2015,0.42454166682197503,0.575458333178025
711,The Breakup Guru,106980263,208959,106771304,2014.csv,2014,0.00195324814260365,0.9980467518573963
712,Hereafter,106956330,32746941,74209389,2010.csv,2010,0.30617113545313307,0.693828864546867
713,Chronicles of the Ghostly Tribe,106380000,0,106380000,2015.csv,2015,0.0,1.0
714,Shaun the Sheep Movie,106209378,19375982,86833396,2015.csv,2015,0.18243193176406702,0.817568068235933
715,Life as We Know It,105734416,53374681,52359735,2010.csv,2010,0.50479950634049,0.4952004936595101
716,First Man,105697415,44936545,60760870,2018.csv,2018,0.4251432733714443,0.5748567266285557
717,Gangster Squad,105200903,46000903,59200000,2013.csv,2013,0.4372671877160598,0.5627328122839402
718,Sisters,105011053,87044645,17966408,2015.csv,2015,0.8289093625220576,0.17109063747794245
719,The Campaign,104907746,86907746,18000000,2012.csv,2012,0.8284206773444546,0.17157932265554537
720,Let the Bullets Fly,104723314,63012,104660302,2010.csv,2010,0.0006016998277957476,0.9993983001722042
721,Raya and the Last Dragon,104622415,35302329,69320086,2021.csv,2021,0.3374260573128617,0.6625739426871383
722,Scary Stories to Tell in the Dark,104545505,68947075,35598430,2019.csv,2019,0.6594934425922951,0.3405065574077049
723,Book Club,104438188,68566296,35871892,2018.csv,2018,0.6565251400187065,0.34347485998129346
724,The Tales of Wukong,103818506,0,103818506,2017.csv,2017,0.0,1.0
725,Ouija,103590271,50856010,52734261,2014.csv,2014,0.49093423068658637,0.5090657693134136
726,Birdman or (The Unexpected Virtue of Ignorance),103215094,42340598,60874496,2014.csv,2014,0.41021711417518064,0.5897828858248194
727,Cold War II,103197501,560824,102636677,2016.csv,2016,0.00543447268165922,0.9945655273183408
728,Night School,103105878,77339130,25766748,2018.csv,2018,0.75009428657404,0.24990571342596005
729,Transcendence,103039258,23022309,80016949,2014.csv,2014,0.22343240282262125,0.7765675971773788
730,Jigsaw,102952888,38052832,64900056,2017.csv,2017,0.3696140316141496,0.6303859683858505
731,Love & Other Drugs,102820008,32367005,70453003,2010.csv,2010,0.31479286599549766,0.6852071340045023
732,Chappie,102811889,31569268,71242621,2015.csv,2015,0.3070585348354022,0.6929414651645979
733,Star Wars: Episode I - The Phantom Menace 2012 3D Release,102739593,43456382,59283211,2012.csv,2012,0.4229759991359903,0.5770240008640096
734,Project X,102731865,54731865,48000000,2012.csv,2012,0.5327642499238187,0.46723575007618134
735,Railroad Tigers,102205175,218044,101987131,2016.csv,2016,0.002133394908819441,0.9978666050911805
736,Heaven Is for Real,101888019,91443253,10444766,2014.csv,2014,0.8974877900020806,0.10251220999791938
737,Detective Conan: Zero the Enforcer,101860359,0,101860359,2018.csv,2018,0.0,1.0
738,The Devil Inside,101758490,53261944,48496546,2012.csv,2012,0.5234152354265477,0.4765847645734523
739,Joy,101134059,56451232,44682827,2015.csv,2015,0.5581822044737669,0.4418177955262332
740,"Alexander and the Terrible, Horrible, No Good, Very Bad Day",100654149,66954149,33700000,2014.csv,2014,0.665190155251325,0.334809844748675
741,Life,100541806,30234022,70307784,2017.csv,2017,0.30071095003008,0.69928904996992
742,Instructions Not Included,100486616,44467206,56019410,2013.csv,2013,0.44251869323572407,0.557481306764276
743,Tammy,100375432,84525432,15850000,2014.csv,2014,0.8420928340313395,0.15790716596866053
744,PK,100370104,10616104,89754000,2014.csv,2014,0.10576958254422054,0.8942304174557795
745,Aftershock,100293273,62962,100230311,2010.csv,2010,0.0006277788940041871,0.9993722211059958
746,Philomena,100129872,37709979,62419893,2013.csv,2013,0.376610678180034,0.623389321819966
747,The Continent,100125957,0,100125957,2014.csv,2014,0.0,1.0
748,Atomic Blonde,100014025,51687870,48326155,2017.csv,2017,0.5168062179279356,0.48319378207206437
749,Tom and Jerry,99997000,41197000,58800000,2021.csv,2021,0.4119823594707841,0.5880176405292159
750,The Book of Life,99783556,50151543,49632013,2014.csv,2014,0.5026032846534353,0.4973967153465647
751,Black Mass,99775678,62575678,37200000,2015.csv,2015,0.6271636460340565,0.3728363539659435
752,Insidious,99557032,54009150,45547882,2011.csv,2011,0.5424945773795266,0.45750542262047345
753,Line Walker 2: Invisible Spy,99482027,296751,99185276,2019.csv,2019,0.002982960932229497,0.9970170390677705
754,The Lucky One,99357138,60457138,38900000,2012.csv,2012,0.6084830865397914,0.39151691346020856
755,Blue Jasmine,99104804,33405481,65699323,2013.csv,2013,0.3370722674553698,0.6629277325446302
756,Ode to My Father,99085291,2300121,96785170,2014.csv,2014,0.023213546398122804,0.9767864536018772
757,Justin Bieber: Never Say Never,99036827,73013910,26022917,2011.csv,2011,0.7372399965923787,0.2627600034076213
758,Young Detective Dee: Rise of the Sea Dragon,98774891,87783,98687108,2013.csv,2013,0.0008887177612780155,0.999111282238722
759,Spotlight,98690254,45055776,53634478,2015.csv,2015,0.45653723821604514,0.5434627617839549
760,Umizaru 3: The Last Message,98663381,0,98663381,2010.csv,2010,0.0,1.0
761,Devil and Angel,98599942,131058,98468884,2015.csv,2015,0.0013291894228497619,0.9986708105771502
762,The Visit,98450062,65206105,33243957,2015.csv,2015,0.6623267032579421,0.3376732967420579
763,Riddick,98337295,42025135,56312160,2013.csv,2013,0.4273570368190421,0.572642963180958
764,Alpha,98203196,35857181,62346015,2018.csv,2018,0.36513252582940375,0.6348674741705962
765,Killers,98159963,47059963,51100000,2010.csv,2010,0.4794211566685289,0.5205788433314711
766,Paul,97984015,37412945,60571070,2011.csv,2011,0.3818270255612612,0.6181729744387388
767,Along With the Gods: The Last 49 Days,97962238,1200246,96761992,2018.csv,2018,0.012252129233715547,0.9877478707662845
768,A Simple Favor,97644617,53548586,44096031,2018.csv,2018,0.5484028474401206,0.4515971525598795
769,Safe Haven,97594140,71349120,26245020,2013.csv,2013,0.7310799603336839,0.26892003966631606
770,The Little Prince,97571250,1339152,96232098,2015.csv,2015,0.013724862600407395,0.9862751373995926
771,Evil Dead,97542952,54239856,43303096,2013.csv,2013,0.5560612518677925,0.44393874813220746
772,42,97470701,95020213,2450488,2013.csv,2013,0.9748592348792074,0.025140765120792555
773,Scream 4,97138686,38180928,58957758,2011.csv,2011,0.39305584183010256,0.6069441581698974
774,Legend of the Demon Cat,97051623,0,97051623,2017.csv,2017,0.0,1.0
775,The Shack,96942115,57386418,39555697,2017.csv,2017,0.5919658138261168,0.40803418617388326
776,Boonie Bears 5,96788929,0,96788929,2018.csv,2018,0.0,1.0
777,The Rite,96560591,33047633,63512958,2011.csv,2011,0.34224762563849676,0.6577523743615032
778,Contraband,96262212,66528000,29734212,2012.csv,2012,0.6911123131057907,0.3088876868942093
779,Kick-Ass,96188903,48071303,48117600,2010.csv,2010,0.4997593433413,0.5002406566587
780,Assassination,96119773,1904682,94215091,2015.csv,2015,0.019815714712518098,0.9801842852874819
781,Think Like a Man,96070507,91547205,4523302,2012.csv,2012,0.9529168509540602,0.04708314904593977
782,Dolphin Tale,95932565,72286779,23645786,2011.csv,2011,0.7535165874069978,0.2464834125930022
783,The Favourite,95918706,34366783,61551923,2018.csv,2018,0.35829072798375744,0.6417092720162426
784,Some Like It Hot,95721320,100026,95621294,2016.csv,2016,0.001044970963626494,0.9989550290363735
785,The New King of Comedy,95618308,0,95618308,2019.csv,2019,0.0,1.0
786,Poltergeist,95437994,47425125,48012869,2015.csv,2015,0.49692080703205055,0.5030791929679495
787,The Mortal Instruments: City of Bones,95396573,31165421,64231152,2013.csv,2013,0.32669329746258285,0.6733067025374172
788,Truth or Dare,95330493,41411015,53919478,2018.csv,2018,0.43439421843753606,0.565605781562464
789,Rush,95224595,26947624,68276971,2013.csv,2013,0.28299016656358583,0.7170098334364142
790,The Hustle,95017038,35417038,59600000,2019.csv,2019,0.3727440756467277,0.6272559243532723
791,Adoring,94975692,0,94975692,2019.csv,2019,0.0,1.0
792,Kill Mobile,94870905,0,94870905,2018.csv,2018,0.0,1.0
793,I Feel Pretty,94539426,48795601,45743825,2018.csv,2018,0.5161402291568811,0.48385977084311893
794,Veteran,94393020,1200627,93192393,2015.csv,2015,0.01271944684045494,0.9872805531595451
795,Masquerade,94268432,922921,93345511,2012.csv,2012,0.009790350602203715,0.9902096493977963
796,Police Story: Lockdown,94249025,0,94249025,2013.csv,2013,0.0,1.0
797,Fleet of Time,94244191,569280,93674911,2014.csv,2014,0.006040478399353017,0.9939595216006469
798,Dirty Grandpa,94073028,35593113,58479915,2016.csv,2016,0.378356195784407,0.6216438042155931
799,Ben-Hur,94061311,26410477,67650834,2016.csv,2016,0.2807793844166174,0.7192206155833827
800,Blockers,94017294,60311495,33705799,2018.csv,2018,0.6414936277574634,0.35850637224253656
801,In the Heart of the Sea,93920758,25020758,68900000,2015.csv,2015,0.26640285420183685,0.7335971457981632
802,The Man from Macau,93864936,0,93864936,2014.csv,2014,0.0,1.0
803,Nothing to Declare,93811164,0,93811164,2011.csv,2011,0.0,1.0
804,Kill Zone 2,93638358,11998,93626360,2015.csv,2015,0.00012813125151126635,0.9998718687484888
805,The Internship,93492844,44672764,48820080,2013.csv,2013,0.4778201420421011,0.5221798579578989
806,BlacKkKlansman,93400823,49275340,44125483,2018.csv,2018,0.5275685847008008,0.47243141529919924
807,Goosebumps 2: Haunted Halloween,93320380,46700633,46619747,2018.csv,2018,0.5004333780038187,0.49956662199618135
808,Money Monster,93282604,41012075,52270529,2016.csv,2016,0.43965405382551287,0.5603459461744872
809,Nanny McPhee Returns,93251121,29011215,64239906,2010.csv,2010,0.3111084852266816,0.6888915147733183
810,Train to Busan,92742323,2129768,90612555,2016.csv,2016,0.022964359001445327,0.9770356409985547
811,Southpaw,91970827,52421953,39548874,2015.csv,2015,0.5699845778270538,0.4300154221729462
812,Brave Hearts: Umizaru,91884352,0,91884352,2012.csv,2012,0.0,1.0
813,Endgame,91815762,23149,91792613,2021.csv,2021,0.0002521244663851943,0.9997478755336148
814,Get Him to the Greek,91720255,60974475,30745780,2010.csv,2010,0.6647874561622185,0.33521254383778154
815,Shadow,91708374,521396,91186978,2018.csv,2018,0.005685369582498541,0.9943146304175015
816,Season of the Witch,91627228,24827228,66800000,2011.csv,2011,0.2709590647007241,0.7290409352992759
817,Crawl,91542097,39014193,52527904,2019.csv,2019,0.4261885436161682,0.5738114563838318
818,Five Feet Apart,91522094,45729221,45792873,2019.csv,2019,0.49965225883052894,0.500347741169471
819,Rambo: Last Blood,91490353,44819352,46671001,2019.csv,2019,0.4898806325514997,0.5101193674485003
820,Overboard,91244913,50316123,40928790,2018.csv,2018,0.551440308787406,0.448559691212594
821,Paranormal Activity: The Marked Ones,90894962,32462372,58432590,2014.csv,2014,0.35714159823291414,0.6428584017670859
822,My Big Fat Greek Wedding 2,90632641,59689605,30943036,2016.csv,2016,0.6585883887020351,0.34141161129796493
823,Sherlock Gnomes,90497778,43242871,47254907,2018.csv,2018,0.4778335110062039,0.522166488993796
824,Jojo Rabbit,90335025,33370906,56964119,2019.csv,2019,0.369412705647671,0.630587294352329
825,Red Riding Hood,90260376,37662162,52598214,2011.csv,2011,0.4172613019028416,0.5827386980971584
826,Detective Dee: The Four Heavenly Kings,90040771,262963,89777808,2018.csv,2018,0.0029204880975530517,0.9970795119024469
827,Sucker Punch,89792502,36392502,53400000,2011.csv,2011,0.4052955557469598,0.5947044442530401
828,Burlesque,89519773,39440655,50079118,2010.csv,2010,0.4405803732321797,0.5594196267678203
829,The Hundred-Foot Journey,89514453,54240821,35273632,2014.csv,2014,0.6059448411085079,0.39405515889149206
830,The Purge,89328627,64473115,24855512,2013.csv,2013,0.7217519978226017,0.2782480021773983
831,The Last Song,89137047,62950384,26186663,2010.csv,2010,0.7062202094265025,0.29377979057349746
832,The Inbetweeners,88823111,36000,88787111,2011.csv,2011,0.00040529992244923735,0.9995947000775508
833,Collateral Beauty,88528280,31016021,57512259,2016.csv,2016,0.350351559976089,0.649648440023911
834,Line Walker,88228755,0,88228755,2016.csv,2016,0.0,1.0
835,This Is 40,88215156,67544505,20670651,2012.csv,2012,0.7656791424820469,0.23432085751795304
836,Dhoom 3,88031955,8031955,80000000,2013.csv,2013,0.09123908471645324,0.9087609152835467
837,Chasing the Dragon,87965942,456854,87509088,2017.csv,2017,0.005193532742478902,0.9948064672575211
838,Deliver Us from Evil,87937815,30577122,57360693,2014.csv,2014,0.3477130060600209,0.652286993939979
839,Tiger Zinda Hai,87320000,5560921,81759079,2017.csv,2017,0.06368439074667888,0.9363156092533211
840,Pain & Gain,87305549,49875291,37430258,2013.csv,2013,0.5712728637672274,0.42872713623277253
841,Sultan,87280000,6200000,81080000,2016.csv,2016,0.07103574702108158,0.9289642529789184
842,A Million Ways to Die in the West,87189756,43139300,44050456,2014.csv,2014,0.49477486781818725,0.5052251321818128
843,The Thieves,87126367,685839,86440528,2012.csv,2012,0.007871773191231536,0.9921282268087684
844,About Time,87100449,15322921,71777528,2013.csv,2013,0.17592241114623874,0.8240775888537613
845,American Dreams in China,87097067,0,87097067,2013.csv,2013,0.0,1.0
846,"Hello, Mrs. Money",86874070,0,86874070,2018.csv,2018,0.0,1.0
847,Dinner for Schmucks,86855739,73026337,13829402,2010.csv,2010,0.8407773376955552,0.15922266230444485
848,Snowpiercer,86758912,4563650,82195262,2013.csv,2013,0.052601512568530136,0.9473984874314698
849,The Lincoln Lawyer,86752352,58009200,28743152,2011.csv,2011,0.6686758187259292,0.3313241812740708
850,Robin Hood,86489031,30824628,55664403,2018.csv,2018,0.35639927564918605,0.643600724350814
851,A Taxi Driver,86252940,1527829,84725111,2017.csv,2017,0.01771335562590678,0.9822866443740932
852,War Dogs,86234523,43034523,43200000,2016.csv,2016,0.4990405408747956,0.5009594591252045
853,Step Up All In,86165646,14904384,71261262,2014.csv,2014,0.1729736233858213,0.8270263766141787
854,Hall Pass,86157237,45060734,41096503,2011.csv,2011,0.523005792305062,0.47699420769493805
855,I Can Only Imagine,86086881,83482352,2604529,2018.csv,2018,0.9697453436604353,0.030254656339564676
856,John Wick,86013056,43037835,42975221,2014.csv,2014,0.5003639796265348,0.49963602037346516
857,The Second Best Exotic Marigold Hotel,85978266,33078266,52900000,2015.csv,2015,0.38472822887588826,0.6152717711241118
858,Spy Kids 4-D: All the Time in the World,85564310,38538188,47026122,2011.csv,2011,0.45040026618574963,0.5495997338142503
859,Paper Towns,85512300,32000304,53511996,2015.csv,2015,0.37421872642882953,0.6257812735711704
860,The Possession,85446075,49130154,36315921,2012.csv,2012,0.5749843278348362,0.42501567216516384
861,Big Fish & Begonia,85409373,0,85409373,2016.csv,2016,0.0,1.0
862,Bayside Shakedown 3: Set the Guys Loose,85347374,0,85347374,2010.csv,2010,0.0,1.0
863,Nerve,85251425,38583626,46667799,2016.csv,2016,0.4525862881470896,0.5474137118529103
864,Hidden Man,85170581,0,85170581,2018.csv,2018,0.0,1.0
865,J. Edgar,84920539,37306030,47614509,2011.csv,2011,0.4393051485459837,0.5606948514540163
866,Going in Style,84918541,45018541,39900000,2017.csv,2017,0.5301379471416025,0.46986205285839755
867,Sicario,84872444,46889293,37983151,2015.csv,2015,0.5524678068655593,0.44753219313444065
868,Carrie,84790678,35266619,49524059,2013.csv,2013,0.41592566343201076,0.5840743365679892
869,The Judge,84419388,47119388,37300000,2014.csv,2014,0.5581583699706517,0.44184163002934823
870,What to Expect When You're Expecting,84384002,41152203,43231799,2012.csv,2012,0.4876777828100639,0.5123222171899361
871,Leap!,84197417,2844490,81352927,2016.csv,2016,0.0337835779451524,0.9662164220548476
872,Finding Mr. Right,84112033,6945,84105088,2013.csv,2013,8.256844772733052e-05,0.9999174315522726
873,Our Times,83867493,0,83867493,2015.csv,2015,0.0,1.0
874,Marmaduke,83761844,33644788,50117056,2010.csv,2010,0.40167200712534457,0.5983279928746554
875,Mortal Engines,83672673,15951040,67721633,2018.csv,2018,0.19063619492591088,0.8093638050740891
876,Piranha 3D,83188165,25003155,58185010,2010.csv,2010,0.30056144404675833,0.6994385559532417
877,Oceans,83090556,19422319,63668237,2010.csv,2010,0.23374881496761196,0.766251185032388
878,Rings,83080890,27793018,55287872,2017.csv,2017,0.33452961324800445,0.6654703867519955
879,Suck Me Shakespeer 2,83027924,0,83027924,2015.csv,2015,0.0,1.0
880,Savages,82966152,47382068,35584084,2012.csv,2012,0.5711011883496778,0.4288988116503222
881,Once Upon A Time,82886178,485728,82400450,2017.csv,2017,0.005860180933906736,0.9941398190660933
882,The Fighter Pilot,82879386,0,82879386,2013.csv,2013,0.0,1.0
883,"Big Mommas: Like Father, Like Son",82686066,37915414,44770652,2011.csv,2011,0.4585465947793429,0.5414534052206571
884,Sinister,82515113,48086903,34428210,2012.csv,2012,0.5827647960683275,0.4172352039316725
885,Act of Valor,82497035,70012847,12484188,2012.csv,2012,0.8486710704208945,0.1513289295791055
886,Hitman: Agent 47,82347656,22467450,59880206,2015.csv,2015,0.2728365455842483,0.7271634544157517
887,Tiny Times 3.0,82320000,0,82320000,2014.csv,2014,0.0,1.0
888,Blades of Blood 2010 Re-release,82177196,0,82177196,2010.csv,2010,0.0,1.0
889,Miracle in Cell No. 7,82101723,0,82101723,2013.csv,2013,0.0,1.0
890,Abduction,82087155,28087155,54000000,2011.csv,2011,0.34216260753585626,0.6578373924641437
891,Ouija: Origin of Evil,81705746,35144505,46561241,2016.csv,2016,0.43013504827432825,0.5698649517256718
892,One Piece: Stampede,81562741,1298528,80264213,2019.csv,2019,0.01592060276640286,0.9840793972335972
893,Frankenweenie,81491068,35291068,46200000,2012.csv,2012,0.43306670124877983,0.5669332987512202
894,Wolf Warrior,81411331,0,81411331,2015.csv,2015,0.0,1.0
895,Gone with the Bullets,81387479,0,81387479,2014.csv,2014,0.0,1.0
896,Tinker Tailor Soldier Spy,81244605,24149393,57095212,2011.csv,2011,0.297243035399089,0.7027569646009111
897,Edge of Darkness,81126522,43313890,37812632,2010.csv,2010,0.5339054224461884,0.46609457755381156
898,Partment: The Movie,81096321,0,81096321,2018.csv,2018,0.0,1.0
899,Underworld: Blood Wars,81093313,30353973,50739340,2016.csv,2016,0.37430919858953104,0.625690801410469
900,Doraemon the Movie: Nobita's Treasure Island,80920916,0,80920916,2018.csv,2018,0.0,1.0
901,A Dog's Way Home,80708134,42004346,38703788,2019.csv,2019,0.5204474929379485,0.4795525070620515
902,Go Away Mr. Tumor,80606893,286639,80320254,2015.csv,2015,0.0035560110225312867,0.9964439889774687
903,Vampires Suck,80547866,36661504,43886362,2010.csv,2010,0.4551517727359779,0.5448482272640222
904,Caught in Time,80543319,0,80543319,2020.csv,2020,0.0,1.0
905,Den of Thieves,80509622,44947622,35562000,2018.csv,2018,0.5582888216764947,0.44171117832350526
906,Muppets Most Wanted,80383113,51183113,29200000,2014.csv,2014,0.6367396221641727,0.36326037783582726
907,Hereditary,80200936,44069456,36131480,2018.csv,2018,0.5494880508626483,0.4505119491373517
908,The Wedding Ringer,79799880,64460211,15339669,2015.csv,2015,0.8077732823658381,0.19222671763416185
909,The Grey,79781695,51580236,28201459,2012.csv,2012,0.6465171741462751,0.353482825853725
910,Letters to Juliet,79293444,53032453,26260991,2010.csv,2010,0.6688125817816666,0.3311874182183334
911,Paradox,79226860,0,79226860,2017.csv,2017,0.0,1.0
912,Manchester by the Sea,78988148,47695371,31292777,2016.csv,2016,0.603829463124012,0.396170536875988
913,Lady Bird,78965611,48958273,30007338,2017.csv,2017,0.6199948608008617,0.3800051391991382
914,Paranormal Activity: The Ghost Dimension,78903124,18300124,60603000,2015.csv,2015,0.2319315519116835,0.7680684480883165
915,The Boss,78844582,63285885,15558697,2016.csv,2016,0.8026662504216207,0.1973337495783794
916,Code Blue the Movie,78778562,0,78778562,2018.csv,2018,0.0,1.0
917,Spanish Affair,78768613,0,78768613,2014.csv,2014,0.0,1.0
918,The Attorney,78547586,557236,77990350,2013.csv,2013,0.007094247301247424,0.9929057526987526
919,The Family,78418811,36918811,41500000,2013.csv,2013,0.47079024189744473,0.5292097581025552
920,Scary Movie V,78378744,32015787,46362957,2013.csv,2013,0.4084753769465864,0.5915246230534136
921,R.I.P.D.,78324220,33618855,44705365,2013.csv,2013,0.4292268087700075,0.5707731912299925
922,Priest,78309505,29137000,49172505,2011.csv,2011,0.37207488414082046,0.6279251158591795
923,If I Stay,78274843,50474843,27800000,2014.csv,2014,0.6448411911857811,0.3551588088142189
924,Tag,78130625,54730625,23400000,2018.csv,2018,0.7005015638874001,0.2994984361125999
925,Head Full of Honey,78127384,0,78127384,2014.csv,2014,0.0,1.0
926,The Left Ear,78015473,0,78015473,2015.csv,2015,0.0,1.0
927,Shin Godzilla,77947607,1918403,76029204,2016.csv,2016,0.024611441888139043,0.975388558111861
928,Tiny Times 4.0,77750000,0,77750000,2015.csv,2015,0.0,1.0
929,Boonie Bears: The Wild Life,77725611,0,77725611,2021.csv,2021,0.0,1.0
930,Tiny Times,77717014,23462,77693552,2013.csv,2013,0.0003018901369525082,0.9996981098630475
931,Suck Me Shakespeer,77676735,0,77676735,2013.csv,2013,0.0,1.0
932,The Back-up Plan,77477008,37490007,39987001,2010.csv,2010,0.48388558060992753,0.5161144193900725
933,Diary of a Wimpy Kid: Dog Days,77229695,49008662,28221033,2012.csv,2012,0.6345831354118386,0.3654168645881613
934,Fantastica: A Boonie Bears Adventure,77151096,0,77151096,2017.csv,2017,0.0,1.0
935,Mike and Dave Need Wedding Dates,77068246,46009673,31058573,2016.csv,2016,0.596999093504736,0.40300090649526393
936,Drive,76976666,35061555,41915111,2011.csv,2011,0.45548289919441304,0.544517100805587
937,"I, Frankenstein",76801179,19075290,57725889,2014.csv,2014,0.248372358971208,0.751627641028792
938,Sanju,76693052,7909317,68783735,2018.csv,2018,0.10312951165380665,0.8968704883461933
939,The Book Thief,76586316,21488481,55097835,2013.csv,2013,0.28057859578987976,0.7194214042101202
940,Cold Pursuit,76419755,32138862,44280893,2019.csv,2019,0.42055698817668286,0.5794430118233171
941,The Ides of March,76338111,40962534,35375577,2011.csv,2011,0.5365934978401549,0.4634065021598452
942,Kubo and the Two Strings,76249438,48023088,28226350,2016.csv,2016,0.6298156322148892,0.37018436778511077
943,Diary of a Wimpy Kid,76196538,64003625,12192913,2010.csv,2010,0.8399807482066968,0.16001925179330326
944,The Mechanic,76130093,29121498,47008595,2011.csv,2011,0.38252282182290254,0.6174771781770975
945,If You Are the One 2,76085443,426894,75658549,2010.csv,2010,0.005610718465554574,0.9943892815344454
946,Vice,76073488,47836282,28237206,2018.csv,2018,0.6288167304751426,0.3711832695248573
947,Widows,75984700,42402632,33582068,2018.csv,2018,0.5580417110286676,0.4419582889713324
948,Quo vado?,75878701,0,75878701,2016.csv,2016,0.0,1.0
949,Sicario: Day of the Soldado,75837743,50072235,25765508,2018.csv,2018,0.6602548153364743,0.33974518466352566
950,A Dog's Journey,75727748,22782371,52945377,2019.csv,2019,0.30084574811335996,0.69915425188664
951,Bajrangi Bhaijaan,75547184,8178001,67369183,2015.csv,2015,0.10825024265629808,0.8917497573437019
952,Searching,75462037,26020957,49441080,2018.csv,2018,0.3448218208050758,0.6551781791949242
953,The Change-Up,75450437,37081475,38368962,2011.csv,2011,0.49146799507602584,0.5085320049239741
954,The Spy Who Dumped Me,75320680,33562069,41758611,2018.csv,2018,0.4455890334500432,0.5544109665499568
955,Larry Crowne,75055070,35608245,39446825,2011.csv,2011,0.47442824315532584,0.5255717568446742
956,Easy A,75026216,58401464,16624752,2010.csv,2010,0.7784140946146078,0.22158590538539222
957,Animal World,74922830,0,74922830,2018.csv,2018,0.0,1.0
958,Boo! A Madea Halloween,74827344,73206343,1621001,2016.csv,2016,0.9783367828744529,0.021663217125547047
959,A Madea Family Funeral,74747725,73257045,1490680,2019.csv,2019,0.9800571856869222,0.019942814313077754
960,Crimson Peak,74679822,31090320,43589502,2014.csv,2014,0.4163148648104705,0.5836851351895295
961,Escape from Planet Earth,74597643,57012977,17584666,2013.csv,2013,0.7642731687916735,0.23572683120832652
962,Thermae Romae,74285251,0,74285251,2012.csv,2012,0.0,1.0
963,Hubble 3D,74249729,52522904,21726825,2010.csv,2010,0.7073817602755156,0.29261823972448436
964,One Piece Film Z,74223861,0,74223861,2012.csv,2012,0.0,1.0
965,August: Osage County,74188937,37738810,36450127,2013.csv,2013,0.5086851426379111,0.4913148573620889
966,Miracles from Heaven,73983003,61705123,12277880,2016.csv,2016,0.8340445845378837,0.16595541546211634
967,Cats,73835438,27166770,46668668,2019.csv,2019,0.3679367352029523,0.6320632647970478
968,Charlie's Angels,73279888,17803077,55476811,2019.csv,2019,0.24294629107511737,0.7570537089248827
969,War Room,73267874,67790117,5477757,2015.csv,2015,0.9252365777666758,0.07476342223332426
970,To Rome With Love,73244881,16685867,56559014,2012.csv,2012,0.22780932636097806,0.7721906736390219
971,Here Comes the Boom,73100172,45290318,27809854,2012.csv,2012,0.6195651359069305,0.3804348640930694
972,My Old Classmate,73052128,0,73052128,2014.csv,2014,0.0,1.0
973,Bayside Shakedown the Final,72867395,0,72867395,2012.csv,2012,0.0,1.0
974,The Best Man Holiday,72835710,70525195,2310515,2013.csv,2013,0.9682777170703766,0.0317222829296234
975,The Bélier Family,72751538,0,72751538,2014.csv,2014,0.0,1.0
976,The Transporter Refueled,72629670,16029670,56600000,2015.csv,2015,0.22070415575342694,0.779295844246573
977,Diary of a Wimpy Kid: Rodrick Rules,72526996,52698535,19828461,2011.csv,2011,0.7266057868989914,0.27339421310100864
978,Amazing China,72506343,0,72506343,2018.csv,2018,0.0,1.0
979,Doctor Sleep,72381712,31581712,40800000,2019.csv,2019,0.4363217051290525,0.5636782948709476
980,Serial (Bad) Weddings 2,72300780,0,72300780,2019.csv,2019,0.0,1.0
981,Second Act,72282227,39282227,33000000,2018.csv,2018,0.5434562357908536,0.45654376420914644
982,What Men Want,72216294,54611903,17604391,2019.csv,2019,0.7562268841987377,0.24377311580126224
983,Run All Night,71561644,26461644,45100000,2015.csv,2015,0.3697741208963841,0.6302258791036159
984,Brick Mansions,71416730,20396829,51019901,2014.csv,2014,0.28560295325759105,0.714397046742409
985,Pokémon: Zoroark: Master of Illusions,71143529,0,71143529,2010.csv,2010,0.0,1.0
986,The Counselor,71009334,16973715,54035619,2013.csv,2013,0.23903498376706364,0.7609650162329363
987,Son of God,70829270,59700064,11129206,2014.csv,2014,0.842872784090532,0.15712721590946793
988,I Am Not Madame Bovary,70826207,436798,70389409,2016.csv,2016,0.006167180461887504,0.9938328195381125
989,A Turtle's Tale: Sammy's Adventures,70627617,0,70627617,2010.csv,2010,0.0,1.0
990,Spirited Away 2018 Re-release,70186029,1175067,69010962,2018.csv,2018,0.016742178133485795,0.9832578218665142
991,Think Like a Man Too,70181428,65182182,4999246,2014.csv,2014,0.9287668241803231,0.07123317581967696
992,Bai du ren,70065569,0,70065569,2016.csv,2016,0.0,1.0
993,The Cabin in the Woods,69935600,42073277,27862323,2012.csv,2012,0.6016002865493397,0.39839971345066033
994,Sole a catinelle,69903094,0,69903094,2013.csv,2013,0.0,1.0
995,After,69756455,12138565,57617890,2019.csv,2019,0.1740135016895569,0.8259864983104431
996,The Dilemma,69721966,48475290,21246676,2011.csv,2011,0.6952656785380952,0.3047343214619048
997,Exit,69501772,470699,69031073,2019.csv,2019,0.006772474808268198,0.9932275251917319
998,The Last Exorcism,69432527,41034350,28398177,2010.csv,2010,0.5909960615433167,0.40900393845668326
999,Playing with Fire,69412425,44451847,24960578,2019.csv,2019,0.6404018732957392,0.3595981267042608
1000,13 Hours,69411370,52853219,16558151,2015.csv,2015,0.7614490104431018,0.23855098955689824
1001,Finding Nemo 2012 3D Release,69328283,41128283,28200000,2012.csv,2012,0.5932396017942634,0.4067603982057366
1002,Takers,69055695,57744720,11310975,2010.csv,2010,0.8362050371080908,0.1637949628919092
1003,Anna Karenina,68929150,12816367,56112783,2012.csv,2012,0.18593536986891612,0.8140646301310839
1004,Bestseller,68813389,0,68813389,2010.csv,2010,0.0,1.0
1005,Running Man,68782475,310978,68471497,2015.csv,2015,0.004521180722269735,0.9954788192777303
1006,The Nut Job 2: Nutty by Nature,68743485,28370522,40372963,2017.csv,2017,0.41270124725273966,0.5872987527472603
1007,The Call,68572631,51872378,16700253,2013.csv,2013,0.7564589143444124,0.24354108565558757
1008,One Direction: This Is Us,68532898,28873374,39659524,2013.csv,2013,0.4213067715303678,0.5786932284696322
1009,Stalingrad,68316452,1013945,67302507,2013.csv,2013,0.014841886109659207,0.9851581138903408
1010,The Watch,68267862,35353000,32914862,2012.csv,2012,0.5178571433802922,0.4821428566197078
1011,Moonrise Kingdom,68263166,45512466,22750700,2012.csv,2012,0.6667207026407185,0.3332792973592816
1012,The Yin-Yang Master: Dream of Eternity,68000000,0,68000000,2020.csv,2020,0.0,1.0
1013,Shoplifters,67999335,3313513,64685822,2018.csv,2018,0.04872860889007223,0.9512713911099278
1014,Legion,67918658,40168080,27750578,2010.csv,2010,0.591414512342102,0.4085854876578981
1015,The American,67876281,35606376,32269905,2010.csv,2010,0.5245775913975016,0.4754224086024984
1016,A Beautiful Day in the Neighborhood,67760877,61704055,6056822,2019.csv,2019,0.9106147637374882,0.08938523626251177
1017,Jersey Boys,67647013,47047013,20600000,2014.csv,2014,0.6954780545890474,0.30452194541095257
1018,The Secret of the Gods,67537798,0,67537798,2012.csv,2012,0.0,1.0
1019,12 Strong,67450815,45819713,21631102,2018.csv,2018,0.6793055502739292,0.32069444972607075
1020,The Next Three Days,67448651,21148651,46300000,2010.csv,2010,0.3135518751887269,0.6864481248112732
1021,American Assassin,67234188,36249674,30984514,2017.csv,2017,0.5391553773208356,0.4608446226791644
1022,War,67179155,4654000,62525155,2019.csv,2019,0.06927744178979328,0.9307225582102068
1023,Skyline,66984887,21393620,45591267,2010.csv,2010,0.31937980279044137,0.6806201972095586
1024,The Giver,66980456,45090374,21890082,2014.csv,2014,0.6731870263767687,0.32681297362323125
1025,Madea's Witness Protection,66899242,65653242,1246000,2012.csv,2012,0.9813749758181116,0.018625024181888338
1026,Mulan,66800000,0,66800000,2020.csv,2020,0.0,1.0
1027,Selma,66787908,52076908,14711000,2014.csv,2014,0.779735577284439,0.22026442271556101
1028,A Violent Prosecutor,66736633,0,66736633,2015.csv,2015,0.0,1.0
1029,Victoria & Abdul,66558465,22245070,44313395,2017.csv,2017,0.33421849497280326,0.6657815050271968
1030,"Love, Simon",66316289,40826341,25489948,2018.csv,2018,0.615630663531248,0.38436933646875204
1031,Mile 22,66308758,36108758,30200000,2018.csv,2018,0.5445548836851989,0.4554451163148011
1032,One Piece Film: Gold,66207073,423593,65783480,2016.csv,2016,0.00639800221949096,0.9936019977805091
1033,Life of the Party,65859911,53059911,12800000,2018.csv,2018,0.8056480823364611,0.1943519176635389
1034,Beijing Love Story,65842375,428318,65414057,2014.csv,2014,0.0065052027664554936,0.9934947972335445
1035,The Age of Adaline,65663276,42629776,23033500,2015.csv,2015,0.6492179281460158,0.35078207185398425
1036,Eiga Doraemon: Nobita no getsumen tansaki,65406606,0,65406606,2019.csv,2019,0.0,1.0
1037,Moonlight,65336603,27854932,37481671,2016.csv,2016,0.42632966394044086,0.5736703360595592
1038,The House That Never Dies,65220000,0,65220000,2014.csv,2014,0.0,1.0
1039,Something Borrowed,65100369,39046489,26053880,2011.csv,2011,0.5997890580312993,0.40021094196870066
1040,The Pirates,64858224,415775,64442449,2014.csv,2014,0.006410520892462304,0.9935894791075377
1041,Hot Tub Time Machine,64735752,50287556,14448196,2010.csv,2010,0.7768127262969,0.22318727370309996
1042,God's Not Dead,64667874,60755732,3912142,2014.csv,2014,0.9395040882277961,0.060495911772203925
1043,The Darkest Hour,64626786,21443494,43183292,2011.csv,2011,0.3318050506178661,0.6681949493821339
1044,Happy Death Day 2U,64600152,28148130,36452022,2019.csv,2019,0.43572854131984085,0.5642714586801592
1045,L Storm,64517456,0,64517456,2018.csv,2018,0.0,1.0
1046,Monster Trucks,64493915,33370166,31123749,2016.csv,2016,0.5174157282900255,0.4825842717099745
1047,Monk Comes Down the Mountain,64455686,0,64455686,2015.csv,2015,0.0,1.0
1048,Capernaum,64417003,1661096,62755907,2018.csv,2018,0.025786607923997954,0.974213392076002
1049,Fences,64414761,57682904,6731857,2016.csv,2016,0.8954920130806664,0.10450798691933359
1050,Zhongkui: Snow Girl and the Dark Crystal,64325947,165428,64160519,2015.csv,2015,0.002571714956641058,0.9974282850433589
1051,Isle of Dogs,64241499,32015231,32226268,2018.csv,2018,0.49835747139088393,0.5016425286091161
1052,Suck Me Shakespeer 3,64236772,0,64236772,2017.csv,2017,0.0,1.0
1053,Thunder and the House of Magic,64197205,4091,64193114,2013.csv,2013,6.372551577595941e-05,0.9999362744842241
1054,The Danish Girl,64191523,11114018,53077505,2015.csv,2015,0.1731384064528271,0.8268615935471729
1055,The Boy,64188367,35819556,28368811,2015.csv,2015,0.5580381255064488,0.4419618744935511
1056,The Grandmaster,64076736,6594959,57481777,2013.csv,2013,0.10292282990194757,0.8970771700980524
1057,The Pirate Fairy,63998725,0,63998725,2014.csv,2014,0.0,1.0
1058,The Inbetweeners 2,63852235,0,63852235,2014.csv,2014,0.0,1.0
1059,Hanna,63782078,40259119,23522959,2011.csv,2011,0.6311979832328448,0.3688020167671552
1060,"Hail, Caesar!",63647656,30498085,33149571,2016.csv,2016,0.4791705919225054,0.5208294080774947
1061,Elite Squad 2: The Enemy Within,63618850,100119,63518731,2010.csv,2010,0.0015737316848701288,0.9984262683151298
1062,Footloose 2011 Re-release,63543328,51802742,11740586,2011.csv,2011,0.815234952755386,0.18476504724461396
1063,Conan the Barbarian,63523283,21295021,42228262,2011.csv,2011,0.33523174487061697,0.664768255129383
1064,Begin Again,63464861,16170632,47294229,2014.csv,2014,0.25479661887229216,0.7452033811277078
1065,Colombiana,63458440,36665854,26792586,2011.csv,2011,0.5777931824356224,0.42220681756437756
1066,The Rescue,63426575,18797,63407778,2020.csv,2020,0.0002963584270473378,0.9997036415729527
1067,Side Effects,63414135,32172757,31241378,2013.csv,2013,0.5073436229950941,0.49265637700490594
1068,The Host,63365859,26627201,36738658,2013.csv,2013,0.42021368320754554,0.5797863167924544
1069,The Hundred Regiments Offensive,63230000,0,63230000,2015.csv,2015,0.0,1.0
1070,Detective Conan: Crimson Love Letter,63144805,0,63144805,2017.csv,2017,0.0,1.0
1071,The Longest Ride,62944815,37446117,25498698,2015.csv,2015,0.5949039170263667,0.4050960829736333
1072,Unfriended,62882090,32482090,30400000,2015.csv,2015,0.5165555088897331,0.4834444911102668
1073,The Mountain Between Us,62832209,30348555,32483654,2017.csv,2017,0.48300951825519933,0.5169904817448007
1074,The Star,62812974,40852824,21960150,2017.csv,2017,0.65038830990553,0.34961169009446996
1075,The Nice Guys,62788218,36261763,26526455,2016.csv,2016,0.5775249585837904,0.4224750414162097
1076,Beauty and the Beast 2012 3D Release,62767829,47617067,15150762,2012.csv,2012,0.7586221757008674,0.2413778242991326
1077,Devil,62695489,33601190,29094299,2010.csv,2010,0.5359427055429777,0.46405729445702226
1078,Runner Runner,62675095,19316646,43358449,2013.csv,2013,0.3082028994132358,0.6917971005867641
1079,How to Be a Latin Lover,62547032,32149404,30397628,2017.csv,2017,0.5140036700702281,0.4859963299297719
1080,The White Haired Witch of Lunar Kingdom,62515046,0,62515046,2014.csv,2014,0.0,1.0
1081,Andhadhun,62475342,1193046,61282296,2018.csv,2018,0.019096270013215774,0.9809037299867842
1082,Evangelion: 3.0+1.0 Thrice Upon a Time,62323726,0,62323726,2021.csv,2021,0.0,1.0
1083,47 Meters Down,62187529,44307191,17880338,2017.csv,2017,0.7124771109654477,0.28752288903455225
1084,Brooklyn,62076141,38322743,23753398,2015.csv,2015,0.6173506017392415,0.3826493982607585
1085,"Dragon Ball Z: Resurrection ""F""",61768190,8008363,53759827,2015.csv,2015,0.1296518968744268,0.8703481031255732
1086,White Snake,61631776,34730,61597046,2019.csv,2019,0.000563508018980339,0.9994364919810197
1087,"Everything, Everything",61621140,34121140,27500000,2017.csv,2017,0.5537245821807256,0.4462754178192744
1088,Woman in Gold,61619773,33307793,28311980,2015.csv,2015,0.540537418078447,0.459462581921553
1089,The Face Reader,61559184,515876,61043308,2013.csv,2013,0.008380163063889865,0.9916198369361101
1090,Krampus,61548707,42725475,18823232,2015.csv,2015,0.694173396688902,0.305826603311098
1091,From Up on Poppy Hill,61459425,1002895,60456530,2011.csv,2011,0.0163180016734618,0.9836819983265382
1092,Bombshell,61404394,31762808,29641586,2019.csv,2019,0.5172725587032094,0.48272744129679057
1093,Ashfall,61326410,372562,60953848,2019.csv,2019,0.00607506619089557,0.9939249338091044
1094,Astérix and Obélix: God Save Britannia,61319383,0,61319383,2012.csv,2012,0.0,1.0
1095,The Legend of Hercules,61279452,18848538,42430914,2013.csv,2013,0.30758333152195944,0.6924166684780406
1096,The Walk,61181942,10137502,51044440,2014.csv,2014,0.16569434817874856,0.8343056518212515
1097,Doraemon: Great Adventure in the Antarctic Kachi Kochi,61153455,0,61153455,2017.csv,2017,0.0,1.0
1098,Ma,61105672,45896028,15209644,2019.csv,2019,0.7510927627144007,0.24890723728559927
1099,Snatched,60845711,45852178,14993533,2017.csv,2017,0.7535811028652455,0.24641889713475448
1100,Kick-Ass 2,60795985,28795985,32000000,2013.csv,2013,0.4736494523445915,0.5263505476554085
1101,127 Hours,60738797,18335230,42403567,2010.csv,2010,0.301870153931432,0.698129846068568
1102,Why Did I Get Married Too?,60673972,60095852,578120,2010.csv,2010,0.9904716968257822,0.009528303174217769
1103,Love You Forever,60670799,0,60670799,2020.csv,2020,0.0,1.0
1104,What a Beautiful Day,60661950,0,60661950,2011.csv,2011,0.0,1.0
1105,The Founding of an Army,60600361,0,60600361,2017.csv,2017,0.0,1.0
1106,Evangelion: 3.0 You Can (Not) Redo,60488344,174945,60313399,2012.csv,2012,0.002892210109107963,0.997107789890892
1107,The Ghost Writer,60331447,15541549,44789898,2010.csv,2010,0.2576027888076346,0.7423972111923653
1108,My Little Pony: The Movie,60330833,21885107,38445726,2017.csv,2017,0.3627516132588456,0.6372483867411544
1109,Secretariat,60321861,59713955,607906,2010.csv,2010,0.9899222936772458,0.0100777063227542
1110,The Perfect Guy,60273173,57027435,3245738,2015.csv,2015,0.9461495415215655,0.05385045847843451
1111,A Haunted House,60159584,40041683,20117901,2013.csv,2013,0.6655910885288037,0.33440891147119634
1112,Beautiful Creatures,60052138,19452138,40600000,2013.csv,2013,0.323920823601651,0.676079176398349
1113,Morning Glory,60040976,31011732,29029244,2010.csv,2010,0.5165094584738262,0.4834905415261737
1114,My Best Summer,60011073,0,60011073,2019.csv,2019,0.0,1.0
1115,Forever Young,59981902,149761,59832141,2015.csv,2015,0.0024967697756566637,0.9975032302243433
1116,Adrift,59945012,31445012,28500000,2018.csv,2018,0.5245642790095696,0.47543572099043035
1117,Green Zone 2010 Re-release,59828889,0,59828889,2010.csv,2010,0.0,1.0
1118,Quartet,59520298,18390117,41130181,2012.csv,2012,0.3089721929819639,0.6910278070180361
1119,Rock of Ages,59418613,38518613,20900000,2012.csv,2012,0.6482583664482373,0.35174163355176263
1120,Miss Granny,59396311,234573,59161738,2015.csv,2015,0.003949285671967069,0.9960507143280329
1121,One Day,59389433,13843771,45545662,2011.csv,2011,0.23310158559688557,0.7668984144031145
1122,Molly's Game,59284015,28780744,30503271,2017.csv,2017,0.48547224745152634,0.5145277525484736
1123,The Devotion of Suspect X,59035664,686435,58349229,2017.csv,2017,0.011627463019641822,0.9883725369803582
1124,The Gift,58978653,43787265,15191388,2015.csv,2015,0.742425653566554,0.257574346433446
1125,Miss Granny,58940254,0,58940254,2014.csv,2014,0.0,1.0
1126,A Walk Among the Tombstones,58834384,26307600,32526784,2014.csv,2014,0.44714668891578774,0.5528533110842122
1127,Shock Wave,58815633,0,58815633,2017.csv,2017,0.0,1.0
1128,The Tree of Life,58409247,13303319,45105928,2011.csv,2011,0.22776049484082547,0.7722395051591745
1129,Beginning of the Great Revival,58309289,151000,58158289,2011.csv,2011,0.0025896388481087464,0.9974103611518913
1130,Huo guo ying xiong,58106427,779818,57326609,2016.csv,2016,0.013420511985705126,0.9865794880142948
1131,L.O.R.D: Legend of Ravaging Dynasties,58089494,350456,57739038,2016.csv,2016,0.0060330358532646195,0.9939669641467354
1132,Snitch,57824674,42930462,14894212,2013.csv,2013,0.7424246265530179,0.25757537344698217
1133,Dolphin Tale 2,57824533,42024533,15800000,2014.csv,2014,0.7267595745217692,0.27324042547823085
1134,Nine Lives,57814445,19700032,38114413,2016.csv,2016,0.3407458464748732,0.6592541535251268
1135,That's My Boy,57719093,36931089,20788004,2012.csv,2012,0.6398418110970663,0.3601581889029337
1136,Goldbuster,57628292,186135,57442157,2017.csv,2017,0.0032299239408310073,0.996770076059169
1137,Ready or Not,57615777,28714231,28901546,2019.csv,2019,0.4983744469852416,0.5016255530147584
1138,The Physician,57284237,0,57284237,2013.csv,2013,0.0,1.0
1139,Jade Dynasty,57149764,0,57149764,2019.csv,2019,0.0,1.0
1140,Killer Elite,57084522,25124966,31959556,2011.csv,2011,0.44013622466699465,0.5598637753330054
1141,Gekijouban Tenpesuto 3D,57082491,0,57082491,2011.csv,2011,0.0,1.0
1142,The 15:17 to Paris,57076286,36276286,20800000,2018.csv,2018,0.6355754472181319,0.36442455278186814
1143,All the Money in the World,56996304,25113707,31882597,2017.csv,2017,0.44061992160053043,0.5593800783994696
1144,Zoolander 2,56722693,28848693,27874000,2016.csv,2016,0.5085917377018754,0.4914082622981247
1145,You Are My Sunshine,56640000,0,56640000,2015.csv,2015,0.0,1.0
1146,Das perfekte Geheimnis,56573047,0,56573047,2019.csv,2019,0.0,1.0
1147,The Big Sick,56411585,42873127,13538458,2017.csv,2017,0.7600057151381228,0.2399942848618772
1148,A or B,56239049,0,56239049,2018.csv,2018,0.0,1.0
1149,Nazha Reborn,56088478,0,56088478,2021.csv,2021,0.0,1.0
1150,The Big Shot,56040681,0,56040681,2019.csv,2019,0.0,1.0
1151,Remember Me,56032889,19068240,36964649,2010.csv,2010,0.3403044237108674,0.6596955762891327
1152,The Odd Life of Timothy Green,56012642,51854875,4157767,2012.csv,2012,0.9257709179295631,0.07422908207043688
1153,Confidential Assignment,55972241,475618,55496623,2017.csv,2017,0.008497390697649572,0.9915026093023505
1154,Firestorm,55754766,0,55754766,2013.csv,2013,0.0,1.0
1155,Dallas Buyers Club,55736588,27298285,28438303,2013.csv,2013,0.4897731630073947,0.5102268369926053
1156,All Eyez on Me,55668698,44922302,10746396,2017.csv,2017,0.806958014358446,0.1930419856415539
1157,Cop Out,55611001,44875481,10735520,2010.csv,2010,0.8069533040773713,0.19304669592262869
1158,Lawless,55404159,37400127,18004032,2012.csv,2012,0.6750418682467502,0.3249581317532498
1159,Silent Hill: Revelation,55362705,17529157,37833548,2011.csv,2011,0.31662392579986837,0.6833760742001317
1160,Extremely Loud & Incredibly Close,55247881,31847881,23400000,2011.csv,2011,0.5764543440136646,0.4235456559863355
1161,End of Watch,55078146,41003371,14074775,2012.csv,2012,0.744458083247755,0.2555419167522451
1162,Hellboy,55064690,21903748,33160942,2019.csv,2019,0.39778209956325916,0.6022179004367408
1163,Wolf Children,55045228,0,55045228,2012.csv,2012,0.0,1.0
1164,Barbershop: The Next Cut,55030051,54030051,1000000,2016.csv,2016,0.9818281106081476,0.018171889391852464
1165,Veda - Atatürk,55024621,0,55024621,2010.csv,2010,0.0,1.0
1166,Downsizing,55003890,24449754,30554136,2017.csv,2017,0.44450954287051336,0.5554904571294866
1167,St. Vincent,54837234,44137712,10699522,2014.csv,2014,0.8048858190039272,0.19511418099607286
1168,The Three Stooges,54819301,44338224,10481077,2012.csv,2012,0.8088068105793614,0.19119318942063854
1169,The Crazies,54806823,39123589,15683234,2010.csv,2010,0.7138452268981181,0.28615477310188187
1170,Go Brother!,54663060,0,54663060,2018.csv,2018,0.0,1.0
1171,Avatar 2021 Re-release,54634048,0,54634048,2021.csv,2021,0.0,1.0
1172,Early Man,54622814,8267544,46355270,2018.csv,2018,0.15135697695838227,0.8486430230416178
1173,The Age of Shadows,54491162,541719,53949443,2016.csv,2016,0.009941410315309481,0.9900585896846905
1174,No Escape,54418872,27288872,27130000,2015.csv,2015,0.5014597141962075,0.4985402858037925
1175,No Good Deed,54323210,52543632,1779578,2014.csv,2014,0.9672409270365282,0.03275907296347178
1176,The Five-Year Engagement,54169363,28835528,25333835,2012.csv,2012,0.5323217110749484,0.4676782889250516
1177,Madea's Big Happy Family,54161287,53345287,816000,2011.csv,2011,0.9849338882955274,0.015066111704472605
1178,A Ghost of a Chance,53982636,0,53982636,2011.csv,2011,0.0,1.0
1179,"I, Tonya",53939297,30014539,23924758,2017.csv,2017,0.5564503185868366,0.4435496814131634
1180,Peppermint,53918723,35418723,18500000,2018.csv,2018,0.6568909838610235,0.34310901613897643
1181,Long Shot,53873809,30316271,23557538,2019.csv,2019,0.5627274470234692,0.4372725529765308
1182,1987: When the Day Comes,53833618,0,53833618,2017.csv,2017,0.0,1.0
1183,Overheard 3,53493428,0,53493428,2014.csv,2014,0.0,1.0
1184,Supercondriaque,53425036,0,53425036,2014.csv,2014,0.0,1.0
1185,A Madea Christmas,53396635,52543354,853281,2013.csv,2013,0.9840199480735069,0.01598005192649312
1186,Sinister 2,53329150,27740955,25588195,2015.csv,2015,0.5201837081596088,0.4798162918403912
1187,Little White Lies,53319615,206088,53113527,2010.csv,2010,0.003865144187556493,0.9961348558124435
1188,A Chinese Odyssey: Part Three,53306108,0,53306108,2016.csv,2016,0.0,1.0
1189,3 Days to Kill,53260230,30697999,22562231,2014.csv,2014,0.5763775147046868,0.4236224852953132
1190,Temptation: Confessions of a Marriage Counselor,53143144,51975354,1167790,2013.csv,2013,0.9780255756038823,0.021974424396117777
1191,Delivery Man,53120346,30664106,22456240,2013.csv,2013,0.5772572716299702,0.4227427283700298
1192,The Outlaws,52946454,0,52946454,2017.csv,2017,0.0,1.0
1193,Detective Conan: Sunflowers of Inferno,52920296,0,52920296,2015.csv,2015,0.0,1.0
1194,From Paris with Love,52830951,24077427,28753524,2010.csv,2010,0.4557447205521627,0.5442552794478374
1195,Sister,52800000,0,52800000,2021.csv,2021,0.0,1.0
1196,Prem Ratan Dhan Payo,52715771,4364639,48351132,2015.csv,2015,0.08279569694617575,0.9172043030538243
1197,Rurouni Kenshin Part II: Kyoto Inferno,52696176,0,52696176,2014.csv,2014,0.0,1.0
1198,Wild,52501541,37880356,14621185,2014.csv,2014,0.7215094124570554,0.2784905875429447
1199,Teo-neol,52444295,568876,51875419,2016.csv,2016,0.010847242774452398,0.9891527572255476
1200,The Boy Next Door,52425855,35423380,17002475,2015.csv,2015,0.6756853083273511,0.3243146916726489
1201,The Night Before,52395996,43047372,9348624,2015.csv,2015,0.8215775113808315,0.17842248861916854
1202,Greenland,52300000,0,52300000,2020.csv,2020,0.0,1.0
1203,Hollywood Adventures,52265070,0,52265070,2015.csv,2015,0.0,1.0
1204,Tolo Tolo,52186426,0,52186426,2020.csv,2020,0.0,1.0
1205,Patriots Day,52185751,31886361,20299390,2016.csv,2016,0.6110166163940038,0.3889833836059962
1206,My Beloved Bodyguard,52165873,0,52165873,2016.csv,2016,0.0,1.0
1207,The Finest Hours,52099090,27569558,24529532,2016.csv,2016,0.5291754232175648,0.47082457678243517
1208,Teen Titans GO! To the Movies,52090236,29790236,22300000,2018.csv,2018,0.5718967370391641,0.4281032629608359
1209,Detective Dee: Mystery of the Phantom Flame,51899269,459836,51439433,2010.csv,2010,0.008860163329082727,0.9911398366709173
1210,Animals United,51883642,0,51883642,2010.csv,2010,0.0,1.0
1211,"Yo-kai Watch Movie: It's the Secret of Birth, Meow!",51838845,257343,51581502,2015.csv,2015,0.004964288845555876,0.9950357111544441
1212,Slender Man,51738549,30569484,21169065,2018.csv,2018,0.5908454061979975,0.4091545938020025
1213,Master,51636415,597251,51039164,2016.csv,2016,0.011566469128424194,0.9884335308715758
1214,Daybreakers,51416464,30101577,21314887,2010.csv,2010,0.5854462687282423,0.4145537312717576
1215,Breaking In,51411620,46840590,4571030,2018.csv,2018,0.9110895552406246,0.08891044475937541
1216,Cry Me a Sad River,51400614,0,51400614,2018.csv,2018,0.0,1.0
1217,Hot Pursuit,51380201,34580201,16800000,2015.csv,2015,0.6730258022929883,0.3269741977070117
1218,Simmba,51329025,5102129,46226896,2018.csv,2018,0.09940046591572702,0.900599534084273
1219,Once Upon a Deadpool 2018 Re-release,51247568,6100309,45147259,2018.csv,2018,0.11903606820912946,0.8809639317908705
1220,The 100 Year-Old Man Who Climbed Out the Window and Disappeared,51167572,944193,50223379,2013.csv,2013,0.018452956884489263,0.9815470431155108
1221,Sseo-ni,51116421,0,51116421,2011.csv,2011,0.0,1.0
1222,Magic in the Moonlight,51029361,10539326,40490035,2014.csv,2014,0.20653454782629946,0.7934654521737006
1223,Red Dawn,50950296,44806783,6143513,2012.csv,2012,0.8794214463444923,0.12057855365550771
1224,Doraemon the Movie: Nobita and the Birth of Japan,50939840,0,50939840,2016.csv,2016,0.0,1.0
1225,Vanguard,50814965,793525,50021440,2020.csv,2020,0.015615970610232635,0.9843840293897673
1226,War of the Arrows,50587661,251200,50336461,2011.csv,2011,0.004965637766885486,0.9950343622331145
1227,Kingdom,50574061,0,50574061,2019.csv,2019,0.0,1.0
1228,The Himalayas,50544493,696717,49847776,2015.csv,2015,0.013784231647154914,0.9862157683528451
1229,Alpha and Omega,50507267,25107267,25400000,2010.csv,2010,0.49710207048027366,0.5028979295197263
1230,Dragon Ball Z: Battle of Gods,50461371,2553002,47908369,2013.csv,2013,0.05059319533747904,0.9494068046625209
1231,Kokowääh,50447784,0,50447784,2011.csv,2011,0.0,1.0
1232,About Last Night,50445860,48637684,1808176,2014.csv,2014,0.9641561071612219,0.03584389283877805
1233,Breakthrough,50444358,40713082,9731276,2019.csv,2019,0.8070889117074302,0.1929110882925698
1234,Just Mercy,50401502,36001502,14400000,2019.csv,2019,0.7142942287711981,0.28570577122880186
1235,Red Tails,50365498,49876377,489121,2012.csv,2012,0.9902885701636466,0.009711429836353449
1236,"Monsters, Inc. 2012 3D Release",50207820,34043006,16164814,2012.csv,2012,0.6780419066193274,0.32195809338067255
1237,HOUBA! On the Trail of the Marsupilami,50146474,0,50146474,2012.csv,2012,0.0,1.0
1238,Uncut Gems,50023780,50023780,0,2019.csv,2019,1.0,0.0
1239,Dearest 2014 Re-release,50000583,0,50000583,2014.csv,2014,0.0,1.0
1240,Family is Family,49954866,0,49954866,2018.csv,2018,0.0,1.0
1241,21 Bridges,49939757,28539757,21400000,2019.csv,2019,0.5714836978481894,0.42851630215181064
1242,Winnie the Pooh,49871429,26692846,23178583,2011.csv,2011,0.535233229430823,0.464766770569177
1243,The Wailing,49851770,786633,49065137,2016.csv,2016,0.015779439727014708,0.9842205602729853
1244,The Switch,49830607,27779426,22051181,2010.csv,2010,0.5574771746208108,0.44252282537918913
1245,Space Battleship Yamato,49827298,0,49827298,2010.csv,2010,0.0,1.0
1246,She's Out of My League,49779728,32010860,17768868,2010.csv,2010,0.6430501187149917,0.3569498812850082
1247,The Boy and the Beast,49714378,490643,49223735,2015.csv,2015,0.009869237426645467,0.9901307625733545
1248,Demain tout commence,49619118,0,49619118,2016.csv,2016,0.0,1.0
1249,Song of Youth,49615508,0,49615508,2019.csv,2019,0.0,1.0
1250,Surprise,49567466,0,49567466,2015.csv,2015,0.0,1.0
1251,Death Wish,49562710,34017028,15545682,2018.csv,2018,0.6863431801852643,0.3136568198147357
1252,The Grudge,49511319,21221803,28289516,2019.csv,2019,0.4286252806151256,0.5713747193848744
1253,Tad: The Lost Explorer,49490859,0,49490859,2012.csv,2012,0.0,1.0
1254,Entourage,49263404,32363404,16900000,2015.csv,2015,0.6569461582476112,0.34305384175238884
1255,A Turtle's Tale 2: Sammy's Escape from Paradise,49261830,0,49261830,2012.csv,2012,0.0,1.0
1256,Death at a Funeral,49050886,42739347,6311539,2010.csv,2010,0.8713267075338863,0.12867329246611367
1257,Little,48987096,40860481,8126615,2019.csv,2019,0.8341070268790786,0.16589297312092147
1258,Whiplash,48982041,13092000,35890041,2014.csv,2014,0.2672816349159481,0.732718365084052
1259,Never Gone,48980792,96421,48884371,2016.csv,2016,0.0019685471806989156,0.9980314528193011
1260,The Berlin File,48972848,665210,48307638,2013.csv,2013,0.013583241064518036,0.986416758935482
1261,Trouble with the Curve,48963137,35763137,13200000,2012.csv,2012,0.7304094302617906,0.2695905697382094
1262,Luck-Key,48913975,466505,48447470,2016.csv,2016,0.00953725392385305,0.9904627460761469
1263,Florence Foster Jenkins,48902953,27383770,21519183,2016.csv,2016,0.559961481262696,0.44003851873730404
1264,The Woman in Black 2: Angel of Death,48854305,26501323,22352982,2015.csv,2015,0.5424562482262311,0.457543751773769
1265,Bleeding Steel,48825526,0,48825526,2017.csv,2017,0.0,1.0
1266,Fantasy Island,48811343,27309289,21502054,2020.csv,2020,0.5594865316449088,0.44051346835509114
1267,Isn't It Romantic,48791187,48791187,0,2019.csv,2019,1.0,0.0
1268,Mother's Day,48782670,32492859,16289811,2016.csv,2016,0.6660738126879894,0.33392618731201057
1269,How Do You Know,48668907,30212620,18456287,2010.csv,2010,0.6207786831950017,0.3792213168049983
1270,Concussion,48623572,34542474,14081098,2015.csv,2015,0.7104059323325732,0.28959406766742685
1271,Her,48517427,25568251,22949176,2013.csv,2013,0.5269910747740189,0.47300892522598115
1272,The Legend of Hei,48462912,0,48462912,2019.csv,2019,0.0,1.0
1273,Logan Lucky,48453605,27780977,20672628,2017.csv,2017,0.5733521169374292,0.4266478830625709
1274,Homefront,48449416,20158898,28290518,2013.csv,2013,0.4160813414138986,0.5839186585861015
1275,Chef,48428048,31424003,17004045,2014.csv,2014,0.6488802315550691,0.3511197684449309
1276,Boo 2! A Madea Halloween,48333932,47319572,1014360,2017.csv,2017,0.979013501322425,0.020986498677575
1277,The Last Stand,48330757,12050299,36280458,2013.csv,2013,0.24932982117370933,0.7506701788262907
1278,Charlie St. Cloud,48190704,31162545,17028159,2010.csv,2010,0.6466505448851713,0.3533494551148288
1279,The New Mutants,48161538,23852659,24308879,2020.csv,2020,0.4952636479341669,0.5047363520658331
1280,Arthur,48147945,33035397,15112548,2011.csv,2011,0.6861226787560715,0.3138773212439285
1281,Boyhood,48137666,25352281,22785385,2014.csv,2014,0.5266620321807874,0.4733379678192125
1282,21 & Over,48065672,25682380,22383292,2013.csv,2013,0.5343185465086184,0.4656814534913815
1283,Sky Hunter,48065601,0,48065601,2017.csv,2017,0.0,1.0
1284,Heartbreaker,48023509,504030,47519479,2010.csv,2010,0.010495484617752526,0.9895045153822475
1285,Countdown,48021766,25621766,22400000,2019.csv,2019,0.5335448513076341,0.4664551486923659
1286,After We Collided,47990414,2386483,45603931,2020.csv,2020,0.04972832699463689,0.9502716730053631
1287,"From Today, It's My Turn: The Movie",47866854,0,47866854,2020.csv,2020,0.0,1.0
1288,Midsommar,47863365,27426361,20437004,2019.csv,2019,0.5730136399728686,0.4269863600271314
1289,Queen & Slim,47803176,43808310,3994866,2019.csv,2019,0.9164309501109299,0.08356904988907013
1290,Phantom Thread,47756590,21198205,26558385,2017.csv,2017,0.4438802058522185,0.5561197941477815
1291,Scott Pilgrim vs. the World,47664559,31524275,16140284,2010.csv,2010,0.6613776705665104,0.3386223294334896
1292,"Yo-kai Watch Movie: It's the Secret of Birth, Meow! 2016 Re-release",47642462,0,47642462,2016.csv,2016,0.0,1.0
1293,Man on a Ledge,47636031,18620000,29016031,2012.csv,2012,0.3908805920459662,0.6091194079540337
1294,Inside Men,47616503,0,47616503,2015.csv,2015,0.0,1.0
1295,Lie ri zhuo xin,47600000,0,47600000,2015.csv,2015,0.0,1.0
1296,Coming Home,47587984,377607,47210377,2014.csv,2014,0.007934923236084135,0.9920650767639159
1297,47 Meters Down: Uncaged,47582563,22260900,25321663,2019.csv,2019,0.46783734621441053,0.5321626537855895
1298,Boonie Bears Winter,47581416,0,47581416,2015.csv,2015,0.0,1.0
1299,Beauty and the Beast,47430624,0,47430624,2014.csv,2014,0.0,1.0
1300,The Magic Tuche,47427990,0,47427990,2018.csv,2018,0.0,1.0
1301,Nightcrawler,47398992,32381217,15017775,2014.csv,2014,0.683162565988745,0.3168374340112549
1302,Rough Night,47347283,22105643,25241640,2017.csv,2017,0.466883031070653,0.533116968929347
1303,Texas Chainsaw,47340586,34341945,12998641,2013.csv,2013,0.7254228961170865,0.2745771038829135
1304,A Monster Calls,47309313,3740823,43568490,2016.csv,2016,0.07907159843982516,0.9209284015601749
1305,Tiny Times 2.0,47289937,43788,47246149,2013.csv,2013,0.0009259475224084143,0.9990740524775916
1306,Golden Job,47287851,285795,47002056,2018.csv,2018,0.006043729921243407,0.9939562700787566
1307,Mortdecai,47275695,7696134,39579561,2015.csv,2015,0.16279261468287246,0.8372073853171276
1308,Switch,47164301,0,47164301,2013.csv,2013,0.0,1.0
1309,Soul Surfer,47120948,43853424,3267524,2011.csv,2011,0.9306566582658736,0.0693433417341264
1310,The Place Beyond the Pines,47052899,21403519,25649380,2013.csv,2013,0.45488204669387106,0.5451179533061289
1311,Son of Bigfoot,47046281,289308,46756973,2017.csv,2017,0.006149434000957483,0.9938505659990425
1312,StreetDance 2,46960833,0,46960833,2010.csv,2010,0.0,1.0
1313,Parker,46922566,17616641,29305925,2013.csv,2013,0.3754406994706982,0.6245593005293019
1314,Mary Queen of Scots,46712809,16468499,30244310,2018.csv,2018,0.35254782044899075,0.6474521795510092
1315,Uncle Drew,46664414,42469946,4194468,2018.csv,2018,0.9101142039413588,0.08988579605864118
1316,Three Seconds,46596415,0,46596415,2017.csv,2017,0.0,1.0
1317,The Big Wedding,46522137,21819348,24702789,2013.csv,2013,0.4690100112984922,0.5309899887015078
1318,Badges of Fury,46495296,0,46495296,2013.csv,2013,0.0,1.0
1319,Risen,46432579,36880033,9552546,2016.csv,2016,0.7942706133122608,0.20572938668773924
1320,Acrimony,46403669,43549096,2854573,2018.csv,2018,0.9384838944523978,0.061516105547602284
1321,A Werewolf Boy,46282588,342922,45939666,2012.csv,2012,0.007409309090494248,0.9925906909095058
1322,The Thousand Faces of Dunjia,46263237,124187,46139050,2017.csv,2017,0.002684356047113608,0.9973156439528864
1323,Asterix: The Secret of the Magic Potion,46221204,1271953,44949251,2018.csv,2018,0.027518820150163114,0.9724811798498368
1324,The Battleship Island,46183383,1104957,45078426,2017.csv,2017,0.023925423566307388,0.9760745764336927
1325,Doraemon: Nobita and the Island of Miracles ~Animal Adventure~,46180706,0,46180706,2012.csv,2012,0.0,1.0
1326,Hanson and the Beast,46154323,0,46154323,2017.csv,2017,0.0,1.0
1327,Eddie the Eagle,46152800,15789389,30363411,2016.csv,2016,0.342111182853478,0.657888817146522
1328,The World's End,46089287,26004851,20084436,2013.csv,2013,0.5642276696534707,0.43577233034652935
1329,Gekijouban Tenpesuto 3D 2012 Re-release,46008255,0,46008255,2012.csv,2012,0.0,1.0
1330,Let's Get Married,45972724,462918,45509806,2015.csv,2015,0.010069405502271303,0.9899305944977287
1331,Welcome to the South,45896492,0,45896492,2010.csv,2010,0.0,1.0
1332,Gintama Live Action the Movie,45746967,0,45746967,2017.csv,2017,0.0,1.0
1333,Somewhere Only We Know,45737711,482341,45255370,2015.csv,2015,0.010545805407708313,0.9894541945922917
1334,Chasing the Dragon II: Wild Wild Bunch,45733356,196634,45536722,2019.csv,2019,0.004299575128490461,0.9957004248715096
1335,"McFarland, USA",45710059,44482410,1227649,2015.csv,2015,0.9731426949153577,0.026857305084642312
1336,Guilty of Mind,45698503,0,45698503,2017.csv,2017,0.0,1.0
1337,Earth to Echo,45681062,38934842,6746220,2014.csv,2014,0.8523191076424624,0.14768089235753756
1338,That Awkward Moment,45640143,26068955,19571188,2014.csv,2014,0.5711847791537376,0.42881522084626245
1339,The Debt,45636368,31177548,14458820,2011.csv,2011,0.6831732972264576,0.31682670277354236
1340,Bajrangi Bhaijaan 2018 Re-release,45579004,0,45579004,2018.csv,2018,0.0,1.0
1341,Hero,45565534,88675,45476859,2015.csv,2015,0.0019460981188105905,0.9980539018811894
1342,Machete,45491656,26593646,18898010,2010.csv,2010,0.5845829397813085,0.4154170602186915
1343,Love on the Cloud,45386560,271734,45114826,2014.csv,2014,0.005987102789900799,0.9940128972100992
1344,Tanhaji: The Unsung Warrior,45221814,0,45221814,2020.csv,2020,0.0,1.0
1345,Confessions,45203103,0,45203103,2010.csv,2010,0.0,1.0
1346,Blair Witch,45173154,20777061,24396093,2016.csv,2016,0.4599426686035693,0.5400573313964308
1347,Flatliners,45158254,16883115,28275139,2017.csv,2017,0.3738655396198445,0.6261344603801555
1348,Boonie Bears: The Big Top Secret,45150390,0,45150390,2016.csv,2016,0.0,1.0
1349,Grudge Match,44907260,29807260,15100000,2013.csv,2013,0.6637514735924659,0.3362485264075341
1350,Child's Play,44907074,29208403,15698671,2019.csv,2019,0.6504187513976083,0.3495812486023917
1351,Trolls World Tour,44893259,0,44893259,2020.csv,2020,0.0,1.0
1352,Avatar 2010 Special Edition,44838548,10741486,34097062,2010.csv,2010,0.239559184655132,0.760440815344868
1353,Still Alice,44779195,18754371,26024824,2015.csv,2015,0.41881885103115407,0.5811811489688459
1354,The Man from Nowhere,44723232,528175,44195057,2010.csv,2010,0.011809857570222116,0.9881901424297779
1355,The White Storm,44670277,0,44670277,2013.csv,2013,0.0,1.0
1356,Bad Genius,44560421,0,44560421,2017.csv,2017,0.0,1.0
1357,Judy,44528735,24313888,20214847,2019.csv,2019,0.5460269194712134,0.45397308052878665
1358,Mother!,44516999,17800004,26716995,2017.csv,2017,0.3998473482006278,0.6001526517993722
1359,Oculus,44446287,27695246,16751041,2014.csv,2014,0.6231172021185931,0.37688279788140683
1360,Detective Conan: The Eleventh Striker,44369456,0,44369456,2012.csv,2012,0.0,1.0
1361,House at the End of the Street,44287131,31611916,12675215,2012.csv,2012,0.7137946235442526,0.2862053764557474
1362,Tarzan,44095996,0,44095996,2013.csv,2013,0.0,1.0
1363,The Great Hypnotist,44077818,0,44077818,2014.csv,2014,0.0,1.0
1364,Winchester,44019588,25091816,18927772,2018.csv,2018,0.5700147852360635,0.4299852147639365
1365,Kick,43996483,2472695,41523788,2014.csv,2014,0.056202105972879696,0.9437978940271203
1366,Wind River,43980821,33800859,10179962,2017.csv,2017,0.7685363354176585,0.23146366458234147
1367,Max,43967255,42656255,1311000,2015.csv,2015,0.9701823550276223,0.029817644972377738
1368,The End of Endless Love,43950000,0,43950000,2020.csv,2020,0.0,1.0
1369,Battle of Memories,43892362,594552,43297810,2017.csv,2017,0.01354568250393998,0.98645431749606
1370,Son of a Rich,43833888,0,43833888,2019.csv,2019,0.0,1.0
1371,Of Gods and Men,43803417,3951596,39851821,2010.csv,2010,0.09021204898238874,0.9097879510176112
1372,Café Society,43763247,11103205,32660042,2016.csv,2016,0.25371072215002693,0.746289277849973
1373,Richard Jewell,43745542,22345542,21400000,2019.csv,2019,0.5108072955182497,0.4891927044817504
1374,The DUFF,43709744,34030343,9679401,2015.csv,2015,0.7785527867653491,0.22144721323465083
1375,Boy,43551154,256211,43294943,2010.csv,2010,0.005882989920313018,0.994117010079687
1376,League of Gods,43498766,181633,43317133,2016.csv,2016,0.004175589716728976,0.9958244102832711
1377,Secretly Greatly,43447199,0,43447199,2013.csv,2013,0.0,1.0
1378,Harriet,43347017,43082155,264862,2019.csv,2019,0.9938897294824232,0.006110270517576792
1379,Unhinged,43249465,20831465,22418000,2020.csv,2020,0.48165832802787273,0.5183416719721273
1380,Beastly,43202283,27865571,15336712,2011.csv,2011,0.6450022791619601,0.35499772083804
1381,The Snowman,43155261,6700035,36455226,2017.csv,2017,0.1552541878961177,0.8447458121038823
1382,A Shaun the Sheep Movie: Farmageddon,43100248,0,43100248,2019.csv,2019,0.0,1.0
1383,Annihilation,43070915,32732301,10338614,2018.csv,2018,0.7599629819798349,0.2400370180201651
1384,When in Rome,43053376,32680633,10372743,2010.csv,2010,0.7590724824924299,0.24092751750757013
1385,Gifted,43046590,24801212,18245378,2017.csv,2017,0.5761481223019059,0.42385187769809407
1386,The Possession of Hannah Grace,43016528,14837422,28179106,2018.csv,2018,0.3449237465190124,0.6550762534809876
1387,Legend,42972994,1872994,41100000,2015.csv,2015,0.04358537364187378,0.9564146263581262
1388,"The Chef, The Actor, The Scoundrel",42970000,0,42970000,2013.csv,2013,0.0,1.0
1389,The Gallows,42964410,22764410,20200000,2015.csv,2015,0.5298434215668271,0.47015657843317293
1390,Asterix and Obelix: Mansion of the Gods,42830578,0,42830578,2014.csv,2014,0.0,1.0
1391,Detective Conan: Quarter of Silence,42808575,0,42808575,2011.csv,2011,0.0,1.0
1392,Doraemon: Nobita's Secret Gadget Museum,42770271,0,42770271,2013.csv,2013,0.0,1.0
1393,Shaolin,42741494,66099,42675395,2011.csv,2011,0.001546483143523247,0.9984535168564768
1394,Train to Busan Presents: Peninsula,42698327,1231407,41466920,2020.csv,2020,0.02883970137752704,0.971160298622473
1395,Almost Christmas,42580920,42158780,422140,2016.csv,2016,0.9900861700498721,0.009913829950127897
1396,Thermae Romae II,42473163,0,42473163,2014.csv,2014,0.0,1.0
1397,Love the Coopers,42426912,26302731,16124181,2015.csv,2015,0.6199539339558816,0.3800460660441184
1398,My Name Is Khan,42345360,4018771,38326589,2010.csv,2010,0.09490463654105195,0.905095363458948
1399,Loving Vincent,42187665,6735118,35452547,2017.csv,2017,0.15964661708582353,0.8403533829141765
1400,The Throne,42165755,0,42165755,2015.csv,2015,0.0,1.0
1401,Long Day's Journey Into Night,42140994,521365,41619629,2018.csv,2018,0.01237191984602926,0.9876280801539707
1402,Jobs,42128352,16131410,25996942,2013.csv,2013,0.3829110144161348,0.6170889855838653
1403,Going the Distance,42059111,17804299,24254812,2010.csv,2010,0.4233161038520286,0.5766838961479713
1404,Bang Bang,42045981,2546172,39499809,2014.csv,2014,0.060556846087144456,0.9394431539128556
1405,Detective Conan: The Sniper from Another Dimension,42028116,0,42028116,2014.csv,2014,0.0,1.0
1406,Mary and the Witch's Flower,41978431,2418404,39560027,2017.csv,2017,0.05761063342267366,0.9423893665773263
1407,Rurouni Kenshin Part III: The Legend Ends,41900000,0,41900000,2014.csv,2014,0.0,1.0
1408,"As Above, So Below",41898409,21321100,20577309,2014.csv,2014,0.5088761246280259,0.49112387537197416
1409,Call Me by Your Name,41887595,18095701,23791894,2017.csv,2017,0.4320062061333433,0.5679937938666567
1410,The Guilt Trip,41863726,37134215,4729511,2012.csv,2012,0.8870260377683534,0.11297396223164656
1411,No Man's Land,41807712,0,41807712,2013.csv,2013,0.0,1.0
1412,T2 Trainspotting,41681746,2402004,39279742,2017.csv,2017,0.05762724047116452,0.9423727595288355
1413,Overlord,41657844,21704844,19953000,2018.csv,2018,0.5210265802522089,0.47897341974779106
1414,Born to Be Wild,41644475,25978556,15665919,2011.csv,2011,0.6238175892480335,0.3761824107519665
1415,Safe,41564670,17142080,24422590,2012.csv,2012,0.4124194899177595,0.5875805100822405
1416,The Great Battle,41509280,472166,41037114,2018.csv,2018,0.0113749503725432,0.9886250496274568
1417,Lupin III vs. Detective Conan: The Movie,41397727,0,41397727,2013.csv,2013,0.0,1.0
1418,The Lady in the Van,41387687,10021175,31366512,2015.csv,2015,0.24212938017048405,0.757870619829516
1419,Shark Night,41363927,18877153,22486774,2011.csv,2011,0.45636752525938845,0.5436324747406115
1420,Ricki and the Flash,41325328,26822144,14503184,2015.csv,2015,0.6490485447568619,0.35095145524313803
1421,This Is Where I Leave You,41296320,34296320,7000000,2014.csv,2014,0.8304933708378858,0.1695066291621142
1422,The Darkest Minds,41142379,12695691,28446688,2018.csv,2018,0.30857940908084097,0.6914205909191591
1423,50/50,41097853,35014192,6083661,2011.csv,2011,0.8519713183070659,0.14802868169293418
1424,Fist Fight,41087017,32187017,8900000,2017.csv,2017,0.7833865622320549,0.21661343776794503
1425,Nodame Cantabile: The Movie II 2010 Re-release,41054604,0,41054604,2010.csv,2010,0.0,1.0
1426,"Lost, Found",41043552,0,41043552,2018.csv,2018,0.0,1.0
1427,Dredd,41037742,13414714,27623028,2012.csv,2012,0.32688723468264896,0.6731127653173511
1428,Fright Night,41002607,18302607,22700000,2011.csv,2011,0.4463766657568871,0.5536233342431128
1429,La vérité si je mens! 3,40928635,0,40928635,2012.csv,2012,0.0,1.0
1430,Always: Sunset on Third Street '64,40923305,0,40923305,2012.csv,2012,0.0,1.0
1431,Drive Angry,40909909,10721033,30188876,2011.csv,2011,0.262064454848824,0.737935545151176
1432,Underwater,40882928,17291078,23591850,2020.csv,2020,0.4229412824834855,0.5770587175165145
1433,Fighting with My Family,40811919,22958886,17853033,2019.csv,2019,0.5625534540534592,0.43744654594654075
1434,30 Minutes or Less,40662632,37053924,3608708,2011.csv,2011,0.9112524737700206,0.0887475262299794
1435,The Circle,40656399,20497844,20158555,2017.csv,2017,0.504172639588666,0.495827360411334
1436,Ocho apellidos catalanes,40591862,0,40591862,2015.csv,2015,0.0,1.0
1437,Gantz,40568961,0,40568961,2011.csv,2011,0.0,1.0
1438,The Roommate,40492652,37300000,3192652,2011.csv,2011,0.9211547813662587,0.07884521863374125
1439,Holmes & Watson,40466970,30573626,9893344,2018.csv,2018,0.7555205146320567,0.24447948536794328
1440,The Witch,40423945,25138705,15285240,2016.csv,2016,0.6218765882449128,0.37812341175508724
1441,Masquerade Hotel,40396244,0,40396244,2019.csv,2019,0.0,1.0
1442,Carol,40272135,12711491,27560644,2015.csv,2015,0.3156398586764769,0.6843601413235231
1443,Yolki 3,40267368,0,40267368,2013.csv,2013,0.0,1.0
1444,SP: The Motion Picture II,40255101,0,40255101,2011.csv,2011,0.0,1.0
1445,Bears and Lola,40163675,0,40163675,2014.csv,2014,0.0,1.0
1446,Diary of a Wimpy Kid: The Long Haul,40140972,20738724,19402248,2017.csv,2017,0.5166472799911273,0.48335272000887275
1447,The Wild Life,40075446,8005586,32069860,2016.csv,2016,0.19976286726790266,0.8002371327320974
1448,Northern Limit Line,40034677,337907,39696770,2015.csv,2015,0.008440357842777151,0.9915596421572228
1449,Dream House,39984400,21302340,18682060,2011.csv,2011,0.532766278848751,0.467233721151249
1450,Love O2O,39969537,0,39969537,2016.csv,2016,0.0,1.0
1451,Brotherhood of Blades 2,39966092,14204,39951888,2017.csv,2017,0.0003554012736596813,0.9996445987263404
1452,Monte Carlo,39782683,23186769,16595914,2011.csv,2011,0.5828357277964384,0.41716427220356156
1453,Eiga Kaibutsukun,39766344,0,39766344,2011.csv,2011,0.0,1.0
1454,The Last Wish,39756292,0,39756292,2019.csv,2019,0.0,1.0
1455,Midnight Runners,39730433,0,39730433,2017.csv,2017,0.0,1.0
1456,The Forest,39712000,26594261,13117739,2016.csv,2016,0.6696782080983078,0.3303217919016922
1457,SP: The Motion Picture I,39674739,0,39674739,2010.csv,2010,0.0,1.0
1458,The November Man,39661919,25018119,14643800,2014.csv,2014,0.6307843803523475,0.3692156196476524
1459,Intimate Strangers,39576060,0,39576060,2018.csv,2018,0.0,1.0
1460,Thugs of Hindostan,39570044,1449848,38120196,2018.csv,2018,0.0366400401273246,0.9633599598726754
1461,Recep Ivedik 4,39477906,0,39477906,2014.csv,2014,0.0,1.0
1462,Don Jon,39439355,24477704,14961651,2013.csv,2013,0.6206415901071405,0.37935840989285957
1463,Frank Miller's Sin City: A Dame to Kill For,39407616,13757804,25649812,2014.csv,2014,0.3491153588179503,0.6508846411820497
1464,Uri: The Surgical Strike,39346577,4186168,35160409,2019.csv,2019,0.10639217739322025,0.8936078226067797
1465,The Gambler,39280992,33680992,5600000,2014.csv,2014,0.8574374089126874,0.14256259108731267
1466,Mars Needs Moms,39233678,21392758,17840920,2011.csv,2011,0.5452651673391417,0.45473483266085835
1467,Absolutely Fabulous: The Movie,39219109,4772155,34446954,2016.csv,2016,0.12167933238870877,0.8783206676112912
1468,My Mom Is a Character 2,39195565,0,39195565,2016.csv,2016,0.0,1.0
1469,Sink or Swim,39193850,0,39193850,2018.csv,2018,0.0,1.0
1470,Samba,39178695,151530,39027165,2014.csv,2014,0.0038676632797493638,0.9961323367202506
1471,Show Dogs,39156854,17857020,21299834,2018.csv,2018,0.4560381689499366,0.5439618310500635
1472,Women Who Flirt,39156132,375495,38780637,2014.csv,2014,0.009589685722787941,0.990410314277212
1473,Masterpiece Mystery: Sherlock: The Abominable Bride,39139204,0,39139204,2016.csv,2016,0.0,1.0
1474,Ex-Files 2: The Backup Strikes Back,39108291,0,39108291,2015.csv,2015,0.0,1.0
1475,Believer,39047153,365639,38681514,2018.csv,2018,0.009364037372968011,0.990635962627032
1476,The Crown Jewels,39000000,0,39000000,2011.csv,2011,0.0,1.0
1477,Forbidden Kingdom 2014 Re-release,38885962,0,38885962,2014.csv,2014,0.0,1.0
1478,The Spy Gone North,38844509,500803,38343706,2018.csv,2018,0.012892504317663018,0.987107495682337
1479,Criminal,38803993,14708696,24095297,2015.csv,2015,0.3790510940459143,0.6209489059540857
1480,Antoine and Sebastian,38719881,0,38719881,2013.csv,2013,0.0,1.0
1481,On the Basis of Sex,38673750,24622687,14051063,2018.csv,2018,0.6366769966708685,0.36332300332913153
1482,The War with Grandpa,38663618,21110178,17553440,2020.csv,2020,0.5459959282651716,0.4540040717348283
1483,"Crouching Tiger, Hidden Dragon: Sword of Destiny",38659039,0,38659039,2016.csv,2016,0.0,1.0
1484,The Best of Me,38609668,26766213,11843455,2014.csv,2014,0.6932515710831805,0.30674842891681947
1485,Taxi 5,38598227,0,38598227,2018.csv,2018,0.0,1.0
1486,Million Dollar Arm,38483455,36457627,2025828,2014.csv,2014,0.9473584687237672,0.05264153127623286
1487,Chernobyl Diaries,38390020,18119640,20270380,2012.csv,2012,0.4719882927906784,0.5280117072093216
1488,Boruto: Naruto The Movie,38362448,919651,37442797,2015.csv,2015,0.023972688082887723,0.9760273119171122
1489,The Lazarus Effect,38356892,25801570,12555322,2015.csv,2015,0.6726710287162996,0.3273289712837005
1490,Don't Be Afraid of the Dark,38269529,24046682,14222847,2011.csv,2011,0.6283506128335157,0.3716493871664843
1491,The Water Diviner,38176317,4196641,33979676,2014.csv,2014,0.10992786444014492,0.8900721355598551
1492,Jumping the Broom,38158601,37295394,863207,2011.csv,2011,0.9773784421499101,0.022621557850089943
1493,One for the Money,38080789,26414527,11666262,2011.csv,2011,0.6936444252770078,0.30635557472299224
1494,But Always,38039248,430760,37608488,2014.csv,2014,0.011324093473141214,0.9886759065268588
1495,Overcomer,38026103,34746945,3279158,2019.csv,2019,0.9137656046426845,0.08623439535731547
1496,The Eagle,37989684,19490041,18499643,2011.csv,2011,0.5130350913158425,0.48696490868415754
1497,Kokkuri-san: Gekijô-ban,37982240,0,37982240,2010.csv,2010,0.0,1.0
1498,For Colored Girls,37981984,37729698,252286,2010.csv,2010,0.9933577456090761,0.0066422543909238655
1499,Chek dou,37938005,0,37938005,2015.csv,2015,0.0,1.0
1500,Killing Them Softly,37930465,15026056,22904409,2012.csv,2012,0.39614742397700636,0.6038525760229937
1501,The King,37886707,0,37886707,2017.csv,2017,0.0,1.0
1502,Hell or High Water,37879877,27007844,10872033,2016.csv,2016,0.7129865812394269,0.28701341876057307
1503,Cold Eyes,37795598,0,37795598,2013.csv,2013,0.0,1.0
1504,Mission Milano,37749848,0,37749848,2016.csv,2016,0.0,1.0
1505,The Handmaiden,37692886,2006788,35686098,2016.csv,2016,0.05324049742436809,0.9467595025756319
1506,The Yinyang Master,37690000,0,37690000,2021.csv,2021,0.0,1.0
1507,Rurouni Kenshin Part I: Origins,37654579,0,37654579,2012.csv,2012,0.0,1.0
1508,Pokémon the Movie: I Choose You!,37552144,2401722,35150422,2017.csv,2017,0.06395698738266449,0.9360430126173355
1509,Fat Buddies,37496410,0,37496410,2018.csv,2018,0.0,1.0
1510,A Walk in the Woods,37461274,29504281,7956993,2015.csv,2015,0.7875941699153104,0.21240583008468958
1511,Sarileru Neekevvaru,37389889,821000,36568889,2020.csv,2020,0.021957807898279665,0.9780421921017204
1512,Pain and Glory,37359689,4567338,32792351,2019.csv,2019,0.12225310547954508,0.877746894520455
1513,Snowden,37357216,21587519,15769697,2016.csv,2016,0.5778674460109662,0.4221325539890339
1514,Home Again,37270721,27020284,10250437,2017.csv,2017,0.7249734718037786,0.27502652819622136
1515,"Like Father, Like Son",37170163,334616,36835547,2013.csv,2013,0.009002274216553745,0.9909977257834462
1516,A Witness Out of the Blue,37092694,0,37092694,2019.csv,2019,0.0,1.0
1517,Monster Hunter,37054169,15073969,21980200,2020.csv,2020,0.40680898821398476,0.5931910117860152
1518,Till The End Of The World,37013733,118660,36895073,2018.csv,2018,0.003205837141582018,0.9967941628584179
1519,2.0,36945969,4152000,32793969,2018.csv,2018,0.11238032490093845,0.8876196750990616
1520,Devil's Due,36921560,15821461,21100099,2014.csv,2014,0.42851550692874296,0.571484493071257
1521,Ex Machina,36869414,25442958,11426456,2015.csv,2015,0.6900830590906598,0.3099169409093402
1522,The Adventurers,36796816,216556,36580260,2017.csv,2017,0.0058851831093211975,0.9941148168906788
1523,New Interpretation Records of the Three Kingdoms,36747486,0,36747486,2020.csv,2020,0.0,1.0
1524,Burnt,36606743,13651946,22954797,2015.csv,2015,0.3729352813496683,0.6270647186503318
1525,The Intruder,36599361,35419122,1180239,2019.csv,2019,0.9677524697767265,0.03224753022327357
1526,The Priests,36577134,185093,36392041,2015.csv,2015,0.005060347265042691,0.9949396527349573
1527,The Tower,36512327,0,36512327,2012.csv,2012,0.0,1.0
1528,Detective Conan: The Lost Ship in the Sky,36407407,0,36407407,2010.csv,2010,0.0,1.0
1529,Detective Conan: Private Eye in the Distant Sea,36324232,0,36324232,2013.csv,2013,0.0,1.0
1530,The Secret Reunion,36298578,0,36298578,2010.csv,2010,0.0,1.0
1531,Furry Vengeance,36288132,17630465,18657667,2010.csv,2010,0.48584658477322556,0.5141534152267744
1532,A Most Wanted Man,36233517,17237855,18995662,2014.csv,2014,0.4757433566275115,0.5242566433724886
1533,A Very Harold & Kumar Christmas,36192775,35061031,1131744,2011.csv,2011,0.9687301125708101,0.031269887429189944
1534,Nobunaga Concerto: The Movie,36187594,0,36187594,2016.csv,2016,0.0,1.0
1535,Dügün Dernek,36185741,0,36185741,2013.csv,2013,0.0,1.0
1536,The Confidence Man JP: Princess,36109913,0,36109913,2020.csv,2020,0.0,1.0
1537,Nothing to Lose,36075317,1016188,35059129,2018.csv,2018,0.028168512005036575,0.9718314879949634
1538,T-34,35950901,0,35950901,2018.csv,2018,0.0,1.0
1539,Kundo: Age of the Rampant,35941291,280958,35660333,2014.csv,2014,0.00781713711953196,0.9921828628804681
1540,Ra.One,35911689,2511689,33400000,2011.csv,2011,0.06994070927713815,0.9300592907228619
1541,You Will Meet a Tall Dark Stranger,35867322,3248246,32619076,2010.csv,2010,0.09056282484652743,0.9094371751534726
1542,Doraemon the Movie: The New Records of Nobita's Spaceblazer 2014 Re-release,35861856,0,35861856,2014.csv,2014,0.0,1.0
1543,Conquest 1453,35797045,35730,35761315,2012.csv,2012,0.0009981270800425008,0.9990018729199575
1544,The New Adventures of Aladdin,35771820,0,35771820,2015.csv,2015,0.0,1.0
1545,Heidi,35755670,0,35755670,2015.csv,2015,0.0,1.0
1546,Tad the Lost Explorer and the Secret of King Midas,35704046,5874,35698172,2017.csv,2017,0.00016451916962016014,0.9998354808303799
1547,Hostiles,35669017,29819114,5849903,2017.csv,2017,0.835994835517895,0.164005164482105
1548,The Terror Live,35659824,0,35659824,2013.csv,2013,0.0,1.0
1549,Faster,35626958,23240020,12386938,2010.csv,2010,0.6523155864163311,0.34768441358366886
1550,Good Deeds,35579177,35025791,553386,2012.csv,2012,0.9844463518647438,0.015553648135256191
1551,The Queen's Corgi,35515687,0,35515687,2019.csv,2019,0.0,1.0
1552,Mia and the White Lion,35487190,399471,35087719,2018.csv,2018,0.011256766173934877,0.9887432338260651
1553,Arbitrage,35485056,7919574,27565482,2012.csv,2012,0.22318054112694652,0.7768194588730535
1554,Hide and Seek,35461505,0,35461505,2013.csv,2013,0.0,1.0
1555,Room,35401758,14677654,20724104,2015.csv,2015,0.4146024047732319,0.5853975952267682
1556,Namiya,35351623,70814,35280809,2017.csv,2017,0.0020031329254670996,0.997996867074533
1557,Eye in the Sky,35259653,18704595,16555058,2016.csv,2016,0.5304815393390286,0.46951846066097136
1558,Les Tuche 2: The American Dream,35210425,0,35210425,2016.csv,2016,0.0,1.0
1559,Courageous,35185884,34522221,663663,2011.csv,2011,0.9811383735591239,0.01886162644087612
1560,Destiny: The Tale of Kamakura,35166640,0,35166640,2017.csv,2017,0.0,1.0
1561,The Girl in the Spider's Web,35164920,14841338,20323582,2018.csv,2018,0.42204953118050603,0.577950468819494
1562,My Week with Marilyn,35057696,14600347,20457349,2011.csv,2011,0.4164662446727817,0.5835337553272183
1563,The Liquidator,35046130,0,35046130,2017.csv,2017,0.0,1.0
1564,Welcome to the North,34995189,0,34995189,2012.csv,2012,0.0,1.0
1565,Blind Detective,34958596,0,34958596,2013.csv,2013,0.0,1.0
1566,When Marnie Was There,34949567,561085,34388482,2014.csv,2014,0.016054133088401354,0.9839458669115987
1567,The Sitter,34942188,30441326,4500862,2011.csv,2011,0.8711911801287315,0.12880881987126852
1568,The Hate U Give,34934009,29719483,5214526,2018.csv,2018,0.8507321046376326,0.14926789536236737
1569,Lost and Love,34930177,188817,34741360,2015.csv,2015,0.005405555202311171,0.9945944447976889
1570,Secret in Their Eyes,34854990,20180155,14674835,2015.csv,2015,0.578974631752871,0.42102536824712905
1571,"Dad, Where Are We Going 2",34840000,0,34840000,2015.csv,2015,0.0,1.0
1572,Chimpanzee,34823764,28972764,5851000,2012.csv,2012,0.8319825507661952,0.16801744923380482
1573,Kidnap,34814102,30971040,3843062,2017.csv,2017,0.8896119164584513,0.11038808354154876
1574,Doraemon: Nobita and the Space Heroes,34811747,0,34811747,2015.csv,2015,0.0,1.0
1575,Broken City,34737199,19701164,15036035,2013.csv,2013,0.5671488941868917,0.4328511058131083
1576,Endless Love,34718173,23438250,11279923,2014.csv,2014,0.6751003285800782,0.32489967141992177
1577,Jane Eyre,34710627,11242660,23467967,2011.csv,2011,0.3238967708650149,0.6761032291349851
1578,The Kids Are All Right,34705850,20811365,13894485,2010.csv,2010,0.5996500589958177,0.4003499410041823
1579,Doraemon The Movie: Nobita's Great Battle of the Mermaid King,34702573,0,34702573,2010.csv,2010,0.0,1.0
1580,The Man Standing Next,34664900,113527,34551373,2020.csv,2020,0.003274984205925879,0.9967250157940741
1581,Alex Cross,34618867,25888412,8730455,2012.csv,2012,0.7478122262060165,0.2521877737939835
1582,The Extraordinary Adventures of Adèle Blanc-Sec,34604339,0,34604339,2010.csv,2010,0.0,1.0
1583,R.A.I.D. Special Unit,34598750,0,34598750,2017.csv,2017,0.0,1.0
1584,Salmon Fishing in the Yemen,34564651,9047981,25516670,2012.csv,2012,0.2617697774526929,0.7382302225473071
1585,Haywire,34513760,18942396,15571364,2012.csv,2012,0.548836058430029,0.4511639415699709
1586,Steve Jobs,34441873,17766658,16675215,2015.csv,2015,0.515844710303647,0.484155289696353
1587,Adventures in Zambezia,34428345,0,34428345,2012.csv,2012,0.0,1.0
1588,My Mom is a Character 3,34360029,0,34360029,2020.csv,2020,0.0,1.0
1589,Warrior of the Hornor,34291831,0,34291831,2019.csv,2019,0.0,1.0
1590,Victor Frankenstein,34227298,5775076,28452222,2015.csv,2015,0.16872719546836562,0.8312728045316343
1591,The House,34184504,25584504,8600000,2017.csv,2017,0.748424022767743,0.25157597723225705
1592,Cirque du Soleil: Worlds Away,34153101,12512862,21640239,2012.csv,2012,0.36637557450493297,0.633624425495067
1593,The Battle: Roar to Victory,34148707,0,34148707,2019.csv,2019,0.0,1.0
1594,Black & White: The Dawn of Justice,34146896,0,34146896,2014.csv,2014,0.0,1.0
1595,The Bad Guys: The Movie,34024386,166972,33857414,2019.csv,2019,0.004907421400638942,0.9950925785993611
1596,"My Love, Don't Cross That River",34012261,0,34012261,2014.csv,2014,0.0,1.0
1597,The Witness,33963557,418063,33545494,2015.csv,2015,0.012309164202088727,0.9876908357979113
1598,Camping 2,33857735,0,33857735,2010.csv,2010,0.0,1.0
1599,The Good Liar,33856058,17156058,16700000,2019.csv,2019,0.5067352495674482,0.49326475043255186
1600,Don't Go Breaking My Heart 2,33801759,0,33801759,2014.csv,2014,0.0,1.0
1601,The Art of Racing in the Rain,33766787,26395642,7371145,2019.csv,2019,0.7817042823766442,0.21829571762335576
1602,I Want to Eat Your Pancreas,33748006,277019,33470987,2017.csv,2017,0.008208455338072419,0.9917915446619275
1603,Deliver Us from Evil,33718703,0,33718703,2020.csv,2020,0.0,1.0
1604,Nobody's Fool,33705333,31713110,1992223,2018.csv,2018,0.9408929441521909,0.05910705584780901
1605,The Skin I Live In,33678406,3185812,30492594,2011.csv,2011,0.09459509455405936,0.9054049054459407
1606,Three Heroes on Distant Shores,33674759,0,33674759,2012.csv,2012,0.0,1.0
1607,Gantz: Perfect Answer,33672515,0,33672515,2011.csv,2011,0.0,1.0
1608,Punch,33556725,0,33556725,2011.csv,2011,0.0,1.0
1609,Bloodshot,33542457,12561824,20980633,2020.csv,2020,0.37450518308781017,0.6254948169121898
1610,Arthur 3: The War of the Two Worlds,33519334,0,33519334,2010.csv,2010,0.0,1.0
1611,Doraemon the Movie: Nobita's New Dinosaur,33479893,0,33479893,2020.csv,2020,0.0,1.0
1612,2016: Obama's America,33449086,33449086,0,2012.csv,2012,1.0,0.0
1613,Get on Up,33448971,30703100,2745871,2014.csv,2014,0.9179086555457865,0.08209134445421355
1614,The Perks of Being a Wallflower,33384127,17742948,15641179,2012.csv,2012,0.5314785676438386,0.46852143235616134
1615,Girls,33325338,0,33325338,2014.csv,2014,0.0,1.0
1616,Perfect Strangers,33262366,1014507,32247859,2017.csv,2017,0.03050014541960124,0.9694998545803988
1617,Project Almanac,33213241,22348241,10865000,2015.csv,2015,0.6728714310054836,0.32712856899451637
1618,Bharat,33185983,2971549,30214434,2019.csv,2019,0.08954229259986062,0.9104577074001394
1619,Baaghi 2,33139063,1319579,31819484,2018.csv,2018,0.039819442088631175,0.9601805579113688
1620,Dogwood Tree,33016351,0,33016351,2010.csv,2010,0.0,1.0
1621,Lockout,32948113,14326864,18621249,2012.csv,2012,0.43483109336185655,0.5651689066381435
1622,Inside Llewyn Davis,32935319,13235319,19700000,2013.csv,2013,0.40185792644060925,0.5981420735593908
1623,Sleepless,32917353,20783704,12133649,2017.csv,2017,0.6313905009312262,0.3686094990687738
1624,Brightburn,32893421,17300439,15592982,2019.csv,2019,0.5259543846169117,0.4740456153830883
1625,Les profs,32849727,0,32849727,2013.csv,2013,0.0,1.0
1626,Hindi Medium,32841493,0,32841493,2017.csv,2017,0.0,1.0
1627,Bait,32813407,0,32813407,2012.csv,2012,0.0,1.0
1628,The Crossing,32806475,0,32806475,2014.csv,2014,0.0,1.0
1629,Fly Me to the Saitama,32802347,0,32802347,2019.csv,2019,0.0,1.0
1630,Big Red Envelope,32800000,0,32800000,2021.csv,2021,0.0,1.0
1631,Old Boys: The Way of the Dragon,32800000,0,32800000,2014.csv,2014,0.0,1.0
1632,Steel Rain,32783733,0,32783733,2017.csv,2017,0.0,1.0
1633,C'est la vie!,32764243,0,32764243,2017.csv,2017,0.0,1.0
1634,Katy Perry: Part of Me,32726956,25326071,7400885,2012.csv,2012,0.7738596586862524,0.2261403413137476
1635,Leap Year,32686500,25918920,6767580,2010.csv,2010,0.7929548896333348,0.20704511036666515
1636,Mud,32613173,21590086,11023087,2013.csv,2013,0.6620050738393348,0.3379949261606652
1637,The Hurricane Heist,32517248,6115825,26401423,2018.csv,2018,0.18807941557661953,0.8119205844233804
1638,Midsummer's Equation,32514549,0,32514549,2013.csv,2013,0.0,1.0
1639,Nameless Gangster: Rules of the Time,32472645,0,32472645,2012.csv,2012,0.0,1.0
1640,UglyDolls,32450241,20150241,12300000,2019.csv,2019,0.6209581309426947,0.3790418690573053
1641,Movie 43,32438988,8840453,23598535,2012.csv,2012,0.2725255485775327,0.7274744514224674
1642,The House That Never Dies: Reawakening,32433588,0,32433588,2017.csv,2017,0.0,1.0
1643,Stuber,32390945,22370452,10020493,2019.csv,2019,0.6906390659488323,0.3093609340511677
1644,Detective K: Secret of Virtuous Widow,32358664,0,32358664,2011.csv,2011,0.0,1.0
1645,Hit Me Anyone One More Time!,32333512,0,32333512,2019.csv,2019,0.0,1.0
1646,Kevin Hart: Let Me Explain,32318051,32244051,74000,2013.csv,2013,0.997710257960791,0.002289742039208986
1647,Potiche,32309881,1618844,30691037,2010.csv,2010,0.050103681904616115,0.9498963180953839
1648,Pokémon,32293377,0,32293377,2013.csv,2013,0.0,1.0
1649,Seven Psychopaths,32226382,15024049,17202333,2012.csv,2012,0.4662034044032619,0.5337965955967381
1650,Somewhere Winter,32218990,0,32218990,2019.csv,2019,0.0,1.0
1651,The After-Dinner Mysteries,32160741,0,32160741,2013.csv,2013,0.0,1.0
1652,The Kid Who Would Be King,32140970,16790790,15350180,2019.csv,2019,0.5224108046521309,0.4775891953478691
1653,You Again,32054369,25702053,6352316,2010.csv,2010,0.8018268274131367,0.1981731725868633
1654,Two Tigers,32001580,0,32001580,2019.csv,2019,0.0,1.0
1655,Os Dez Mandamentos - O Filme,31998251,0,31998251,2016.csv,2016,0.0,1.0
1656,Dilwale,31994323,4871263,27123060,2015.csv,2015,0.15225397955756087,0.8477460204424391
1657,Suffragette,31972096,4702420,27269676,2015.csv,2015,0.1470788777814254,0.8529211222185746
1658,The Floating Castle,31967471,0,31967471,2012.csv,2012,0.0,1.0
1659,The Neighbors,31949315,0,31949315,2012.csv,2012,0.0,1.0
1660,I Fell in Love Like A Flower Bouquet,31946381,0,31946381,2021.csv,2021,0.0,1.0
1661,All About Me,31920159,0,31920159,2018.csv,2018,0.0,1.0
1662,Bounty Hunters,31918573,0,31918573,2016.csv,2016,0.0,1.0
1663,Bad Times at the El Royale,31882724,17839115,14043609,2018.csv,2018,0.5595229253309724,0.44047707466902764
1664,Tinker Bell and the Legend of the NeverBeast,31836701,0,31836701,2014.csv,2014,0.0,1.0
1665,The Dream Team,31822402,0,31822402,2012.csv,2012,0.0,1.0
1666,Self/less,31807156,12279691,19527465,2015.csv,2015,0.38606692783221486,0.6139330721677851
1667,Underdogs,31775719,0,31775719,2013.csv,2013,0.0,1.0
1668,Spring Breakers,31724284,14124284,17600000,2013.csv,2013,0.44521994570468476,0.5547800542953152
1669,Hunter Killer,31672678,15767460,15905218,2018.csv,2018,0.49782528651350544,0.5021747134864946
1670,New World,31670607,457806,31212801,2013.csv,2013,0.014455232891494628,0.9855447671085054
1671,Ae Dil Hai Mushkil,31668920,4264983,27403937,2016.csv,2016,0.1346740905594507,0.8653259094405493
1672,Anna,31626978,7743794,23883184,2019.csv,2019,0.2448477372703772,0.7551522627296228
1673,Super Troopers 2,31626386,30617396,1008990,2018.csv,2018,0.9680965760678442,0.03190342393215589
1674,The Four 3,31521335,0,31521335,2014.csv,2014,0.0,1.0
1675,Bodyguard,31516209,1834384,29681825,2011.csv,2011,0.058204462345074565,0.9417955376549254
1676,The Thing,31505287,16928670,14576617,2011.csv,2011,0.5373279094394537,0.46267209056054626
1677,Harry Potter and the Sorcerer's Stone 2020 Re-release,31501815,0,31501815,2020.csv,2020,0.0,1.0
1678,I Don't Know How She Does It,31410151,9662284,21747867,2011.csv,2011,0.3076166045811114,0.6923833954188886
1679,Assassination Classroom: The Graduation,31352921,0,31352921,2016.csv,2016,0.0,1.0
1680,"All's Well, Ends Well 2011",31335572,0,31335572,2011.csv,2011,0.0,1.0
1681,What's in a Name?,31303580,8111,31295469,2012.csv,2012,0.00025910774422605975,0.9997408922557739
1682,101 Proposals,31283838,0,31283838,2013.csv,2013,0.0,1.0
1683,Tazza: The Hidden Card,31278476,251555,31026921,2014.csv,2014,0.008042431479078457,0.9919575685209215
1684,Perfect Strangers,31254929,0,31254929,2016.csv,2016,0.0,1.0
1685,Saving Mr. Wu,31222161,92696,31129465,2015.csv,2015,0.0029689168536412326,0.9970310831463588
1686,The Invisible Guest,31191910,0,31191910,2017.csv,2017,0.0,1.0
1687,My Dear Liar,31177968,90545,31087423,2019.csv,2019,0.0029041340987969455,0.997095865901203
1688,Joyful Noise,31158113,30932113,226000,2012.csv,2012,0.9927466724316714,0.007253327568328673
1689,Honest Thief,31135149,14163574,16971575,2020.csv,2020,0.454906254021781,0.545093745978219
1690,Mrs. Brown's Boys D'Movie,31116264,0,31116264,2014.csv,2014,0.0,1.0
1691,Premium Rush,31083599,20275446,10808153,2012.csv,2012,0.6522875938529512,0.3477124061470488
1692,The Wild Goose Lake,31042413,12573,31029840,2019.csv,2019,0.00040502650357754084,0.9995949734964225
1693,The Strangers: Prey at Night,31039126,24586708,6452418,2018.csv,2018,0.7921198554366512,0.20788014456334886
1694,Vysotsky: Thank God I'm Alive,31016553,0,31016553,2011.csv,2011,0.0,1.0
1695,This Is Not What I Expected,30996615,337670,30658945,2017.csv,2017,0.010893770174581966,0.9891062298254181
1696,Silenced,30996130,0,30996130,2011.csv,2011,0.0,1.0
1697,Playing for Keeps,30962335,13103272,17859063,2012.csv,2012,0.42320038201253235,0.5767996179874677
1698,Rise of the Legend,30932534,0,30932534,2014.csv,2014,0.0,1.0
1699,Billy Lynn's Long Halftime Walk,30930984,1738477,29192507,2016.csv,2016,0.05620503376161586,0.9437949662383841
1700,Pandora,30896701,0,30896701,2016.csv,2016,0.0,1.0
1701,Gintama 2: Rules are Made to be Broken,30896653,0,30896653,2018.csv,2018,0.0,1.0
1702,African Cats,30857747,15428747,15429000,2011.csv,2011,0.499995900543225,0.500004099456775
1703,Attack on Titan Part 1,30810658,449523,30361135,2015.csv,2015,0.014589853939503662,0.9854101460604964
1704,Winter's Tale,30800231,12600231,18200000,2014.csv,2014,0.40909534087585253,0.5909046591241475
1705,Norm of the North,30734502,17062499,13672003,2016.csv,2016,0.5551578157993254,0.44484218420067456
1706,Carnage,30722632,2547047,28175585,2011.csv,2011,0.08290458317503527,0.9170954168249648
1707,A Man Called Ove,30691696,3479315,27212381,2015.csv,2015,0.11336339966354417,0.8866366003364559
1708,A Wedding Invitation,30665036,14350,30650686,2013.csv,2013,0.0004679596658552757,0.9995320403341448
1709,When the Bough Breaks,30658387,29747603,910784,2016.csv,2016,0.9702925010373181,0.02970749896268189
1710,Wild Tales,30642704,3106530,27536174,2014.csv,2014,0.10137910805782675,0.8986208919421732
1711,Posledniy bogatyr,30618274,0,30618274,2017.csv,2017,0.0,1.0
1712,A Dangerous Method,30519436,5704709,24814727,2011.csv,2011,0.18692052500577008,0.81307947499423
1713,The Four,30505808,0,30505808,2012.csv,2012,0.0,1.0
1714,What's Your Number?,30426096,14011084,16415012,2011.csv,2011,0.4604956219161341,0.5395043780838659
1715,Like a Boss,30399490,22169514,8229976,2020.csv,2020,0.7292725634541896,0.2707274365458105
1716,S Storm,30381402,0,30381402,2016.csv,2016,0.0,1.0
1717,The Way of the Bug,30355804,0,30355804,2018.csv,2018,0.0,1.0
1718,Nocturnal Animals,30311857,10663357,19648500,2016.csv,2016,0.3517883117487655,0.6482116882512345
1719,Doraemon: Nobita and the New Steel Troops: ~Winged Angels~,30236973,0,30236973,2011.csv,2011,0.0,1.0
1720,Far from the Madding Crowd,30229977,12236500,17993477,2015.csv,2015,0.40478032781831097,0.595219672181689
1721,Eternal Moment,30186159,0,30186159,2011.csv,2011,0.0,1.0
1722,The Grand Heist,30158762,0,30158762,2012.csv,2012,0.0,1.0
1723,A Silent Voice: The Movie,30156463,310407,29846056,2016.csv,2016,0.010293216415996797,0.9897067835840032
1724,When the Game Stands Tall,30138754,30127963,10791,2014.csv,2014,0.9996419560012335,0.0003580439987665051
1725,The Rum Diary,30134958,13109815,17025143,2011.csv,2011,0.4350367768888213,0.5649632231111787
1726,Clergy,30114115,0,30114115,2018.csv,2018,0.0,1.0
1727,My Own Swordsman,30082188,0,30082188,2011.csv,2011,0.0,1.0
1728,Reset 2017 Re-release,29949252,108970,29840282,2017.csv,2017,0.0036384881999724067,0.9963615118000276
1729,Keeping Up with the Joneses,29918745,14904426,15014319,2016.csv,2016,0.4981634757741342,0.5018365242258658
1730,My Hero Academia: Heroes Rising,29876826,13304000,16572826,2019.csv,2019,0.4452949587081305,0.5547050412918695
1731,The Bye Bye Man,29874280,22395806,7478474,2017.csv,2017,0.7496684773658143,0.2503315226341857
1732,You Are the Apple of My Eye,29843025,0,29843025,2011.csv,2011,0.0,1.0
1733,Draft Day,29824199,28842237,981962,2014.csv,2014,0.9670749916871195,0.03292500831288042
1734,The Disaster Artist,29820616,21120616,8700000,2017.csv,2017,0.7082555236283516,0.2917444763716484
1735,Ice,29806210,0,29806210,2018.csv,2018,0.0,1.0
1736,Jackie,29777777,13960394,15817383,2016.csv,2016,0.46881921373781527,0.5311807862621847
1737,The Little Things,29755000,15155000,14600000,2021.csv,2021,0.5093261636699714,0.4906738363300286
1738,Torrente 4,29737384,0,29737384,2011.csv,2011,0.0,1.0
1739,The Swindlers,29721916,241916,29480000,2017.csv,2017,0.008139313764294335,0.9918606862357057
1740,The Raven,29699345,16008272,13691073,2012.csv,2012,0.5390109445174632,0.4609890554825367
1741,Masterminds,29674699,17368022,12306677,2016.csv,2016,0.5852804774868988,0.4147195225131011
1742,Amour,29652180,6739492,22912688,2012.csv,2012,0.22728487416439533,0.7727151258356046
1743,The Sorcerer and the White Snake,29649716,0,29649716,2011.csv,2011,0.0,1.0
1744,Rajneeti,29459596,1514558,27945038,2010.csv,2010,0.051411363550267285,0.9485886364497327
1745,The Losers,29397654,23591432,5806222,2010.csv,2010,0.8024936955853689,0.19750630441463118
1746,All About My Wife,29382038,0,29382038,2012.csv,2012,0.0,1.0
1747,Alibi.com,29370592,0,29370592,2017.csv,2017,0.0,1.0
1748,Mr. Holmes,29355203,17737646,11617557,2015.csv,2015,0.6042419805443008,0.3957580194556992
1749,Rowdy Rathore,29342463,777373,28565090,2012.csv,2012,0.02649310659435781,0.9735068934056422
1750,Sword Art Online the Movie: Ordinal Scale,29322339,1522976,27799363,2017.csv,2017,0.05193910349375607,0.9480608965062439
1751,Free Solo,29318861,17541090,11777771,2018.csv,2018,0.5982868843370143,0.4017131156629857
1752,Silent Witness,29315945,0,29315945,2013.csv,2013,0.0,1.0
1753,Big Eyes,29253166,14482031,14771135,2014.csv,2014,0.495058586137309,0.504941413862691
1754,Fall In Love At First Kiss,29206238,0,29206238,2019.csv,2019,0.0,1.0
1755,The Santa Claus Gang,29181330,0,29181330,2010.csv,2010,0.0,1.0
1756,Dark Figure of Crime,29176133,0,29176133,2018.csv,2018,0.0,1.0
1757,Flight Crew,29171110,0,29171110,2016.csv,2016,0.0,1.0
1758,Unfair: The Answer,29166054,0,29166054,2011.csv,2011,0.0,1.0
1759,Viking,29161298,0,29161298,2016.csv,2016,0.0,1.0
1760,Dragon,29140858,0,29140858,2011.csv,2011,0.0,1.0
1761,Special ID,29139936,12666,29127270,2013.csv,2013,0.0004346612154535961,0.9995653387845465
1762,Sacrifice,29093560,29792,29063768,2010.csv,2010,0.0010240066873906115,0.9989759933126093
1763,The Fatal Encounter,29060186,0,29060186,2014.csv,2014,0.0,1.0
1764,Pad Man,29045020,1670192,27374828,2018.csv,2018,0.057503558269197265,0.9424964417308027
1765,SPEC: Heaven,29023960,0,29023960,2012.csv,2012,0.0,1.0
1766,Nobody,28994735,15623735,13371000,2021.csv,2021,0.5388473114170556,0.46115268858294445
1767,Recep Ivedik 5,28952258,0,28952258,2017.csv,2017,0.0,1.0
1768,M.S. Dhoni: The Untold Story,28903047,1801550,27101497,2016.csv,2016,0.06233079854867897,0.937669201451321
1769,We Were There: True Love,28876929,0,28876929,2012.csv,2012,0.0,1.0
1770,Kokowääh 2,28811936,0,28811936,2013.csv,2013,0.0,1.0
1771,Bol Bachchan,28775262,1216258,27559004,2012.csv,2012,0.04226748656536993,0.9577325134346301
1772,Mirai,28756961,812794,27944167,2018.csv,2018,0.028264252262260953,0.9717357477377391
1773,Judwaa 2,28733523,1431255,27302268,2017.csv,2017,0.04981133013170713,0.9501886698682929
1774,Yolki 2,28719002,0,28719002,2011.csv,2011,0.0,1.0
1775,Bath Buddy,28700000,0,28700000,2020.csv,2020,0.0,1.0
1776,Master,28692230,0,28692230,2021.csv,2021,0.0,1.0
1777,The Suspect,28674130,218693,28455437,2013.csv,2013,0.007626839942484741,0.9923731600575153
1778,The Fortress,28645448,252895,28392553,2017.csv,2017,0.008828453302598025,0.9911715466974019
1779,Love & Mercy,28641776,12551031,16090745,2015.csv,2015,0.43820714888629814,0.5617928511137019
1780,Maya the Bee Movie,28638603,0,28638603,2014.csv,2014,0.0,1.0
1781,The Four 2,28599970,0,28599970,2013.csv,2013,0.0,1.0
1782,Pokémon the Movie: Diancie and the Cocoon of Destruction,28595105,0,28595105,2014.csv,2014,0.0,1.0
1783,Flying Colors,28525563,0,28525563,2015.csv,2015,0.0,1.0
1784,Deranged,28444173,0,28444173,2012.csv,2012,0.0,1.0
1785,The Kiyosu Conference,28338665,0,28338665,2013.csv,2013,0.0,1.0
1786,The Last Warrior: Root of Evil,28338091,0,28338091,2021.csv,2021,0.0,1.0
1787,I Give It a Year,28328531,34657,28293874,2013.csv,2013,0.0012233955936507969,0.9987766044063492
1788,The Master,28258060,16377274,11880786,2012.csv,2012,0.5795611588339752,0.42043884116602487
1789,Fan,28240000,2300000,25940000,2016.csv,2016,0.08144475920679886,0.9185552407932012
1790,Gully Boy,28141995,5566534,22575461,2019.csv,2019,0.19780168392468267,0.8021983160753173
1791,"Yôkai Watch: the Movie: The Flying Whale and the Grand Adventure of the Double Worlds, Meow!",28110245,0,28110245,2016.csv,2016,0.0,1.0
1792,Triumph in the Skies,28085162,0,28085162,2015.csv,2015,0.0,1.0
1793,Welcome to Germany,28036021,0,28036021,2016.csv,2016,0.0,1.0
1794,Your Highness,28013733,21596445,6417288,2011.csv,2011,0.7709234967007075,0.22907650329929252
1795,Mandela: Long Walk to Freedom,27985788,8323085,19662703,2013.csv,2013,0.29740398948208996,0.70259601051791
1796,The Brothers Grimsby,27979040,6874837,21104203,2016.csv,2016,0.24571382720779555,0.7542861727922044
1797,What Happened to Monday,27975429,0,27975429,2017.csv,2017,0.0,1.0
1798,The 33,27972023,12227722,15744301,2015.csv,2015,0.4371411392018375,0.5628588607981625
1799,The Divine Move,27926871,136707,27790164,2014.csv,2014,0.004895177837860891,0.9951048221621391
1800,Monster Family,27890108,127259,27762849,2017.csv,2017,0.004562872255639885,0.9954371277443601
1801,The Beguiled,27869129,10709995,17159134,2017.csv,2017,0.3842960072415611,0.6157039927584389
1802,When Larry Meets Mary,27863090,0,27863090,2016.csv,2016,0.0,1.0
1803,Dark Skies,27858103,17418667,10439436,2013.csv,2013,0.6252639312877837,0.3747360687122163
1804,The Lady Shogun and Her Men,27769952,0,27769952,2010.csv,2010,0.0,1.0
1805,Love Strikes!,27707149,0,27707149,2011.csv,2011,0.0,1.0
1806,Kim Ji-young: Born 1982,27696393,0,27696393,2019.csv,2019,0.0,1.0
1807,Default,27694043,203775,27490268,2018.csv,2018,0.007358080580722721,0.9926419194192773
1808,Nebraska,27682872,17654912,10027960,2013.csv,2013,0.6377557935462765,0.36224420645372346
1809,Bride Wars,27670000,0,27670000,2015.csv,2015,0.0,1.0
1810,One Cut of the Dead,27590180,52406,27537774,2018.csv,2018,0.0018994439325876091,0.9981005560674124
1811,Nicholas on Holiday,27567832,0,27567832,2014.csv,2014,0.0,1.0
1812,The Women on the 6th Floor,27533970,719823,26814147,2011.csv,2011,0.026143087974600104,0.9738569120253999
1813,Grace of Monaco,27515247,0,27515247,2014.csv,2014,0.0,1.0
1814,The Happytime Murders,27506452,20706452,6800000,2018.csv,2018,0.7527852737968532,0.2472147262031468
1815,The Incredible Burt Wonderstone,27437881,22537881,4900000,2013.csv,2013,0.8214147805364416,0.17858521946355843
1816,Yesterday Once More,27411872,0,27411872,2016.csv,2016,0.0,1.0
1817,Left Behind,27405896,14019924,13385972,2014.csv,2014,0.5115659783573578,0.48843402164264216
1818,Irrational Man,27391084,4030360,23360724,2015.csv,2015,0.14714131065422603,0.852858689345774
1819,Jing wu feng yun: Chen Zhen,27390678,50433,27340245,2010.csv,2010,0.0018412468650830767,0.998158753134917
1820,Detective K: Secret of the Lost Island,27387870,185367,27202503,2015.csv,2015,0.006768215271943382,0.9932317847280566
1821,Gorko!,27369902,0,27369902,2013.csv,2013,0.0,1.0
1822,Midnight Sun,27365467,9561064,17804403,2018.csv,2018,0.34938428056060583,0.6506157194393942
1823,Pokémon: Mewtwo Strikes Back - Evolution,27347118,0,27347118,2019.csv,2019,0.0,1.0
1824,Ramona and Beezus,27293743,26167002,1126741,2010.csv,2010,0.9587179742990912,0.04128202570090881
1825,To the Fore,27267799,0,27267799,2015.csv,2015,0.0,1.0
1826,American Ultra,27262374,14440985,12821389,2015.csv,2015,0.5297038695162791,0.4702961304837209
1827,VIP Policeman,27222681,0,27222681,2018.csv,2018,0.0,1.0
1828,Khumba,27187375,1029,27186346,2013.csv,2013,3.7848449877930475e-05,0.999962151550122
1829,Splice 2010 Re-release,27127620,17010170,10117450,2010.csv,2010,0.627042475528631,0.37295752447136904
1830,Let Me In,27093592,12134935,14958657,2010.csv,2010,0.4478894861928976,0.5521105138071024
1831,Vaterfreuden,27088817,0,27088817,2014.csv,2014,0.0,1.0
1832,My Neighbor Totoro 2018 Re-release,27083857,1144649,25939208,2018.csv,2018,0.042263145902741994,0.9577368540972581
1833,Hitchcock,27039669,6008677,21030992,2012.csv,2012,0.22221710628188532,0.7777828937181147
1834,Almost a Comedy,26990962,0,26990962,2019.csv,2019,0.0,1.0
1835,Listy do M.,26923513,0,26923513,2011.csv,2011,0.0,1.0
1836,Total Dhamaal,26911995,2167632,24744363,2019.csv,2019,0.08054519926895051,0.9194548007310495
1837,The Witches,26900000,0,26900000,2020.csv,2020,0.0,1.0
1838,You're Next,26895481,18494006,8401475,2013.csv,2013,0.6876250326216512,0.3123749673783488
1839,Mr. Go,26835201,0,26835201,2013.csv,2013,0.0,1.0
1840,CHIPS,26800152,18600152,8200000,2017.csv,2017,0.6940315860895118,0.3059684139104883
1841,The Faces of My Gene,26796279,0,26796279,2018.csv,2018,0.0,1.0
1842,Dearest,26723916,0,26723916,2012.csv,2012,0.0,1.0
1843,Stand by Me Doraemon 2,26663967,0,26663967,2020.csv,2020,0.0,1.0
1844,Architecture 101,26642354,0,26642354,2012.csv,2012,0.0,1.0
1845,A Cure for Wellness,26620002,8106986,18513016,2017.csv,2017,0.3045449057441844,0.6954550942558156
1846,A Monster in Paris,26611650,0,26611650,2011.csv,2011,0.0,1.0
1847,Missing Link,26565710,16649539,9916171,2019.csv,2019,0.626730435587831,0.3732695644121689
1848,No Manches Frida 2,26493648,9270920,17222728,2019.csv,2019,0.3499299152762957,0.6500700847237043
1849,A Hard Day,26488847,19004,26469843,2014.csv,2014,0.0007174340204388662,0.9992825659795611
1850,The Break Up Man,26477012,0,26477012,2013.csv,2013,0.0,1.0
1851,The Way Way Back,26474920,21506546,4968374,2013.csv,2013,0.8123365811870253,0.18766341881297469
1852,We Are the Nobles,26433651,0,26433651,2013.csv,2013,0.0,1.0
1853,Ivan Tsarevich & the Grey Wolf,26420475,0,26420475,2011.csv,2011,0.0,1.0
1854,Dancing Queen,26411266,0,26411266,2012.csv,2012,0.0,1.0
1855,Only the Brave,26351322,18343983,8007339,2017.csv,2017,0.6961314123063731,0.3038685876936269
1856,Twenty Two,26289378,46796,26242582,2017.csv,2017,0.0017800345067121785,0.9982199654932878
1857,Orange,26261536,0,26261536,2015.csv,2015,0.0,1.0
1858,Aloha,26250020,21067116,5182904,2015.csv,2015,0.8025561885286182,0.19744381147138174
1859,The Stolen Years,26249553,0,26249553,2013.csv,2013,0.0,1.0
1860,Apollo 18,26236153,17687709,8548444,2011.csv,2011,0.6741731152429246,0.3258268847570755
1861,The Confidence Man JP,26228317,0,26228317,2019.csv,2019,0.0,1.0
1862,One Night Surprise,26220159,0,26220159,2013.csv,2013,0.0,1.0
1863,Lesson of the Evil,26167224,0,26167224,2012.csv,2012,0.0,1.0
1864,The Zookeeper's Wife,26152835,17571660,8581175,2017.csv,2017,0.6718835644395722,0.32811643556042774
1865,Badrinath Ki Dulhania,26134309,1993259,24141050,2017.csv,2017,0.0762698183449197,0.9237301816550803
1866,Badhaai Ho,26125610,0,26125610,2018.csv,2018,0.0,1.0
1867,Top Five,26117471,25317471,800000,2014.csv,2014,0.9693691628871723,0.030630837112827655
1868,Hichki,26055222,330279,25724943,2018.csv,2018,0.012676115367583512,0.9873238846324165
1869,Platinum Data,26052718,0,26052718,2013.csv,2013,0.0,1.0
1870,Iceman,26033917,7679,26026238,2014.csv,2014,0.0002949613767302093,0.9997050386232698
1871,Agneepath,26001696,1986748,24014948,2012.csv,2012,0.07640840043664844,0.9235915995633516
1872,The Light Between Oceans,25975621,12545979,13429642,2016.csv,2016,0.48299053177592943,0.5170094682240706
1873,A Chinese Odyssey: Part Two - Cinderella 2017 Re-release,25960664,0,25960664,2017.csv,2017,0.0,1.0
1874,Love Off the Cuff,25959989,0,25959989,2017.csv,2017,0.0,1.0
1875,The Confidence Man JP: The Movie,25958189,0,25958189,2019.csv,2019,0.0,1.0
1876,White Boy Rick,25957482,24011188,1946294,2018.csv,2018,0.925019922964793,0.07498007703520704
1877,Emma.,25950131,10055355,15894776,2020.csv,2020,0.3874876392724183,0.6125123607275816
1878,Meet Miss Anxiety,25948636,0,25948636,2014.csv,2014,0.0,1.0
1879,"Paul, Apostle of Christ",25915966,17560475,8355491,2018.csv,2018,0.6775929170458087,0.32240708295419124
1880,Huevos: Little Rooster's Egg-cellent Adventure,25892561,9080818,16811743,2015.csv,2015,0.3507114649647827,0.6492885350352172
1881,Gekijouban SPEC: Kurôzu - Zen no hen,25860404,0,25860404,2013.csv,2013,0.0,1.0
1882,Dügün Dernek 2: Sünnet,25836668,0,25836668,2015.csv,2015,0.0,1.0
1883,Leap,25818882,83074,25735808,2020.csv,2020,0.00321756767004861,0.9967824323299513
1884,Unbeatable,25816154,0,25816154,2013.csv,2013,0.0,1.0
1885,Rust and Bone,25807712,2062027,23745685,2012.csv,2012,0.07989964395138942,0.9201003560486106
1886,Our Idiot Brother,25804448,24816118,988330,2011.csv,2011,0.9616992388289026,0.038300761171097326
1887,Fair Game,25798915,9540691,16258224,2010.csv,2010,0.3698097768840279,0.6301902231159722
1888,"The Gangster, the Cop, the Devil",25775371,216494,25558877,2019.csv,2019,0.008399258346271718,0.9916007416537282
1889,Man on the Edge,25774679,0,25774679,2013.csv,2013,0.0,1.0
1890,A Beautiful Planet,25730120,15650615,10079505,2016.csv,2016,0.6082604744944835,0.3917395255055165
1891,Champions,25674036,0,25674036,2018.csv,2018,0.0,1.0
1892,Fireworks,25672406,525280,25147126,2017.csv,2017,0.020460879280266915,0.979539120719733
1893,The Roundup,25623521,0,25623521,2010.csv,2010,0.0,1.0
1894,Father Figures,25601244,17501244,8100000,2017.csv,2017,0.6836091246191005,0.31639087538089944
1895,"Love, Rosie",25574387,20431,25553956,2014.csv,2014,0.0007988852284123173,0.9992011147715877
1896,Mr. Donkey,25537759,356255,25181504,2016.csv,2016,0.013950127730471574,0.9860498722695284
1897,Look Who's Back,25513752,0,25513752,2015.csv,2015,0.0,1.0
1898,Money,25403753,0,25403753,2017.csv,2017,0.0,1.0
1899,Head Over Heels 2,25402893,0,25402893,2012.csv,2012,0.0,1.0
1900,Keys To The Heart,25375866,75134,25300732,2018.csv,2018,0.0029608447648643795,0.9970391552351356
1901,Serial Teachers 2,25364150,0,25364150,2015.csv,2015,0.0,1.0
1902,Natale in Sudafrica,25362517,0,25362517,2010.csv,2010,0.0,1.0
1903,A Haunted House 2,25358716,17329486,8029230,2014.csv,2014,0.6833739531607199,0.31662604683928003
1904,And So It Goes,25312387,15160801,10151586,2014.csv,2014,0.5989478985130877,0.40105210148691234
1905,Bodies at Rest,25293853,0,25293853,2019.csv,2019,0.0,1.0
1906,Enough Said,25288872,17550872,7738000,2013.csv,2013,0.6940156128751017,0.3059843871248983
1907,Biutiful,25147786,5101237,20046549,2010.csv,2010,0.20285034237208793,0.797149657627912
1908,On the Other Side of the Tracks,25109572,9572,25100000,2012.csv,2012,0.0003812092057961004,0.9996187907942039
1909,Born in China,25081168,13873211,11207957,2016.csv,2016,0.5531325734112542,0.4468674265887458
1910,Race,25070261,19206207,5864054,2016.csv,2016,0.7660952153629353,0.2339047846370646
1911,Helter Skelter,25066699,0,25066699,2012.csv,2012,0.0,1.0
1912,The Last Exorcism Part II,25051865,15179302,9872563,2013.csv,2013,0.6059150486400913,0.39408495135990873
1913,Call of Heroes,25040561,0,25040561,2016.csv,2016,0.0,1.0
1914,Free State of Jones,25035950,20810036,4225914,2016.csv,2016,0.8312061655339622,0.16879383446603785
1915,Six Degrees of Celebration,25030264,0,25030264,2010.csv,2010,0.0,1.0
1916,The Last Tycoon,25009914,0,25009914,2012.csv,2012,0.0,1.0
1917,"Me, Myself and Mum",24991467,0,24991467,2013.csv,2013,0.0,1.0
1918,Whiskey Tango Foxtrot,24972139,23083334,1888805,2016.csv,2016,0.924363507667485,0.07563649233251504
1919,Booksmart,24959607,22680962,2278645,2019.csv,2019,0.9087066955821861,0.09129330441781396
1920,Housefull 2,24922847,1791780,23131067,2012.csv,2012,0.07189307064317331,0.9281069293568267
1921,Scoob!,24900000,0,24900000,2020.csv,2020,0.0,1.0
1922,Wild City,24817852,34866,24782986,2015.csv,2015,0.0014048758127818636,0.9985951241872182
1923,Elle s'appelait Sarah,24792815,7693187,17099628,2010.csv,2010,0.31029905236658284,0.6897009476334172
1924,Eyyvah Eyvah 2,24792348,0,24792348,2011.csv,2011,0.0,1.0
1925,Lottery Ticket,24719879,24719879,0,2010.csv,2010,1.0,0.0
1926,Big Miracle,24719215,20157300,4561915,2012.csv,2012,0.815450652458017,0.18454934754198302
1927,Super 30,24701637,2269878,22431759,2019.csv,2019,0.09189180457959123,0.9081081954204088
1928,Soulmate,24684439,0,24684439,2016.csv,2016,0.0,1.0
1929,Drug War,24676341,128195,24548146,2013.csv,2013,0.005195057079167451,0.9948049429208325
1930,Ready,24663361,955148,23708213,2011.csv,2011,0.03872740621199195,0.961272593788008
1931,Liar Game: The Final Stage,24658706,0,24658706,2010.csv,2010,0.0,1.0
1932,The Death of Stalin,24646055,8047856,16598199,2017.csv,2017,0.32653728963925466,0.6734627103607453
1933,The Snow Queen 3: Fire and Ice,24644317,0,24644317,2016.csv,2016,0.0,1.0
1934,Sparkle,24637800,24397469,240331,2012.csv,2012,0.9902454358749564,0.009754564125043632
1935,The Players,24629152,10854,24618298,2012.csv,2012,0.00044069726801799754,0.999559302731982
1936,Capture the Flag,24604331,6690,24597641,2015.csv,2015,0.00027190334904858825,0.9997280966509514
1937,Babysitting 2,24563629,0,24563629,2015.csv,2015,0.0,1.0
1938,Liar Game: Reborn,24549726,0,24549726,2012.csv,2012,0.0,1.0
1939,God's Not Dead 2,24487848,20774575,3713273,2016.csv,2016,0.8483626245964937,0.15163737540350627
1940,The Tale of The Princess Kaguya,24434485,703232,23731253,2013.csv,2013,0.028780307831329368,0.9712196921686707
1941,The 8-Year Engagement,24425963,0,24425963,2017.csv,2017,0.0,1.0
1942,Stan & Ollie,24420923,5470235,18950688,2018.csv,2018,0.22399788083357866,0.7760021191664214
1943,Skyfire,24374856,1105,24373751,2019.csv,2019,4.533360115030013e-05,0.9999546663988497
1944,The Witch: Part 1 - The Subversion,24340302,0,24340302,2018.csv,2018,0.0,1.0
1945,The Great Beauty,24271739,2852400,21419339,2013.csv,2013,0.11751939158541545,0.8824806084145845
1946,Trance,24261569,2328743,21932826,2013.csv,2013,0.09598484747626998,0.90401515252373
1947,The Accidental Detective 2: In Action,24243825,179045,24064780,2018.csv,2018,0.0073851795250955655,0.9926148204749045
1948,Camping 3,24224579,0,24224579,2016.csv,2016,0.0,1.0
1949,Jolly LLB 2,24214186,1654254,22559932,2017.csv,2017,0.06831755566757437,0.9316824443324256
1950,The Gunman,24177137,10664749,13512388,2015.csv,2015,0.44110884593159233,0.5588911540684077
1951,The Railway Man,24174885,4438438,19736447,2013.csv,2013,0.18359706778336277,0.8164029322166372
1952,The Way Back,24172201,2701859,21470342,2010.csv,2010,0.11177546471668012,0.8882245352833199
1953,The Founder,24121245,12786053,11335192,2016.csv,2016,0.5300743390318369,0.46992566096816313
1954,Out of Inferno,24109886,0,24109886,2013.csv,2013,0.0,1.0
1955,Start-Up,24106579,0,24106579,2019.csv,2019,0.0,1.0
1956,Bad Santa 2,24079268,17782178,6297090,2016.csv,2016,0.7384849904905747,0.2615150095094253
1957,Kung Fu Jungle,24070765,129784,23940981,2014.csv,2014,0.0053917688116684286,0.9946082311883315
1958,I Can Speak,24024444,63239,23961205,2017.csv,2017,0.0026322773588433514,0.9973677226411567
1959,Nasha Russia. Yaytsa sudby,24022125,0,24022125,2010.csv,2010,0.0,1.0
1960,Bring Happiness Home,23980000,0,23980000,2013.csv,2013,0.0,1.0
1961,I Want You,23961214,0,23961214,2012.csv,2012,0.0,1.0
1962,Türkisch für Anfänger,23952712,0,23952712,2012.csv,2012,0.0,1.0
1963,Killing for the Prosecution,23929620,0,23929620,2018.csv,2018,0.0,1.0
1964,Spirits' Homecoming,23857217,125616,23731601,2016.csv,2016,0.0052653249538703525,0.9947346750461297
1965,Silence,23834809,7100177,16734632,2016.csv,2016,0.2978910802264033,0.7021089197735967
1966,Wanderlust,23812816,17450535,6362281,2012.csv,2012,0.7328211413551425,0.26717885864485746
1967,"Little Brother, Big Trouble: A Christmas Adventure",23785681,0,23785681,2012.csv,2012,0.0,1.0
1968,Interstellar 2020 Re-release,23771122,0,23771122,2020.csv,2020,0.0,1.0
1969,The Dressmaker,23762417,2022115,21740302,2015.csv,2015,0.08509719360618913,0.9149028063938108
1970,The Peanut Butter Falcon,23743627,20457151,3286476,2019.csv,2019,0.8615849212927746,0.1384150787072253
1971,Pokémon the Movie: The Power of Us,23740788,789170,22951618,2018.csv,2018,0.0332411038757433,0.9667588961242567
1972,Amy,23706049,8413144,15292905,2015.csv,2015,0.3548943984718837,0.6451056015281164
1973,Da Xiao Jiang Hu,23705022,0,23705022,2010.csv,2010,0.0,1.0
1974,To the Arctic 3D,23695388,14560838,9134550,2012.csv,2012,0.6145009315736886,0.3854990684263115
1975,Ever Since We Love,23620000,0,23620000,2015.csv,2015,0.0,1.0
1976,Nous finirons ensemble,23613535,0,23613535,2019.csv,2019,0.0,1.0
1977,Kevin Hart: What Now?,23591043,23591043,0,2016.csv,2016,1.0,0.0
1978,No manches Frida,23540937,11528613,12012324,2016.csv,2016,0.48972617360133114,0.5102738263986688
1979,Youth,23469540,2703296,20766244,2015.csv,2015,0.11518316933352762,0.8848168306664723
1980,Wish Upon,23468586,14301505,9167081,2017.csv,2017,0.6093892917110558,0.39061070828894423
1981,Five Minarets in New York,23423390,0,23423390,2010.csv,2010,0.0,1.0
1982,Ossan's Love: Love or Dead,23422744,0,23422744,2019.csv,2019,0.0,1.0
1983,Only Cloud Knows,23410836,0,23410836,2019.csv,2019,0.0,1.0
1984,In His Chart,23384864,0,23384864,2011.csv,2011,0.0,1.0
1985,Detroit,23355100,16790139,6564961,2017.csv,2017,0.7189067484189748,0.2810932515810251
1986,Middle School: The Worst Years of My Life,23316139,20007149,3308990,2016.csv,2016,0.8580815631610362,0.14191843683896377
1987,Warrior,23308615,13657115,9651500,2011.csv,2011,0.5859256330760108,0.41407436692398925
1988,Triple 9,23177948,12639297,10538651,2016.csv,2016,0.5453156163781194,0.4546843836218806
1989,Hoodwinked Too! Hood vs. Evil,23167844,10143779,13024065,2011.csv,2011,0.4378387130023838,0.5621612869976161
1990,Pinocchio,23160765,1831718,21329047,2019.csv,2019,0.07908711132814482,0.9209128886718552
1991,Rock Dog,23157646,9420546,13737100,2016.csv,2016,0.40680067395451164,0.5931993260454884
1992,The Guernsey Literary and Potato Peel Pie Society,23148937,0,23148937,2018.csv,2018,0.0,1.0
1993,The Crimes That Bind,23144130,0,23144130,2018.csv,2018,0.0,1.0
1994,New Happy Dad and Son 3: Adventure in Russia,23130469,0,23130469,2018.csv,2018,0.0,1.0
1995,Dark Waters,23108017,11136084,11971933,2019.csv,2019,0.48191430705629135,0.5180856929437087
1996,The Farewell,23076657,17695781,5380876,2019.csv,2019,0.7668260181706562,0.23317398182934382
1997,The Choice,23064015,18730891,4333124,2016.csv,2016,0.8121262061267304,0.1878737938732697
1998,Under the Hawthorn Tree,23004431,0,23004431,2010.csv,2010,0.0,1.0
1999,Padmaavat,22991060,11846060,11145000,2018.csv,2018,0.5152463609768319,0.48475363902316815
2000,Hotaru the Movie: It's Only a Little Light in My Life,22975341,0,22975341,2012.csv,2012,0.0,1.0
2001,Penny Pincher!,22955486,0,22955486,2016.csv,2016,0.0,1.0
2002,Young Adult,22939027,16311571,6627456,2011.csv,2011,0.7110838223434673,0.28891617765653266
2003,Andalucia: Revenge of the Goddess,22929221,0,22929221,2011.csv,2011,0.0,1.0
2004,A Separation,22926076,7099055,15827021,2011.csv,2011,0.30964980662194436,0.6903501933780556
2005,Hot Road,22916313,0,22916313,2014.csv,2014,0.0,1.0
2006,Baggage Claim,22871096,21569509,1301587,2013.csv,2013,0.9430903092707057,0.056909690729294304
2007,Qualunquemente,22862029,0,22862029,2011.csv,2011,0.0,1.0
2008,Minuscule: Valley of the Lost Ants,22850838,0,22850838,2013.csv,2013,0.0,1.0
2009,Won't You Be My Neighbor?,22844741,22835787,8954,2018.csv,2018,0.9996080498351897,0.0003919501648103605
2010,Kon-Tiki,22842887,1517410,21325477,2012.csv,2012,0.06642811830220935,0.9335718816977907
2011,Hunt for the Wilderpeople,22835917,5205468,17630449,2016.csv,2016,0.22795090733601808,0.7720490926639819
2012,Sweet Sixteen,22819702,34327,22785375,2016.csv,2016,0.001504270301163442,0.9984957296988366
2013,Captain Fantastic,22787526,5879835,16907691,2016.csv,2016,0.2580286688427695,0.7419713311572305
2014,The Knight of Shadows: Between Yin and Yang,22774256,0,22774256,2019.csv,2019,0.0,1.0
2015,Extraordinary Mission,22757764,54174,22703590,2017.csv,2017,0.0023804623336457836,0.9976195376663543
2016,Black and Blue,22741061,22055313,685748,2019.csv,2019,0.9698453823240701,0.030154617675929897
2017,Fading Gigolo,22706304,3769873,18936431,2014.csv,2014,0.1660275930420028,0.8339724069579972
2018,Live by Night,22678555,10378555,12300000,2016.csv,2016,0.45763740238300016,0.5423625976169999
2019,Fall in Love Like a Star,22640355,0,22640355,2012.csv,2012,0.0,1.0
2020,Recep Ivedik 3,22588876,0,22588876,2010.csv,2010,0.0,1.0
2021,Friends: Naki on the Monster Island,22537428,0,22537428,2011.csv,2011,0.0,1.0
2022,Hyupsang Jonggyulja,22481135,0,22481135,2013.csv,2013,0.0,1.0
2023,Julieta,22468044,1490948,20977096,2016.csv,2016,0.06635860246668557,0.9336413975333144
2024,Europe Raiders,22435156,0,22435156,2018.csv,2018,0.0,1.0
2025,Villain,22414467,0,22414467,2010.csv,2010,0.0,1.0
2026,Late Night,22386555,15499454,6887101,2019.csv,2019,0.6923554785450463,0.30764452145495363
2027,2 States,22386518,2238174,20148344,2014.csv,2014,0.09997865679691678,0.9000213432030832
2028,Mojin: The Worm Valley,22381583,101516,22280067,2018.csv,2018,0.004535693476194244,0.9954643065238058
2029,Rupan sansei,22361629,0,22361629,2014.csv,2014,0.0,1.0
2030,Solace,22354572,0,22354572,2015.csv,2015,0.0,1.0
2031,Kamen Rider OOO Wonderful: The Shogun and the 21 Core Medals,22313925,0,22313925,2011.csv,2011,0.0,1.0
2032,Twenty,22271862,136125,22135737,2015.csv,2015,0.006111972137758397,0.9938880278622416
2033,Fei chang xing yun,22259179,64432,22194747,2013.csv,2013,0.0028946260776284696,0.9971053739223715
2034,Fifty Shades of Black,22227514,11686940,10540574,2015.csv,2015,0.5257870943192298,0.47421290568077024
2035,Gooische Vrouwen,22194574,0,22194574,2011.csv,2011,0.0,1.0
2036,Upside Down,22187813,105095,22082718,2012.csv,2012,0.004736609236791386,0.9952633907632086
2037,Mr. Turner,22179785,3958500,18221285,2014.csv,2014,0.17847332604892246,0.8215266739510775
2038,Unbowed,22132903,0,22132903,2012.csv,2012,0.0,1.0
2039,Sabotage,22126842,10508518,11618324,2014.csv,2014,0.4749217262906293,0.5250782737093708
2040,The Glass Castle,22088533,17273059,4815474,2017.csv,2017,0.7819921313923383,0.21800786860766172
2041,Stree,22075730,0,22075730,2018.csv,2018,0.0,1.0
2042,Gretel & Hansel,22051055,15347654,6703401,2020.csv,2020,0.6960054292186927,0.3039945707813073
2043,A Thousand Words,22044277,18450127,3594150,2010.csv,2010,0.8369576829396582,0.16304231706034178
2044,"Me, Them and Lara",22039646,0,22039646,2010.csv,2010,0.0,1.0
2045,Big Brother,22029250,85624,21943626,2018.csv,2018,0.0038868322798097984,0.9961131677201902
2046,A Rainy Day in New York,22002504,0,22002504,2019.csv,2019,0.0,1.0
2047,Bullet to the Head,21947209,9489829,12457380,2013.csv,2013,0.4323934309824999,0.5676065690175002
2048,Strawberry Night,21940182,0,21940182,2013.csv,2013,0.0,1.0
2049,Leap! 2017 Re-release,21929861,21858070,71791,2017.csv,2017,0.9967263358395204,0.003273664160479631
2050,Moss,21925534,0,21925534,2010.csv,2010,0.0,1.0
2051,My Mom Is a Character,21909567,0,21909567,2013.csv,2013,0.0,1.0
2052,The Immature,21858834,0,21858834,2011.csv,2011,0.0,1.0
2053,Pleasant Goat and Big Big Wolf 3,21847806,0,21847806,2011.csv,2011,0.0,1.0
2054,Daddy or Mommy,21835307,0,21835307,2015.csv,2015,0.0,1.0
2055,Black or White,21833967,21571189,262778,2015.csv,2015,0.9879647157110754,0.012035284288924683
2056,Master Z: The Ip Man Legacy,21832649,209454,21623195,2018.csv,2018,0.009593613674639298,0.9904063863253607
2057,Pokémon the Movie: Hoopa and the Clash of Ages,21815482,0,21815482,2015.csv,2015,0.0,1.0
2058,Welcome Back,21775694,1388365,20387329,2015.csv,2015,0.0637575546386719,0.9362424453613281
2059,Diana,21766271,335359,21430912,2013.csv,2013,0.015407278536594533,0.9845927214634055
2060,Legends of Oz: Dorothy's Return,21755418,8462347,13293071,2014.csv,2014,0.38897652989246173,0.6110234701075383
2061,Proud Mary,21753365,20877013,876352,2018.csv,2018,0.9597141867476595,0.0402858132523405
2062,It Follows,21729511,14674076,7055435,2015.csv,2015,0.6753063149925463,0.3246936850074537
2063,Confession of Murder,21701525,0,21701525,2012.csv,2012,0.0,1.0
2064,22 Bullets,21695883,0,21695883,2010.csv,2010,0.0,1.0
2065,The Target,21658812,0,21658812,2014.csv,2014,0.0,1.0
2066,Poupelle of Chimney Town,21651776,0,21651776,2020.csv,2020,0.0,1.0
2067,Inazuma Eleven GO the Movie: The Ultimate Bonds Gryphon,21645379,0,21645379,2010.csv,2010,0.0,1.0
2068,StreetDance 2 2012 Re-release,21638853,0,21638853,2012.csv,2012,0.0,1.0
2069,The Marksman,21629006,15215143,6413863,2021.csv,2021,0.7034601127763338,0.2965398872236662
2070,Kureyon Shinchan: Bakusui! Yumemî wârudo daitotsugeki!,21611358,0,21611358,2016.csv,2016,0.0,1.0
2071,Love Studio,21590285,0,21590285,2016.csv,2016,0.0,1.0
2072,Just Wright,21584424,21540363,44061,2010.csv,2010,0.9979586668608807,0.0020413331391192094
2073,Épouse-moi mon pote,21571464,0,21571464,2017.csv,2017,0.0,1.0
2074,Quick,21561934,0,21561934,2011.csv,2011,0.0,1.0
2075,2012 2012 Re-release,21538353,0,21538353,2012.csv,2012,0.0,1.0
2076,My Soul to Take,21500813,14744435,6756378,2010.csv,2010,0.6857617430559486,0.3142382569440514
2077,K-On! The Movie,21434003,0,21434003,2011.csv,2011,0.0,1.0
2078,Our Family Wedding,21409028,20255281,1153747,2010.csv,2010,0.9461093235993713,0.053890676400628744
2079,Love & Friendship,21401949,14016568,7385381,2016.csv,2016,0.6549201663829776,0.34507983361702244
2080,Crazy Romance,21386368,0,21386368,2019.csv,2019,0.0,1.0
2081,Shaft,21360215,21360215,0,2019.csv,2019,1.0,0.0
2082,Unplanned,21349753,19005109,2344644,2019.csv,2019,0.890179338374547,0.109820661625453
2083,Bears,21316745,17780194,3536551,2014.csv,2014,0.8340951679067324,0.16590483209326753
2084,Hotel Mumbai,21314816,9651611,11663205,2019.csv,2019,0.4528123067072219,0.5471876932927782
2085,Love Live! The School Idol Movie,21292009,115840,21176169,2015.csv,2015,0.005440538748598124,0.9945594612514018
2086,Integrity,21290004,0,21290004,2019.csv,2019,0.0,1.0
2087,Chaos Walking,21283521,12683521,8600000,2021.csv,2021,0.595931519037663,0.404068480962337
2088,Stigmatized Properties,21276720,0,21276720,2020.csv,2020,0.0,1.0
2089,I'm So Excited!,21245677,1368119,19877558,2013.csv,2013,0.06439517083875464,0.9356048291612453
2090,Nosso Lar,21218935,0,21218935,2010.csv,2010,0.0,1.0
2091,The Prison,21205329,207481,20997848,2017.csv,2017,0.009784380143312088,0.9902156198566879
2092,The Apology King,21188003,0,21188003,2013.csv,2013,0.0,1.0
2093,Red Dog,21185162,0,21185162,2011.csv,2011,0.0,1.0
2094,The Prodigy,21150265,14856291,6293974,2018.csv,2018,0.7024163054221779,0.2975836945778221
2095,Wish Dragon,21120000,0,21120000,2021.csv,2021,0.0,1.0
2096,Beasts of the Southern Wild,21107746,12795746,8312000,2012.csv,2012,0.6062109142302546,0.39378908576974536
2097,Minha Vida em Marte,21105636,0,21105636,2018.csv,2018,0.0,1.0
2098,The Secret Mission,21083522,0,21083522,2019.csv,2019,0.0,1.0
2099,Gonjiam: Haunted Asylum,21041950,115252,20926698,2018.csv,2018,0.005477249019221127,0.9945227509807789
2100,Yves Saint Laurent,21026290,723593,20302697,2014.csv,2014,0.034413726815334514,0.9655862731846655
2101,My Hero Academia: Two Heroes,21022724,5754556,15268168,2018.csv,2018,0.27373027396449673,0.7262697260355033
2102,The Infiltrator,21011110,15436808,5574302,2016.csv,2016,0.7346974053250875,0.26530259467491246
2103,Before Midnight,20994648,8114627,12880021,2013.csv,2013,0.38650931418330997,0.6134906858166901
2104,71: Into the Fire,20967660,176638,20791022,2010.csv,2010,0.008424306765752593,0.9915756932342474
2105,The Spy Next Door 2010 Re-release,20929457,0,20929457,2010.csv,2010,0.0,1.0
2106,CM101MMXI Fundamentals,20922871,0,20922871,2013.csv,2013,0.0,1.0
2107,El nino,20918976,1237,20917739,2014.csv,2014,5.9132913580473535e-05,0.9999408670864195
2108,Pee Mak,20896252,0,20896252,2013.csv,2013,0.0,1.0
2109,On Your Wedding Day,20895905,0,20895905,2018.csv,2018,0.0,1.0
2110,Vicky and the Treasure of the Gods,20796153,0,20796153,2011.csv,2011,0.0,1.0
2111,Prince Ivan and the Grey Wolf 2,20791052,0,20791052,2013.csv,2013,0.0,1.0
2112,SuperFly,20780685,20545116,235569,2018.csv,2018,0.9886640406704591,0.01133595932954087
2113,Lady of the Dynasty,20778906,0,20778906,2015.csv,2015,0.0,1.0
2114,We Were There: True Love 2012 Re-release,20762157,0,20762157,2012.csv,2012,0.0,1.0
2115,The Photograph,20690779,20578185,112594,2020.csv,2020,0.9945582522533347,0.005441747746665314
2116,Keanu,20651333,20591853,59480,2016.csv,2016,0.9971197985137328,0.0028802014862672545
2117,The Front Line,20629645,11018,20618627,2011.csv,2011,0.0005340857780150847,0.9994659142219849
2118,If Beale Street Could Talk,20596567,14915773,5680794,2018.csv,2018,0.7241873366566379,0.275812663343362
2119,The Best Offer,20596350,100035,20496315,2013.csv,2013,0.004856928533453743,0.9951430714665462
2120,Polisse,20590872,211440,20379432,2011.csv,2011,0.010268627768653994,0.989731372231346
2121,Hollywoo,20587850,0,20587850,2011.csv,2011,0.0,1.0
2122,The Man with the Iron Fists,20546518,15634090,4912428,2012.csv,2012,0.7609118975779741,0.23908810242202597
2123,Race 2,20531909,1579940,18951969,2013.csv,2013,0.07695046768422752,0.9230495323157725
2124,Country Strong,20529194,20218921,310273,2010.csv,2010,0.9848862551544888,0.015113744845511227
2125,Friend 2,20502243,0,20502243,2013.csv,2013,0.0,1.0
2126,Cock and Bull,20490872,82778,20408094,2016.csv,2016,0.004039749992094041,0.995960250007906
2127,One Hundred Thousand Bad Jokes 2,20460352,0,20460352,2017.csv,2017,0.0,1.0
2128,Yarn,20444185,0,20444185,2020.csv,2020,0.0,1.0
2129,They Shall Not Grow Old,20433798,17956913,2476885,2018.csv,2018,0.8787848935376575,0.12121510646234245
2130,The Sapphires,20423628,2450867,17972761,2012.csv,2012,0.12000154918607017,0.8799984508139298
2131,That Demon Within,20415934,172343,20243591,2014.csv,2014,0.00844159272850314,0.9915584072714969
2132,The Mole Song: Undercover Agent Reiji,20392349,0,20392349,2014.csv,2014,0.0,1.0
2133,The Clan,20381995,201227,20180768,2015.csv,2015,0.009872782325773311,0.9901272176742267
2134,Burn the Stage: The Movie,20347513,4201819,16145694,2018.csv,2018,0.20650282911724888,0.7934971708827512
2135,Babysitting,20334564,0,20334564,2014.csv,2014,0.0,1.0
2136,Brahms: The Boy II,20311536,12611536,7700000,2020.csv,2020,0.6209050856616654,0.37909491433833464
2137,Cold War 2018 Re-release,20296042,4580048,15715994,2018.csv,2018,0.22566212663533117,0.7743378733646689
2138,Labor Day,20275812,13371528,6904284,2014.csv,2014,0.6594817509651402,0.3405182490348599
2139,Sadako 3D,20260672,0,20260672,2012.csv,2012,0.0,1.0
2140,Scabbard Samurai,20251745,0,20251745,2011.csv,2011,0.0,1.0
2141,Singh Is Bliing,20224851,919095,19305756,2015.csv,2015,0.045443845297055585,0.9545561547029444
2142,Beck,20219060,0,20219060,2010.csv,2010,0.0,1.0
2143,Memoirs of a Murderer,20211045,0,20211045,2017.csv,2017,0.0,1.0
2144,"Les trois frères, le retour",20193106,0,20193106,2014.csv,2014,0.0,1.0
2145,How Not to Rescue a Princess,20157447,0,20157447,2010.csv,2010,0.0,1.0
2146,Hirugao,20122011,0,20122011,2017.csv,2017,0.0,1.0
2147,This Crazy Heart,20118769,0,20118769,2017.csv,2017,0.0,1.0
2148,Violet Evergarden: The Movie,20086270,0,20086270,2020.csv,2020,0.0,1.0
2149,This Is Tomas,20084169,0,20084169,2019.csv,2019,0.0,1.0
2150,Botanical Books,20071961,0,20071961,2016.csv,2016,0.0,1.0
2151,Shui zhai wo shang pu de xiong di,20069212,0,20069212,2016.csv,2016,0.0,1.0
2152,The Bling Ring,20045576,5845732,14199844,2013.csv,2013,0.29162205166865746,0.7083779483313425
2153,The Company You Keep,20014680,5133027,14881653,2012.csv,2012,0.25646310608013717,0.7435368939198628
2154,Mr. Highheels,20003919,0,20003919,2016.csv,2016,0.0,1.0
2155,Ansatsu kyôshitsu,20000000,0,20000000,2015.csv,2015,0.0,1.0
2156,The Wife,19978189,9601092,10377097,2018.csv,2018,0.48057869509593687,0.5194213049040631
2157,Kaiji 2: The Ultimate Gambler,19971259,0,19971259,2011.csv,2011,0.0,1.0
2158,About Her Brother,19969473,0,19969473,2010.csv,2010,0.0,1.0
2159,The Wings of the Kirin,19835053,0,19835053,2012.csv,2012,0.0,1.0
2160,The Rooftop,19833152,85755,19747397,2013.csv,2013,0.0043238210446831645,0.9956761789553168
2161,Partners: The Movie III,19814411,0,19814411,2014.csv,2014,0.0,1.0
2162,Go Fighting: Royal Treasure,19800195,0,19800195,2016.csv,2016,0.0,1.0
2163,Justin and the Knights of Valour,19799759,0,19799759,2013.csv,2013,0.0,1.0
2164,Trick the Movie: Psychic Battle Royale,19795115,0,19795115,2010.csv,2010,0.0,1.0
2165,Ice 2,19788995,0,19788995,2020.csv,2020,0.0,1.0
2166,Flu,19775853,0,19775853,2013.csv,2013,0.0,1.0
2167,Hello Ghost,19774455,0,19774455,2010.csv,2010,0.0,1.0
2168,Gone,19767535,11682205,8085330,2012.csv,2012,0.590979350738471,0.4090206492615291
2169,It Comes at Night,19735344,13985117,5750227,2017.csv,2017,0.7086330494163162,0.2913669505836838
2170,Another Year,19722766,3205706,16517060,2010.csv,2010,0.1625383579564854,0.8374616420435146
2171,Xi Yang Yang Yu Hui Tai Lang Zhi Xi Qi Yang Yang Guo She Nian,19713518,0,19713518,2013.csv,2013,0.0,1.0
2172,Be With You,19711640,0,19711640,2018.csv,2018,0.0,1.0
2173,O chyom eshchyo govoryat muzhchiny,19705392,0,19705392,2011.csv,2011,0.0,1.0
2174,Brothers,19694450,613775,19080675,2015.csv,2015,0.031164871321615988,0.9688351286783841
2175,Duck Duck Goose,19676514,0,19676514,2018.csv,2018,0.0,1.0
2176,Blackhat,19652057,8005980,11646077,2015.csv,2015,0.4073863616414302,0.5926136383585698
2177,Youth in Revolt,19651093,15281286,4369807,2010.csv,2010,0.7776303333356572,0.2223696666643428
2178,Warkop DKI Reborn: Jangkrik Boss Part 1,19608000,0,19608000,2016.csv,2016,0.0,1.0
2179,Until the Break of Dawn,19585809,0,19585809,2012.csv,2012,0.0,1.0
2180,Hot Summer Days,19573451,0,19573451,2010.csv,2010,0.0,1.0
2181,The Guard,19561904,5360274,14201630,2011.csv,2011,0.27401596490811936,0.7259840350918806
2182,Soul Snatcher,19548161,0,19548161,2020.csv,2020,0.0,1.0
2183,Puella Magi Madoka Magica the Movie Part III: The Rebellion Story,19544634,375627,19169007,2013.csv,2013,0.019218932418995412,0.9807810675810046
2184,Nisos 2: To kynigi tou hamenou thisavrou,19508880,0,19508880,2011.csv,2011,0.0,1.0
2185,Margin Call,19504039,5354039,14150000,2011.csv,2011,0.2745092439571106,0.7254907560428894
2186,Love for Beginners,19499312,0,19499312,2012.csv,2012,0.0,1.0
2187,In This Corner of the World,19496308,172147,19324161,2016.csv,2016,0.008829723042947414,0.9911702769570526
2188,Blue Is the Warmest Colour,19465835,2199787,17266048,2013.csv,2013,0.11300758482746823,0.8869924151725318
2189,Crayon Shin-chan Movie 23: Ora No Hikkoshi Monogatari - Saboten Daisuugeki 2015 Re-release,19461448,0,19461448,2015.csv,2015,0.0,1.0
2190,Attraction,19454845,0,19454845,2017.csv,2017,0.0,1.0
2191,Buried,19439764,1044143,18395621,2010.csv,2010,0.05371171172654154,0.9462882882734585
2192,The Turning,19427123,15472775,3954348,2020.csv,2020,0.7964522075656802,0.20354779243431978
2193,The Witness,19424375,0,19424375,2018.csv,2018,0.0,1.0
2194,Rolling to You,19405540,0,19405540,2018.csv,2018,0.0,1.0
2195,The Edge of Seventeen,19370020,14431633,4938387,2016.csv,2016,0.7450499792979047,0.2549500207020953
2196,The Specials,19363826,0,19363826,2019.csv,2019,0.0,1.0
2197,Sekigahara,19356047,0,19356047,2017.csv,2017,0.0,1.0
2198,EX-Files,19310000,0,19310000,2014.csv,2014,0.0,1.0
2199,Woman in Love,19302752,0,19302752,2011.csv,2011,0.0,1.0
2200,The Lost City of Z,19263938,8580410,10683528,2017.csv,2017,0.44541308220572556,0.5545869177942745
2201,The Servant,19259164,0,19259164,2010.csv,2010,0.0,1.0
2202,Space Brothers,19248130,0,19248130,2012.csv,2012,0.0,1.0
2203,The Classified File,19243890,0,19243890,2015.csv,2015,0.0,1.0
2204,Gekijouban SPEC: Kurôzu - Kou no hen,19243799,0,19243799,2013.csv,2013,0.0,1.0
2205,Eyjafjallajökull,19226272,0,19226272,2013.csv,2013,0.0,1.0
2206,Santa & Cie,19222086,0,19222086,2017.csv,2017,0.0,1.0
2207,Foxcatcher,19206513,12096300,7110213,2014.csv,2014,0.6298019843581185,0.3701980156418815
2208,Everybody Knows,19176163,2660165,16515998,2018.csv,2018,0.13872248582784782,0.8612775141721521
2209,Till Luck Do Us Part 2,19164182,0,19164182,2013.csv,2013,0.0,1.0
2210,My Annoying Brother,19162324,51996,19110328,2016.csv,2016,0.0027134495794977685,0.9972865504205022
2211,Heroine Disqualified,19161661,0,19161661,2015.csv,2015,0.0,1.0
2212,Gekijouban Fate/Stay Night: Heaven's Feel - III. Spring Song,19134514,200000,18934514,2020.csv,2020,0.010452316688053848,0.9895476833119462
2213,Oolong Courtyard: KungFu School,19129015,37727,19091288,2018.csv,2018,0.0019722395533695804,0.9980277604466304
2214,Shame,19123767,3909002,15214765,2011.csv,2011,0.20440543957683652,0.7955945604231635
2215,Princess Toyotomi,19122151,0,19122151,2011.csv,2011,0.0,1.0
2216,Death Note: Light Up the New World,19117022,0,19117022,2016.csv,2016,0.0,1.0
2217,Norwegian Wood,19115721,13000,19102721,2010.csv,2010,0.000680068515333531,0.9993199314846665
2218,Les Misérables,19090476,330181,18760295,2013.csv,2013,0.017295587600853955,0.9827044123991461
2219,Aladdin 2,19024452,0,19024452,2018.csv,2018,0.0,1.0
2220,Always Miss You,19015465,91884,18923581,2019.csv,2019,0.0048320669518205316,0.9951679330481795
2221,Memoir of a Murderer,19015346,91335,18924011,2017.csv,2017,0.004803225773541013,0.995196774226459
2222,"Kamen Rider Fourze: Everyone, Space is Here!",18982811,0,18982811,2011.csv,2011,0.0,1.0
2223,Super Hero Taisen: Kamen Rider vs. Super Sentai,18973831,0,18973831,2012.csv,2012,0.0,1.0
2224,Jo Nesbø's Headhunters,18962444,1200010,17762434,2011.csv,2011,0.0632835092354129,0.9367164907645871
2225,Temporary Family,18936753,0,18936753,2014.csv,2014,0.0,1.0
2226,Unfair the End,18913492,0,18913492,2015.csv,2015,0.0,1.0
2227,An Officer and a Spy,18878648,0,18878648,2019.csv,2019,0.0,1.0
2228,Head Over Heels,18876082,0,18876082,2010.csv,2010,0.0,1.0
2229,Spellbound,18875078,0,18875078,2011.csv,2011,0.0,1.0
2230,Father and Son,18764047,0,18764047,2017.csv,2017,0.0,1.0
2231,Crayon Shin-chan: Honeymoon Hurricane - The Lost Hiroshi,18738951,0,18738951,2019.csv,2019,0.0,1.0
2232,Love in Vegas,18717556,0,18717556,2014.csv,2014,0.0,1.0
2233,Pina,18705853,3524826,15181027,2011.csv,2011,0.18843439002754914,0.8115656099724509
2234,13 Assassins,18689058,802778,17886280,2010.csv,2010,0.042954438902164035,0.957045561097836
2235,Glee: The 3D Concert Movie,18663238,11862398,6800840,2011.csv,2011,0.6356023536751768,0.3643976463248232
2236,The Drop,18658381,10724389,7933992,2014.csv,2014,0.5747759679684963,0.4252240320315037
2237,Greta,18653107,10532219,8120888,2019.csv,2019,0.56463617562479,0.43536382437521
2238,Peppa Celebrates Chinese New Year,18653040,131225,18521815,2019.csv,2019,0.0070350462980833155,0.9929649537019167
2239,Admission,18637201,18007317,629884,2013.csv,2013,0.9662028649044457,0.03379713509555431
2240,Sector 7,18618028,0,18618028,2011.csv,2011,0.0,1.0
2241,Il principe abusivo,18614277,0,18614277,2013.csv,2013,0.0,1.0
2242,Detective K: Secret of the Living Dead,18603476,104013,18499463,2018.csv,2018,0.005591051908793819,0.9944089480912062
2243,Battle of the Sexes,18598607,12638526,5960081,2017.csv,2017,0.6795415377076358,0.32045846229236413
2244,Girls und Panzer der Film,18596830,0,18596830,2015.csv,2015,0.0,1.0
2245,Suddenly Seventeen,18583270,0,18583270,2016.csv,2016,0.0,1.0
2246,The Visitors: Bastille Day,18552314,0,18552314,2016.csv,2016,0.0,1.0
2247,One Hundred Thousand Bad Jokes,18550000,0,18550000,2014.csv,2014,0.0,1.0
2248,Peak: The Rescuers,18536792,0,18536792,2011.csv,2011,0.0,1.0
2249,Black Christmas,18529730,10429730,8100000,2019.csv,2019,0.5628646504833044,0.4371353495166956
2250,Kaguya-sama: Love Is War,18516460,0,18516460,2019.csv,2019,0.0,1.0
2251,Men Vs Women,18493043,0,18493043,2010.csv,2010,0.0,1.0
2252,Airpocalypse,18491089,105678,18385411,2018.csv,2018,0.005715077137966293,0.9942849228620337
2253,Listy do M. 3,18490245,0,18490245,2017.csv,2017,0.0,1.0
2254,Motherless Brooklyn,18477736,9277736,9200000,2019.csv,2019,0.5021035044553077,0.4978964955446923
2255,How the Grinch Stole Christmas 2020 Re-release,18455781,420180,18035601,2020.csv,2020,0.022766850126797668,0.9772331498732023
2256,Palm Trees in the Snow,18428235,0,18428235,2015.csv,2015,0.0,1.0
2257,Zero,18412196,1035388,17376808,2018.csv,2018,0.05623381371782051,0.9437661862821795
2258,Repo Men,18409891,13794835,4615056,2010.csv,2010,0.7493164951384014,0.25068350486159857
2259,Yo-Kai Watch 4,18385844,0,18385844,2017.csv,2017,0.0,1.0
2260,The Wasted Times,18345372,386540,17958832,2016.csv,2016,0.021070164180917127,0.9789298358190829
2261,Commerce (pas très) équitable,18342838,0,18342838,2010.csv,2010,0.0,1.0
2262,Manhunt,18339343,0,18339343,2017.csv,2017,0.0,1.0
2263,Big Baker's Unlucky Bear,18330043,0,18330043,2017.csv,2017,0.0,1.0
2264,Gooische Vrouwen II,18326296,0,18326296,2014.csv,2014,0.0,1.0
2265,Fabricated City,18307490,104874,18202616,2017.csv,2017,0.005728475066762292,0.9942715249332377
2266,The Sheriff in Town,18303514,0,18303514,2017.csv,2017,0.0,1.0
2267,Asura,18300843,175702,18125141,2016.csv,2016,0.009600759921277943,0.990399240078722
2268,Chappaquiddick,18263470,17395520,867950,2018.csv,2018,0.9524761723812616,0.04752382761873839
2269,New Kids Turbo,18261046,0,18261046,2010.csv,2010,0.0,1.0
2270,The Case for Christ,18175663,14682684,3492979,2017.csv,2017,0.8078210957146378,0.19217890428536225
2271,Sorry to Bother You,18170707,17493096,677611,2018.csv,2018,0.9627086056695537,0.03729139433044625
2272,Hell Fest,18159691,11107431,7052260,2018.csv,2018,0.6116530837446518,0.3883469162553482
2273,The Lighthouse,18123239,10867104,7256135,2019.csv,2019,0.5996226171271041,0.400377382872896
2274,The Con Artists,18106167,0,18106167,2014.csv,2014,0.0,1.0
2275,Blinded by the Light,18096691,11901145,6195546,2019.csv,2019,0.6576420517983095,0.3423579482016906
2276,Takizawa Enbujo Zero,18091395,0,18091395,2020.csv,2020,0.0,1.0
2277,Dead Man Down,18074539,10895295,7179244,2013.csv,2013,0.6027979468798623,0.3972020531201377
2278,"Belle and Sebastian, Friends for Life 2018 Re-release",18033184,0,18033184,2018.csv,2018,0.0,1.0
2279,From Me to You,18027475,0,18027475,2010.csv,2010,0.0,1.0
2280,Mr. Pride vs. Miss Prejudice,18019651,0,18019651,2017.csv,2017,0.0,1.0
2281,Harlock: Space Pirate,18010317,0,18010317,2013.csv,2013,0.0,1.0
2282,Ataru,17991975,0,17991975,2013.csv,2013,0.0,1.0
2283,Kalank,17987034,2729336,15257698,2019.csv,2019,0.15173908049542797,0.848260919504572
2284,Dope,17986781,17506470,480311,2015.csv,2015,0.9732964447612944,0.02670355523870558
2285,"Isoroku Yamamoto, the Commander-in-Chief of the Combined Fleet",17969314,0,17969314,2011.csv,2011,0.0,1.0
2286,Cantinflas,17966873,6382924,11583949,2014.csv,2014,0.3552607067462435,0.6447392932537566
2287,Mumon: The Land of Stealth,17952505,0,17952505,2017.csv,2017,0.0,1.0
2288,Cyrano Agency,17917697,0,17917697,2010.csv,2010,0.0,1.0
2289,Raaz 3: The Third Dimension,17899667,0,17899667,2012.csv,2012,0.0,1.0
2290,9-Month Stretch,17891858,0,17891858,2013.csv,2013,0.0,1.0
2291,Black Money,17887384,0,17887384,2019.csv,2019,0.0,1.0
2292,We Have a Pope,17877523,548115,17329408,2011.csv,2011,0.030659448739067487,0.9693405512609325
2293,Shield of Straw,17876628,0,17876628,2013.csv,2013,0.0,1.0
2294,The Gilded Cage,17871370,0,17871370,2013.csv,2013,0.0,1.0
2295,Dil Dhadakne Do,17870077,3066100,14803977,2015.csv,2015,0.17157732448494767,0.8284226755150523
2296,The Old Man & the Gun,17860397,11277120,6583277,2018.csv,2018,0.6314036580485864,0.3685963419514135
2297,The Girl in the Sun,17860232,0,17860232,2013.csv,2013,0.0,1.0
2298,The Quiet Ones,17835162,8509867,9325295,2014.csv,2014,0.4771398768343119,0.5228601231656881
2299,Unforgettable,17768012,11368012,6400000,2017.csv,2017,0.6398021343074284,0.36019786569257156
2300,64: Part I,17756875,0,17756875,2016.csv,2016,0.0,1.0
2301,Clash of the Families,17748829,0,17748829,2011.csv,2011,0.0,1.0
2302,Oba: The Last Samurai,17737092,0,17737092,2011.csv,2011,0.0,1.0
2303,Luk fuk hei si,17716725,0,17716725,2014.csv,2014,0.0,1.0
2304,The Accidental Detective 2015 Re-release,17708027,0,17708027,2015.csv,2015,0.0,1.0
2305,The Promised Neverland,17698106,0,17698106,2020.csv,2020,0.0,1.0
2306,The Children Act,17696794,547750,17149044,2018.csv,2018,0.03095193400567357,0.9690480659943265
2307,Jue zhan shi shen,17677325,0,17677325,2017.csv,2017,0.0,1.0
2308,Regression,17671101,55039,17616062,2015.csv,2015,0.0031146333213759574,0.996885366678624
2309,Before I Go to Sleep,17669776,3242457,14427319,2014.csv,2014,0.18350300535784947,0.8164969946421505
2310,Kaiji: Final Game,17645779,0,17645779,2020.csv,2020,0.0,1.0
2311,Kanchana 2,17639157,0,17639157,2015.csv,2015,0.0,1.0
2312,Road to Ninja - Naruto the Movie,17635872,0,17635872,2012.csv,2012,0.0,1.0
2313,Neerja,17618280,1585687,16032593,2015.csv,2015,0.09000237253579804,0.909997627464202
2314,Operation Finale,17612099,17612099,0,2018.csv,2018,1.0,0.0
2315,Svaha: The Sixth Finger,17607783,0,17607783,2019.csv,2019,0.0,1.0
2316,Hitman: Agent Jun,17601351,0,17601351,2020.csv,2020,0.0,1.0
2317,Escape Plan 2: Hades,17592626,0,17592626,2018.csv,2018,0.0,1.0
2318,Little Boy,17572289,6485961,11086328,2015.csv,2015,0.3691016577293943,0.6308983422706057
2319,Toilet: A Love Story,17567417,1830715,15736702,2017.csv,2017,0.10421082393615408,0.8957891760638459
2320,Crayon Shin-Chan,17542139,0,17542139,2014.csv,2014,0.0,1.0
2321,Loving Pablo,17535962,22017,17513945,2018.csv,2018,0.0012555341988081407,0.9987444658011918
2322,Addicted,17534314,17390770,143544,2014.csv,2014,0.9918135377295056,0.0081864622704943
2323,Machete Kills,17496820,8008161,9488659,2013.csv,2013,0.45769236924195367,0.5423076307580463
2324,Natsume's Book of Friends The Movie: Tied to the Temporal World,17473797,0,17473797,2018.csv,2018,0.0,1.0
2325,Eyyvah Eyvah 3,17455570,0,17455570,2014.csv,2014,0.0,1.0
2326,Back to Mom's,17455542,0,17455542,2016.csv,2016,0.0,1.0
2327,Fate/Stay Night: Heaven's Feel - I. Presage Flower,17422935,193833,17229102,2017.csv,2017,0.011125163469874622,0.9888748365301254
2328,Stolen,17415418,304318,17111100,2012.csv,2012,0.017474056608919753,0.9825259433910802
2329,Kapoor & Sons,17412627,2607036,14805591,2016.csv,2016,0.14972100418851217,0.8502789958114878
2330,Billy and Buddy,17400053,894,17399159,2013.csv,2013,5.1379153845106106e-05,0.9999486208461549
2331,Fruitvale Station,17385830,16101339,1284491,2013.csv,2013,0.9261185114544431,0.07388148854555693
2332,Tokyo Family,17370130,0,17370130,2013.csv,2013,0.0,1.0
2333,Si accettano miracoli,17368659,0,17368659,2014.csv,2014,0.0,1.0
2334,What a Man,17351247,0,17351247,2011.csv,2011,0.0,1.0
2335,Mirage,17325485,0,17325485,2018.csv,2018,0.0,1.0
2336,Fate/stay night [Heaven's Feel] II. lost butterfly,17296294,420595,16875699,2019.csv,2019,0.02431705890290718,0.9756829410970929
2337,Genji monogatari: Sennen no nazo,17295465,0,17295465,2011.csv,2011,0.0,1.0
2338,While We're Young,17287309,7587485,9699824,2015.csv,2015,0.4389049215236449,0.5610950784763551
2339,Legend of the Naga Pearls,17274695,13588,17261107,2017.csv,2017,0.0007865840757246365,0.9992134159242754
2340,Innocent Witness,17245147,0,17245147,2019.csv,2019,0.0,1.0
2341,21 Karat,17241379,0,17241379,2018.csv,2018,0.0,1.0
2342,Z Storm,17234954,0,17234954,2014.csv,2014,0.0,1.0
2343,Chico Xavier,17229064,0,17229064,2010.csv,2010,0.0,1.0
2344,My Wish,17226157,0,17226157,2013.csv,2013,0.0,1.0
2345,New Trial,17198072,0,17198072,2017.csv,2017,0.0,1.0
2346,Crayon Shin-chan: Burst Serving! Kung Fu Boys - Ramen Rebellion,17170925,0,17170925,2018.csv,2018,0.0,1.0
2347,Miracle in Cell No. 7,17163660,0,17163660,2019.csv,2019,0.0,1.0
2348,I'm Off Then 2015 Re-release,17153058,0,17153058,2015.csv,2015,0.0,1.0
2349,Saint Seiya: Legend of Sanctuary,17150803,0,17150803,2014.csv,2014,0.0,1.0
2350,My Afternoons with Margueritte,17107143,666557,16440586,2010.csv,2010,0.03896366564539736,0.9610363343546027
2351,Paradise Kiss,17088871,0,17088871,2011.csv,2011,0.0,1.0
2352,Digimon Adventure: Last Evolution Kizuna,17068434,0,17068434,2020.csv,2020,0.0,1.0
2353,Melancholia,17039814,3030848,14008966,2011.csv,2011,0.17786860819020678,0.8221313918097932
2354,Beyond Outrage,17027515,3878,17023637,2012.csv,2012,0.0002277490285576022,0.9997722509714424
2355,Recep Ivedik 6,17018156,0,17018156,2019.csv,2019,0.0,1.0
2356,Women Vs Men,17010026,0,17010026,2011.csv,2011,0.0,1.0
2357,26 Years,17003684,0,17003684,2012.csv,2012,0.0,1.0
2358,Dad's Holiday,17000000,0,17000000,2015.csv,2015,0.0,1.0
2359,Celal and Ceren,16999831,0,16999831,2013.csv,2013,0.0,1.0
2360,Gintama: The Final,16971401,0,16971401,2021.csv,2021,0.0,1.0
2361,Chinese Puzzle,16968297,338523,16629774,2013.csv,2013,0.019950322651707476,0.9800496773482925
2362,Till Luck Do Us Part,16963608,0,16963608,2012.csv,2012,0.0,1.0
2363,Bullyparade: The Movie,16943483,0,16943483,2017.csv,2017,0.0,1.0
2364,Once Upon a Time in Bethlehem,16940610,0,16940610,2019.csv,2019,0.0,1.0
2365,Los ojos de Julia,16934369,0,16934369,2010.csv,2010,0.0,1.0
2366,Shanghai Fortress,16923671,0,16923671,2019.csv,2019,0.0,1.0
2367,The Nutcracker: The Untold Story,16918946,195459,16723487,2010.csv,2010,0.011552670006748648,0.9884473299932514
2368,Calvary,16887741,3600006,13287735,2014.csv,2014,0.21317273873397277,0.7868272612660272
2369,The Last Godfather,16863629,164247,16699382,2010.csv,2010,0.009739718538637206,0.9902602814613628
2370,The Cold Light of Day,16863583,3763583,13100000,2012.csv,2012,0.2231781348008902,0.7768218651991098
2371,The Pyramid,16861137,2756333,14104804,2014.csv,2014,0.16347254636505237,0.8365274536349476
2372,Happiness Never Comes Alone,16840841,0,16840841,2012.csv,2012,0.0,1.0
2373,Monkey Kingdom,16839663,16432322,407341,2015.csv,2015,0.9758106204381881,0.024189379561811896
2374,Stolen Identity,16831582,0,16831582,2018.csv,2018,0.0,1.0
2375,"Black Coal, Thin Ice",16830885,0,16830885,2014.csv,2014,0.0,1.0
2376,Hit and Run,16816647,13749300,3067347,2012.csv,2012,0.8176005597310807,0.18239944026891924
2377,Hardcore Henry,16810562,9252038,7558524,2016.csv,2016,0.5503705349053768,0.44962946509462326
2378,Kaabil,16795775,0,16795775,2017.csv,2017,0.0,1.0
2379,Love 911,16786016,0,16786016,2012.csv,2012,0.0,1.0
2380,The Birth of a Nation,16779212,15861566,917646,2016.csv,2016,0.9453105425928225,0.05468945740717741
2381,102 Not Out,16758596,1343797,15414799,2018.csv,2018,0.08018553582889641,0.9198144641711036
2382,My Way,16756021,0,16756021,2012.csv,2012,0.0,1.0
2383,Library Wars,16754139,0,16754139,2013.csv,2013,0.0,1.0
2384,Heartfall Arises,16748620,0,16748620,2016.csv,2016,0.0,1.0
2385,Salyut-7,16746823,0,16746823,2017.csv,2017,0.0,1.0
2386,Baaghi 3,16726510,721439,16005071,2020.csv,2020,0.043131472136147944,0.956868527863852
2387,Love Is All You Need,16722143,1631709,15090434,2012.csv,2012,0.09757774467064419,0.9024222553293558
2388,Delhi Belly,16706074,1532594,15173480,2011.csv,2011,0.09173872927894369,0.9082612707210563
2389,Tensou Sentai Goseiger: Epic on the Movie,16704506,0,16704506,2010.csv,2010,0.0,1.0
2390,Pride,16699029,1446634,15252395,2014.csv,2014,0.08662982739894637,0.9133701726010536
2391,Invasion,16653687,0,16653687,2019.csv,2019,0.0,1.0
2392,My Way,16653488,70177,16583311,2011.csv,2011,0.004213952056169854,0.9957860479438302
2393,The Dry,16648637,0,16648637,2021.csv,2021,0.0,1.0
2394,Beautiful Boy,16636604,7649973,8986631,2018.csv,2018,0.45982779899070747,0.5401722010092925
2395,Top Cat: The Movie,16611575,0,16611575,2011.csv,2011,0.0,1.0
2396,Nothing to Lose 2,16610713,1150551,15460162,2019.csv,2019,0.06926559985715243,0.9307344001428476
2397,Belle,16607575,10726630,5880945,2014.csv,2014,0.6458877951778029,0.3541122048221971
2398,Upgrade,16593554,11977130,4616424,2018.csv,2018,0.7217941376512832,0.27820586234871686
2399,One Life,16582691,0,16582691,2011.csv,2011,0.0,1.0
2400,Abacus and Sword,16575961,0,16575961,2010.csv,2010,0.0,1.0
2401,Tazza: One-Eyed Jack,16572611,97655,16474956,2019.csv,2019,0.005892553683906537,0.9941074463160935
2402,A Boss in the Living Room,16562487,0,16562487,2014.csv,2014,0.0,1.0
2403,The Wind Guardians,16558135,0,16558135,2018.csv,2018,0.0,1.0
2404,Kureyon Shinchan: Arashi o yobu ougon no supai daisakusen,16549790,0,16549790,2011.csv,2011,0.0,1.0
2405,Battle of the Year,16549477,8888355,7661122,2013.csv,2013,0.5370776973798024,0.4629223026201976
2406,The Most Beautiful Day,16542495,0,16542495,2016.csv,2016,0.0,1.0
2407,"Tomorrow, When the War Began",16533595,4936,16528659,2010.csv,2010,0.00029854366216179845,0.9997014563378382
2408,Silent House,16527747,12754783,3772964,2012.csv,2012,0.7717194001094039,0.2282805998905961
2409,Trick the Movie: Last Stage,16518606,0,16518606,2014.csv,2014,0.0,1.0
2410,The Concubine,16465764,0,16465764,2012.csv,2012,0.0,1.0
2411,Kamen Rider Movie War Mega Max: Kamen Rider vs. Kamen Rider Fourze & OOO,16458957,0,16458957,2010.csv,2010,0.0,1.0
2412,Pride and Prejudice and Zombies,16457494,10938134,5519360,2016.csv,2016,0.6646293779599738,0.33537062204002627
2413,The Great War of Archimedes,16454674,0,16454674,2019.csv,2019,0.0,1.0
2414,Hold Your Hands,16444489,0,16444489,2017.csv,2017,0.0,1.0
2415,Hwayi: A Monster Boy,16437802,0,16437802,2013.csv,2013,0.0,1.0
2416,Poms,16418218,13631124,2787094,2019.csv,2019,0.8302438181780751,0.1697561818219249
2417,Eyyvah Eyvah,16401863,0,16401863,2010.csv,2010,0.0,1.0
2418,Forever My Girl,16376066,16376066,0,2018.csv,2018,1.0,0.0
2419,Case départ,16374243,0,16374243,2011.csv,2011,0.0,1.0
2420,Before I Fall,16373843,12241122,4132721,2017.csv,2017,0.7476022580648904,0.25239774193510955
2421,The Single Moms Club,16365451,15973881,391570,2014.csv,2014,0.9760733755519478,0.02392662444805218
2422,Little Q,16360233,1652,16358581,2019.csv,2019,0.0001009765569964682,0.9998990234430035
2423,Playmobil: The Movie,16349303,1115008,15234295,2019.csv,2019,0.068199115277269,0.931800884722731
2424,Macbeth,16322067,1110707,15211360,2015.csv,2015,0.06804940820301743,0.9319505917969826
2425,Fiston,16301210,0,16301210,2014.csv,2014,0.0,1.0
2426,Animal Kingdom: Let's go Ape,16294916,0,16294916,2015.csv,2015,0.0,1.0
2427,Gravity,16222260,0,16222260,2010.csv,2010,0.0,1.0
2428,Evim Sensin,16212101,0,16212101,2012.csv,2012,0.0,1.0
2429,Gangnam 1970,16191434,18022,16173412,2015.csv,2015,0.0011130576822287637,0.9988869423177712
2430,In the House,16190771,389757,15801014,2012.csv,2012,0.024072788133437252,0.9759272118665627
2431,Helpless,16175929,0,16175929,2012.csv,2012,0.0,1.0
2432,Scouts Guide to the Zombie Apocalypse,16137046,3703046,12434000,2015.csv,2015,0.22947483696830262,0.7705251630316974
2433,See You Up There,16094346,0,16094346,2017.csv,2017,0.0,1.0
2434,Father There Is Only One,16093063,0,16093063,2019.csv,2019,0.0,1.0
2435,Whistleblower,16083213,0,16083213,2019.csv,2019,0.0,1.0
2436,Mom 2019 Re-release,16082564,0,16082564,2019.csv,2019,0.0,1.0
2437,The Space Between Us,16080475,7885294,8195181,2017.csv,2017,0.4903644948299102,0.5096355051700898
2438,Pokémon the Movie: Secrets of the Jungle,16052056,0,16052056,2020.csv,2020,0.0,1.0
2439,A Perfect Plan,16049338,0,16049338,2012.csv,2012,0.0,1.0
2440,"Kamen Rider OOO, Den-O, & All Riders: Let's Go Kamen Riders",16048109,0,16048109,2011.csv,2011,0.0,1.0
2441,Unfriended: Dark Web,16024987,8866745,7158242,2018.csv,2018,0.5533074691417846,0.44669253085821536
2442,I Still Believe,16021491,9868521,6152970,2020.csv,2020,0.6159552191490792,0.3840447808509208
2443,Sea Rex 3D: Journey to a Prehistoric World,16004150,6096582,9907568,2010.csv,2010,0.38093756931795814,0.6190624306820418
2444,Seventy-Seven Days,15988889,0,15988889,2017.csv,2017,0.0,1.0
2445,The Kitchen,15980032,12180032,3800000,2019.csv,2019,0.762203229630579,0.23779677036942104
2446,As the Light Goes Out,15973348,0,15973348,2014.csv,2014,0.0,1.0
2447,The Liar and His Lover,15957611,0,15957611,2013.csv,2013,0.0,1.0
2448,Gintama the Movie: The Final Chapter - Be Forever Yorozuya,15954700,0,15954700,2013.csv,2013,0.0,1.0
2449,The Words,15950164,11494838,4455326,2012.csv,2012,0.7206720883873043,0.27932791161269566
2450,Freaky,15920855,9030855,6890000,2020.csv,2020,0.5672342974042537,0.43276570259574626
2451,Loucas pra Casar,15918808,0,15918808,2015.csv,2015,0.0,1.0
2452,Stars 80,15896916,0,15896916,2012.csv,2012,0.0,1.0
2453,Wonder Wheel,15889124,1404061,14485063,2017.csv,2017,0.08836616795236792,0.911633832047632
2454,Anarchist from Colony,15876791,0,15876791,2017.csv,2017,0.0,1.0
2455,Seer Movie 6: Invincible Puni,15874097,0,15874097,2017.csv,2017,0.0,1.0
2456,Pokémon the Movie: Volcanion and the Mechanical Marvel,15870009,0,15870009,2016.csv,2016,0.0,1.0
2457,The Hunt,15843274,613308,15229966,2012.csv,2012,0.038710938155838245,0.9612890618441617
2458,Fueled: The Man They Called 'Pirate',15827405,0,15827405,2016.csv,2016,0.0,1.0
2459,Super Hero Taisen: Kamen Rider vs. Super Sentai 2012 Re-release,15822485,0,15822485,2012.csv,2012,0.0,1.0
2460,"I, Daniel Blake",15793051,260354,15532697,2016.csv,2016,0.01648535169043651,0.9835146483095635
2461,The Yellow Sea,15789762,0,15789762,2010.csv,2010,0.0,1.0
2462,The Client,15780280,0,15780280,2011.csv,2011,0.0,1.0
2463,Finding Your Feet,15775555,1418682,14356873,2018.csv,2018,0.08992913403046676,0.9100708659695332
2464,The Manny,15772833,0,15772833,2015.csv,2015,0.0,1.0
2465,Yolki novye,15735317,0,15735317,2017.csv,2017,0.0,1.0
2466,I Hate Luv Storys,15719212,847993,14871219,2010.csv,2010,0.053946279240969584,0.9460537207590304
2467,Tuntematon sotilas,15717199,0,15717199,2017.csv,2017,0.0,1.0
2468,Blind,15713724,0,15713724,2011.csv,2011,0.0,1.0
2469,The Brand New Testament,15709652,127910,15581742,2015.csv,2015,0.008142128164264873,0.9918578718357351
2470,Feng Shui,15702302,64147,15638155,2018.csv,2018,0.004085197189558576,0.9959148028104414
2471,Judy Moody and the Not Bummer Summer,15691640,15013650,677990,2011.csv,2011,0.956792916482917,0.04320708351708298
2472,"Papita, maní, tostón",15665693,0,15665693,2013.csv,2013,0.0,1.0
2473,Out of the Furnace,15660668,11330849,4329819,2013.csv,2013,0.723522713079672,0.276477286920328
2474,The Divine Move 2: The Wrathful,15642991,67578,15575413,2019.csv,2019,0.004320017827792652,0.9956799821722073
2475,Vampire Academy,15642346,7791979,7850367,2014.csv,2014,0.4981336559106927,0.5018663440893073
2476,Tully,15636462,9369755,6266707,2018.csv,2018,0.5992247479001324,0.4007752520998676
2477,"Belle and Sebastian, Friends for Life",15632063,0,15632063,2015.csv,2015,0.0,1.0
2478,The Conspirator,15623183,11538204,4084979,2011.csv,2011,0.7385309382857513,0.2614690617142486
2479,Traumfrauen,15599265,0,15599265,2015.csv,2015,0.0,1.0
2480,A Chorus of Angels,15591719,0,15591719,2012.csv,2012,0.0,1.0
2481,The Miracle,15584520,0,15584520,2015.csv,2015,0.0,1.0
2482,64: Part 2,15570077,0,15570077,2016.csv,2016,0.0,1.0
2483,Teiichi: Battle of Supreme High,15545390,0,15545390,2017.csv,2017,0.0,1.0
2484,In the Name of the Land,15531521,0,15531521,2019.csv,2019,0.0,1.0
2485,A Few Best Men,15521362,0,15521362,2012.csv,2012,0.0,1.0
2486,Bo Gia,15516889,0,15516889,2021.csv,2021,0.0,1.0
2487,Immaturi - Il viaggio,15512578,0,15512578,2012.csv,2012,0.0,1.0
2488,Paranoia,15500644,7388654,8111990,2013.csv,2013,0.47666755007082284,0.5233324499291772
2489,The Snow Queen 2,15490747,0,15490747,2014.csv,2014,0.0,1.0
2490,"My Love, My Bride",15486122,0,15486122,2014.csv,2014,0.0,1.0
2491,Chronicles of Evil,15460494,105057,15355437,2015.csv,2015,0.006795190373606432,0.9932048096263936
2492,Paths of the Soul 2017 Re-release,15409665,0,15409665,2017.csv,2017,0.0,1.0
2493,Our Little Sister,15407615,64441,15343174,2015.csv,2015,0.004182412398025262,0.9958175876019747
2494,The Detective Is in the Bar,15404986,0,15404986,2011.csv,2011,0.0,1.0
2495,Anonymous,15395087,4463292,10931795,2011.csv,2011,0.2899166467847827,0.7100833532152173
2496,Miss Bala,15383580,15006824,376756,2019.csv,2019,0.9755092117699521,0.024490788230047883
2497,"The Rich, the Pauper and the Butler",15377544,0,15377544,2014.csv,2014,0.0,1.0
2498,Jab Harry Met Sejal,15360368,1664648,13695720,2017.csv,2017,0.10837292439868629,0.8916270756013137
2499,Apollo 11,15342353,9039891,6302462,2019.csv,2019,0.5892115114285273,0.4107884885714727
2500,Loose Cannons,15340429,0,15340429,2010.csv,2010,0.0,1.0
2501,Meu Passado Me Condena: O Filme,15340418,0,15340418,2013.csv,2013,0.0,1.0
2502,The Dead Don't Die,15322395,6563605,8758790,2019.csv,2019,0.42836677947540186,0.5716332205245982
2503,Cats,15320645,0,15320645,2018.csv,2018,0.0,1.0
2504,Woody Woodpecker,15316635,0,15316635,2017.csv,2017,0.0,1.0
2505,The Little Witch,15295482,0,15295482,2018.csv,2018,0.0,1.0
2506,Chocolat,15291827,0,15291827,2016.csv,2016,0.0,1.0
2507,Jappeloup,15288523,0,15288523,2013.csv,2013,0.0,1.0
2508,Yugo & Lala 4,15286513,0,15286513,2018.csv,2018,0.0,1.0
2509,Kandagar,15274292,0,15274292,2010.csv,2010,0.0,1.0
2510,The Negotiation,15229193,110986,15118207,2018.csv,2018,0.0072877138007247004,0.9927122861992753
2511,Mixed Doubles,15224207,0,15224207,2017.csv,2017,0.0,1.0
2512,The Incite Mill,15219610,0,15219610,2010.csv,2010,0.0,1.0
2513,Crayon Shin-Chan: Invasion!! Alien Shiriri,15216719,0,15216719,2017.csv,2017,0.0,1.0
2514,Once Upon a Time in the Northeast,15208575,0,15208575,2017.csv,2017,0.0,1.0
2515,"Paw Patrol: Ready, Race, Rescue!",15193000,0,15193000,2019.csv,2019,0.0,1.0
2516,Attack on Titan Part 2,15186410,305934,14880476,2015.csv,2015,0.020145248284485932,0.9798547517155141
2517,The Fable,15183043,0,15183043,2019.csv,2019,0.0,1.0
2518,Tamasha,15159762,2065487,13094275,2015.csv,2015,0.13624798331266677,0.8637520166873333
2519,Friendship! 2010 Re-release,15141000,0,15141000,2010.csv,2010,0.0,1.0
2520,Extraordinary Measures,15134293,12068313,3065980,2010.csv,2010,0.7974150493848638,0.2025849506151361
2521,Irreplaceable,15130912,8494,15122418,2016.csv,2016,0.0005613673518159382,0.9994386326481841
2522,Three,15121228,119550,15001678,2016.csv,2016,0.007906103922247585,0.9920938960777524
2523,Pitbull: Tough Women,15118739,0,15118739,2016.csv,2016,0.0,1.0
2524,Partners: The Movie IV,15104791,0,15104791,2017.csv,2017,0.0,1.0
2525,Impossible,15101854,0,15101854,2012.csv,2012,0.0,1.0
2526,Recall,15101476,0,15101476,2018.csv,2018,0.0,1.0
2527,Metro,15099267,0,15099267,2013.csv,2013,0.0,1.0
2528,War of the Buttons,15082409,47771,15034638,2011.csv,2011,0.003167332221265184,0.9968326677787348
2529,Ip Man 2,15061802,205675,14856127,2010.csv,2010,0.013655404579080245,0.9863445954209198
2530,The Housemaid,15038301,157961,14880340,2010.csv,2010,0.01050391264279123,0.9894960873572087
2531,Marrying the Mafia 4: Family Ordeal,15029510,0,15029510,2011.csv,2011,0.0,1.0
2532,Friend,15007076,0,15007076,2012.csv,2012,0.0,1.0
2533,Journey to the South Pacific,14994876,7653913,7340963,2013.csv,2013,0.510435231341693,0.489564768658307
2534,The One,14897163,0,14897163,2017.csv,2017,0.0,1.0
2535,Blue Valentine,14892418,9706328,5186090,2010.csv,2010,0.651763064936802,0.3482369350631979
2536,Almanya: Welcome to Germany,14885722,0,14885722,2011.csv,2011,0.0,1.0
2537,Colpi di fortuna,14882541,0,14882541,2013.csv,2013,0.0,1.0
2538,Gold,14880939,7227038,7653901,2017.csv,2017,0.4856573903031254,0.5143426096968746
2539,School of Life,14880497,6300,14874197,2017.csv,2017,0.00042337295588984697,0.9995766270441101
2540,The Game Changer,14875966,0,14875966,2017.csv,2017,0.0,1.0
2541,Emperor,14858240,3346265,11511975,2013.csv,2013,0.22521274390506546,0.7747872560949345
2542,The Take,14857808,50269,14807539,2016.csv,2016,0.0033833389151347224,0.9966166610848652
2543,Le mac,14849183,0,14849183,2010.csv,2010,0.0,1.0
2544,Vacanze di Natale a Cortina,14847186,0,14847186,2011.csv,2011,0.0,1.0
2545,Familyhood,14831131,0,14831131,2016.csv,2016,0.0,1.0
2546,Sluzhebnyy roman. Nashe vremya,14823830,0,14823830,2011.csv,2011,0.0,1.0
2547,Happiness Around the Corner,14798770,0,14798770,2018.csv,2018,0.0,1.0
2548,Somewhere,14788642,1785645,13002997,2010.csv,2010,0.12074435232119352,0.8792556476788065
2549,Dabangg 3,14784628,202000,14582628,2019.csv,2019,0.013662839538471985,0.986337160461528
2550,Seondal: The Man Who Sells the River,14777982,97477,14680505,2016.csv,2016,0.006596096814842514,0.9934039031851575
2551,A Royal Affair,14758997,1546761,13212236,2012.csv,2012,0.10480122734627563,0.8951987726537244
2552,Sui Dhaaga,14751915,790628,13961287,2018.csv,2018,0.053594940046766806,0.9464050599532332
2553,Sword Master,14714624,75526,14639098,2016.csv,2016,0.005132716948798691,0.9948672830512013
2554,Inherent Vice,14710975,8110975,6600000,2014.csv,2014,0.5513553656368799,0.4486446343631201
2555,City Hunter,14702744,0,14702744,2019.csv,2019,0.0,1.0
2556,The Way Back,14690514,13590514,1100000,2020.csv,2020,0.9251217486331655,0.0748782513668344
2557,Inazuma Eleven GO the Movie: The Ultimate Bonds Gryphon 2011 Re-release,14673852,0,14673852,2011.csv,2011,0.0,1.0
2558,A Boy Called H,14673839,0,14673839,2013.csv,2013,0.0,1.0
2559,Men in the City 2,14663510,0,14663510,2011.csv,2011,0.0,1.0
2560,"Hello, My Name Is Doris",14659448,14444999,214449,2016.csv,2016,0.985371277281382,0.014628722718618054
2561,Blood-Soaked Guangchang,14651659,0,14651659,2018.csv,2018,0.0,1.0
2562,Stromberg - Der Film,14641000,0,14641000,2014.csv,2014,0.0,1.0
2563,Paulette,14627193,0,14627193,2013.csv,2013,0.0,1.0
2564,Beyond the Lights,14618727,14618727,0,2014.csv,2014,1.0,0.0
2565,Robo-G,14598382,0,14598382,2012.csv,2012,0.0,1.0
2566,High & Low: The Movie,14590783,0,14590783,2016.csv,2016,0.0,1.0
2567,Trap.com,14576408,0,14576408,2011.csv,2011,0.0,1.0
2568,The Dude in Me,14569310,0,14569310,2019.csv,2019,0.0,1.0
2569,Megan Leavey,14510490,13406883,1103607,2017.csv,2017,0.9239441948548947,0.07605580514510536
2570,Pattaya,14496436,0,14496436,2016.csv,2016,0.0,1.0
2571,¿Qué culpa tiene el niño?,14490880,0,14490880,2016.csv,2016,0.0,1.0
2572,Nagasaki: Memories of My Son,14484841,0,14484841,2015.csv,2015,0.0,1.0
2573,"My Tomorrow, Your Yesterday",14483358,0,14483358,2016.csv,2016,0.0,1.0
2574,Vai que dá Certo,14464092,0,14464092,2013.csv,2013,0.0,1.0
2575,A United Kingdom,14459330,3902185,10557145,2016.csv,2016,0.269873154565253,0.7301268454347469
2576,Serenity,14454622,8547045,5907577,2019.csv,2019,0.5913018687033117,0.40869813129668836
2577,Barbecue,14454364,0,14454364,2014.csv,2014,0.0,1.0
2578,The Drug King,14446477,0,14446477,2018.csv,2018,0.0,1.0
2579,America: Imagine the World Without Her,14444502,14444502,0,2014.csv,2014,1.0,0.0
2580,RBG,14441292,14017361,423931,2018.csv,2018,0.9706445240495103,0.02935547595048975
2581,"1,778 Stories of Me and My Wife",14436754,0,14436754,2011.csv,2011,0.0,1.0
2582,Nativity 2: Danger in the Manger!,14433981,0,14433981,2012.csv,2012,0.0,1.0
2583,Unfinished Business,14431253,10219501,4211752,2015.csv,2015,0.7081506366772171,0.29184936332278283
2584,45 Years,14430249,4247285,10182964,2015.csv,2015,0.2943320659262359,0.705667934073764
2585,Do You Believe?,14410698,12985600,1425098,2015.csv,2015,0.9011083293814082,0.09889167061859183
2586,Beauty and the Beast 2010 3D Release,14410056,0,14410056,2010.csv,2010,0.0,1.0
2587,The Burma Conspiracy,14404319,0,14404319,2011.csv,2011,0.0,1.0
2588,Woodlawn,14401617,14394097,7520,2015.csv,2015,0.9994778364123973,0.0005221635876026977
2589,Botoks,14387546,0,14387546,2017.csv,2017,0.0,1.0
2590,Boy s tenyu 3. Posledniy raund,14386840,0,14386840,2011.csv,2011,0.0,1.0
2591,Titeuf: The Movie,14377649,0,14377649,2011.csv,2011,0.0,1.0
2592,Little Bird's Big Adventure,14375849,0,14375849,2017.csv,2017,0.0,1.0
2593,Soulless,14370662,0,14370662,2012.csv,2012,0.0,1.0
2594,Eighth Grade,14347433,13539709,807724,2018.csv,2018,0.9437025424687469,0.056297457531253155
2595,Super Lopez,14347006,0,14347006,2018.csv,2018,0.0,1.0
2596,Tall Tales from the Magical Garden of Antoon Krings,14340726,220,14340506,2017.csv,2017,1.5340924859731648e-05,0.9999846590751402
2597,La Belle Époque,14334104,0,14334104,2019.csv,2019,0.0,1.0
2598,The Other Side of the Door,14332467,3000342,11332125,2016.csv,2016,0.20933883887540086,0.7906611611245992
2599,Ducoboo,14325401,0,14325401,2011.csv,2011,0.0,1.0
2600,Beginners,14311701,5790894,8520807,2011.csv,2011,0.4046265360071455,0.5953734639928545
2601,The Beauty Inside,14301869,108083,14193786,2015.csv,2015,0.007557264019129248,0.9924427359808707
2602,Unsane,14293601,7732899,6560702,2018.csv,2018,0.5410042577794077,0.45899574222059225
2603,The Personal History of David Copperfield,14284948,1876298,12408650,2020.csv,2020,0.1313479055016511,0.8686520944983489
2604,Colette,14273033,5137622,9135411,2018.csv,2018,0.35995306673781247,0.6400469332621875
2605,Brotherhood of Blades,14257523,0,14257523,2014.csv,2014,0.0,1.0
2606,Petty Romance,14244325,0,14244325,2010.csv,2010,0.0,1.0
2607,Srimanthudu,14240289,0,14240289,2015.csv,2015,0.0,1.0
2608,Bibi & Tina: Mädchen gegen Jungs,14223864,0,14223864,2016.csv,2016,0.0,1.0
2609,If I Were Rich Man,14195149,0,14195149,2019.csv,2019,0.0,1.0
2610,Pawn,14191042,0,14191042,2020.csv,2020,0.0,1.0
2611,Kukhnya v Parizhe,14187131,0,14187131,2014.csv,2014,0.0,1.0
2612,Tri bogatyrya i printsessa Egipta,14184783,0,14184783,2017.csv,2017,0.0,1.0
2613,School Life,14178920,0,14178920,2019.csv,2019,0.0,1.0
2614,Ya veremos,14134723,4165949,9968774,2018.csv,2018,0.2947315628328903,0.7052684371671096
2615,Shaandaar,14120808,521794,13599014,2015.csv,2015,0.03695213475036273,0.9630478652496373
2616,Sotto una buona stella,14119210,0,14119210,2014.csv,2014,0.0,1.0
2617,Red Lights,14107313,52624,14054689,2012.csv,2012,0.0037302638709440982,0.9962697361290559
2618,100 Things,14093397,0,14093397,2018.csv,2018,0.0,1.0
2619,Seeking Justice,14089528,411746,13677782,2011.csv,2011,0.02922354815576505,0.970776451844235
2620,Samurai Hustle,14086665,0,14086665,2014.csv,2014,0.0,1.0
2621,Rebirth,14066908,0,14066908,2011.csv,2011,0.0,1.0
2622,Island of Lemurs: Madagascar,14066534,11272213,2794321,2014.csv,2014,0.8013497141513325,0.19865028584866748
2623,Three Steps Above Heaven,14066238,0,14066238,2010.csv,2010,0.0,1.0
2624,Coward Hero,14059651,0,14059651,2019.csv,2019,0.0,1.0
2625,Les gamins,14057569,0,14057569,2013.csv,2013,0.0,1.0
2626,Brice 3,14039310,0,14039310,2016.csv,2016,0.0,1.0
2627,Inside Men 2015 Re-release,14037405,0,14037405,2015.csv,2015,0.0,1.0
2628,Buried Secrets 2010 Re-release,14029525,0,14029525,2010.csv,2010,0.0,1.0
2629,The Eight Rangers,14013405,0,14013405,2012.csv,2012,0.0,1.0
2630,Lucky Trouble,14005861,0,14005861,2011.csv,2011,0.0,1.0
2631,Ozzy,14005298,0,14005298,2016.csv,2016,0.0,1.0
2632,Kedarnath,13999297,901131,13098166,2018.csv,2018,0.06436973228012807,0.9356302677198719
2633,Mysterious Island,13969010,0,13969010,2011.csv,2011,0.0,1.0
2634,I soliti idioti,13927866,0,13927866,2011.csv,2011,0.0,1.0
2635,Forbidden Dream,13902314,0,13902314,2019.csv,2019,0.0,1.0
2636,The Missing,13887720,0,13887720,2017.csv,2017,0.0,1.0
2637,The Miracles of the Namiya General Store,13871918,0,13871918,2017.csv,2017,0.0,1.0
2638,The Tuche Family,13867701,0,13867701,2011.csv,2011,0.0,1.0
2639,The Golden Monk,13867066,0,13867066,2017.csv,2017,0.0,1.0
2640,Hotel Deluxe,13866613,0,13866613,2013.csv,2013,0.0,1.0
2641,Trouble,13864163,0,13864163,2019.csv,2019,0.0,1.0
2642,City Under Siege,13851432,0,13851432,2010.csv,2010,0.0,1.0
2643,Torrente 5,13851074,0,13851074,2014.csv,2014,0.0,1.0
2644,Tri bogatyrya: Khod konem,13845029,0,13845029,2015.csv,2015,0.0,1.0
2645,Politseyskiy s Rublyovki. Novogodniy bespredel 2,13843719,0,13843719,2019.csv,2019,0.0,1.0
2646,Kureyon Shin-chan 2013 Re-release,13840916,0,13840916,2013.csv,2013,0.0,1.0
2647,The Quake,13837294,6235,13831059,2018.csv,2018,0.0004505938805665327,0.9995494061194334
2648,Three heroes and the King of the Sea,13816357,0,13816357,2016.csv,2016,0.0,1.0
2649,The Little Vampire 3D,13808590,0,13808590,2017.csv,2017,0.0,1.0
2650,Rudolf the Black Cat,13804754,0,13804754,2016.csv,2016,0.0,1.0
2651,Winter's Bone,13796834,6531503,7265331,2010.csv,2010,0.47340592776574686,0.5265940722342531
2652,Nightlife,13796163,0,13796163,2020.csv,2020,0.0,1.0
2653,Meet the Pegusus,13760000,0,13760000,2014.csv,2014,0.0,1.0
2654,Pulling Strings,13725819,5842961,7882858,2013.csv,2013,0.4256912465478381,0.5743087534521619
2655,Yolki 5,13716450,0,13716450,2016.csv,2016,0.0,1.0
2656,Muslum,13700403,0,13700403,2018.csv,2018,0.0,1.0
2657,Too Young to Die,13699654,0,13699654,2016.csv,2016,0.0,1.0
2658,Love Will Tear Us Apart,13690000,0,13690000,2013.csv,2013,0.0,1.0
2659,Tees Maar Khan,13681934,1076443,12605491,2010.csv,2010,0.0786762310065229,0.9213237689934771
2660,Phantom,13676590,489984,13186606,2015.csv,2015,0.03582647428927825,0.9641735257107218
2661,Humpty Sharma Ki Dulhania,13669988,380011,13289977,2014.csv,2014,0.027798927109519044,0.972201072890481
2662,Chloe,13657649,3075255,10582394,2010.csv,2010,0.2251672304655069,0.7748327695344931
2663,Department Q: The Keeper of Lost Causes,13656380,0,13656380,2013.csv,2013,0.0,1.0
2664,Finalmente la felicità,13652530,0,13652530,2011.csv,2011,0.0,1.0
2665,I Just Wanna Hug You,13651173,0,13651173,2014.csv,2014,0.0,1.0
2666,Chihayafuru Part III,13649091,0,13649091,2018.csv,2018,0.0,1.0
2667,I Am a Hero,13640067,0,13640067,2016.csv,2016,0.0,1.0
2668,All Is Lost,13627519,6263670,7363849,2013.csv,2013,0.45963392162579264,0.5403660783742074
2669,Guilt by Design,13626391,0,13626391,2019.csv,2019,0.0,1.0
2670,Sing Street,13624522,3237118,10387404,2016.csv,2016,0.23759497764398635,0.7624050223560137
2671,Bakuman.,13612114,0,13612114,2015.csv,2015,0.0,1.0
2672,Do It Like An Hombre,13610252,2534252,11076000,2017.csv,2017,0.18620169560416663,0.8137983043958333
2673,Love Forecast,13608637,32211,13576426,2015.csv,2015,0.0023669526933520232,0.9976330473066479
2674,Strange Magic,13603453,12429583,1173870,2015.csv,2015,0.9137079387123255,0.08629206128767454
2675,The Last Mission,13597694,0,13597694,2015.csv,2015,0.0,1.0
2676,Bunshinsaba 2,13587820,0,13587820,2013.csv,2013,0.0,1.0
2677,Love Likes Coincidences,13585314,0,13585314,2011.csv,2011,0.0,1.0
2678,Chronicle of My Mother,13575636,0,13575636,2012.csv,2012,0.0,1.0
2679,The Two Faces of January,13551951,507463,13044488,2014.csv,2014,0.03744575227581623,0.9625542477241837
2680,ARIF V 216,13547689,0,13547689,2018.csv,2018,0.0,1.0
2681,Nymphomaniac: Vol. I,13545832,785896,12759936,2013.csv,2013,0.05801755108139537,0.9419824489186046
2682,Phantom of the Theatre,13526843,43955,13482888,2016.csv,2016,0.0032494647864250363,0.9967505352135749
2683,Rage,13521593,0,13521593,2016.csv,2016,0.0,1.0
2684,Sardaar Gabbar Singh,13504607,0,13504607,2016.csv,2016,0.0,1.0
2685,Hit-and-Run Squad,13489165,0,13489165,2019.csv,2019,0.0,1.0
2686,Letters to Santa 2,13482509,0,13482509,2015.csv,2015,0.0,1.0
2687,Three Identical Strangers,13448497,12320845,1127652,2018.csv,2018,0.9161503326356841,0.08384966736431587
2688,Haunters,13443879,0,13443879,2010.csv,2010,0.0,1.0
2689,The Truth About Beauty,13442445,0,13442445,2014.csv,2014,0.0,1.0
2690,#Alive,13432212,0,13432212,2020.csv,2020,0.0,1.0
2691,The Third Murder,13411936,89315,13322621,2017.csv,2017,0.006659366701421778,0.9933406332985782
2692,The Snow Queen,13410623,0,13410623,2012.csv,2012,0.0,1.0
2693,Howling Village,13394556,0,13394556,2020.csv,2020,0.0,1.0
2694,Our President,13392049,507268,12884781,2017.csv,2017,0.03787829629356942,0.9621217037064306
2695,Ratchet & Clank,13385737,8821329,4564408,2016.csv,2016,0.6590095860989947,0.3409904139010052
2696,Lightning Strike,13378892,0,13378892,2012.csv,2012,0.0,1.0
2697,New Happy Dad and Son 2: The Instant Genius,13375370,0,13375370,2016.csv,2016,0.0,1.0
2698,Behind The Candelabra,13352609,0,13352609,2013.csv,2013,0.0,1.0
2699,Dzhungli,13324130,0,13324130,2012.csv,2012,0.0,1.0
2700,Reign of Assassins,13321793,0,13321793,2010.csv,2010,0.0,1.0
2701,Montage,13316432,0,13316432,2013.csv,2013,0.0,1.0
2702,Hotel Artemis,13313581,6708147,6605434,2018.csv,2018,0.5038574520258674,0.4961425479741326
2703,Blood and Ties,13306865,0,13306865,2013.csv,2013,0.0,1.0
2704,Eiga Kureyon Shinchan: Arashi o yobu! Ora to uchuu to purinsesu,13305162,0,13305162,2012.csv,2012,0.0,1.0
2705,Three Seconds 2019 Re-release,13287714,0,13287714,2019.csv,2019,0.0,1.0
2706,Upon the Magic Roads,13284522,0,13284522,2021.csv,2021,0.0,1.0
2707,Bienvenue à bord,13264865,0,13264865,2011.csv,2011,0.0,1.0
2708,Gorko! 2,13228038,0,13228038,2014.csv,2014,0.0,1.0
2709,Klown,13204964,0,13204964,2010.csv,2010,0.0,1.0
2710,Paris Can Wait,13203541,5617731,7585810,2017.csv,2017,0.42547154585273755,0.5745284541472625
2711,The Well Digger's Daughter,13194167,386368,12807799,2011.csv,2011,0.029283243117962657,0.9707167568820373
2712,Nothing to Hide,13189388,0,13189388,2018.csv,2018,0.0,1.0
2713,Come Play,13173947,10475990,2697957,2020.csv,2020,0.7952051120290676,0.20479488797093232
2714,Miszmasz czyli Kogel Mogel 3,13168337,0,13168337,2019.csv,2019,0.0,1.0
2715,Mommy,13156856,3494070,9662786,2014.csv,2014,0.2655702851805933,0.7344297148194067
2716,While at War,13144370,0,13144370,2019.csv,2019,0.0,1.0
2717,The Sisters Brothers,13143056,3143056,10000000,2018.csv,2018,0.23914194689576002,0.76085805310424
2718,Man in Love,13128746,0,13128746,2014.csv,2014,0.0,1.0
2719,Mafia Women,13121008,0,13121008,2018.csv,2018,0.0,1.0
2720,Kamen Rider Movie War Ultimatum: Kamen Rider vs. Kamen Rider Wizard & Fourze,13105773,0,13105773,2012.csv,2012,0.0,1.0
2721,Hillary's America: The Secret History of the Democratic Party,13099931,13099931,0,2016.csv,2016,1.0,0.0
2722,Kiss Me Again,13099140,0,13099140,2010.csv,2010,0.0,1.0
2723,The Angels' Share,13090471,346669,12743802,2012.csv,2012,0.026482545967979304,0.9735174540320207
2724,Shut In,13082071,6900335,6181736,2016.csv,2016,0.5274650321038619,0.47253496789613814
2725,Hot Tub Time Machine 2,13081651,12314651,767000,2015.csv,2015,0.94136825695778,0.05863174304221998
2726,Song of the Phoenix,13075926,0,13075926,2016.csv,2016,0.0,1.0
2727,Saraba Abunai Deka: Long Goodbye,13074758,0,13074758,2016.csv,2016,0.0,1.0
2728,"Charterrejsen, Malta All Inclusive",13061991,0,13061991,2014.csv,2014,0.0,1.0
2729,French Women,13061533,0,13061533,2014.csv,2014,0.0,1.0
2730,Welcome to Marwen,13061491,10763520,2297971,2018.csv,2018,0.8240651852074162,0.1759348147925838
2731,Good Newwz,13058135,0,13058135,2019.csv,2019,0.0,1.0
2732,"Roman J. Israel, Esq.",13025860,11962778,1063082,2017.csv,2017,0.9183868090091556,0.08161319099084437
2733,Friends with Kids,13019073,7251073,5768000,2012.csv,2012,0.5569577035169861,0.4430422964830138
2734,The Vatican Tapes,13015764,1784763,11231001,2015.csv,2015,0.13712318385613015,0.8628768161438698
2735,Ayla,13010729,0,13010729,2017.csv,2017,0.0,1.0
2736,The Guardian,13006233,0,13006233,2017.csv,2017,0.0,1.0
2737,In a Better World,13004504,1008098,11996406,2010.csv,2010,0.07751914259859508,0.922480857401405
2738,All Creatures Big And Small 2015 Re-release,12989471,0,12989471,2015.csv,2015,0.0,1.0
2739,Pyaar Ka Punchnama 2,12983721,222856,12760865,2015.csv,2015,0.017164262848839713,0.9828357371511602
2740,The Wave,12975143,177404,12797739,2015.csv,2015,0.013672604610215086,0.9863273953897849
2741,I Saw the Devil,12966357,129210,12837147,2010.csv,2010,0.00996501947308716,0.9900349805269129
2742,Le Havre,12959706,611709,12347997,2011.csv,2011,0.04720083927829844,0.9527991607217016
2743,Loving,12957265,7751969,5205296,2016.csv,2016,0.5982720118790501,0.4017279881209499
2744,Child 44,12951093,1224330,11726763,2015.csv,2015,0.09453487825313277,0.9054651217468672
2745,Lyubov v bolshom gorode 2,12923001,0,12923001,2010.csv,2010,0.0,1.0
2746,Drishyam 2015 Re-release,12914193,0,12914193,2015.csv,2015,0.0,1.0
2747,Take Point,12908032,112386,12795646,2018.csv,2018,0.008706671938836221,0.9912933280611638
2748,Byeonshin,12902597,0,12902597,2019.csv,2019,0.0,1.0
2749,Mubarakan,12899968,758868,12141100,2017.csv,2017,0.05882712267193221,0.9411728773280678
2750,Kureyon Shinchan: Chojiku! Arashi wo Yobu Ora no Hanayome,12876220,0,12876220,2010.csv,2010,0.0,1.0
2751,Party Crashers,12867493,0,12867493,2012.csv,2012,0.0,1.0
2752,Earth: One Amazing Day,12851540,81345,12770195,2017.csv,2017,0.006329591628707532,0.9936704083712925
2753,Parasyte: Part 2,12828929,0,12828929,2015.csv,2015,0.0,1.0
2754,What Men Talk About,12824118,0,12824118,2010.csv,2010,0.0,1.0
2755,The Perfect Dictatorship,12809592,0,12809592,2014.csv,2014,0.0,1.0
2756,I Can Quit Whenever I Want,12804194,0,12804194,2019.csv,2019,0.0,1.0
2757,Madang Amtark,12778833,0,12778833,2011.csv,2011,0.0,1.0
2758,Samjin Company English Class,12761386,0,12761386,2020.csv,2020,0.0,1.0
2759,Trener,12760988,0,12760988,2018.csv,2018,0.0,1.0
2760,Saving General Yang,12756500,0,12756500,2013.csv,2013,0.0,1.0
2761,The Brain Man,12752752,0,12752752,2013.csv,2013,0.0,1.0
2762,Suburbicon,12751667,5775178,6976489,2017.csv,2017,0.4528959233330042,0.5471040766669958
2763,Elle,12748594,2341534,10407060,2016.csv,2016,0.18366997960716294,0.8163300203928371
2764,Dad's Army,12738785,0,12738785,2016.csv,2016,0.0,1.0
2765,Valley of the Wolves: Palestine,12732423,0,12732423,2011.csv,2011,0.0,1.0
2766,Get Married If You Can,12710975,0,12710975,2014.csv,2014,0.0,1.0
2767,Hunter X Hunter: Phantom Rouge,12705094,0,12705094,2013.csv,2013,0.0,1.0
2768,Jim Button and Luke the Engine Driver,12699718,0,12699718,2018.csv,2018,0.0,1.0
2769,Populaire,12698385,179091,12519294,2012.csv,2012,0.014103447013143797,0.9858965529868562
2770,"S Novym godom, mamy!",12690623,0,12690623,2012.csv,2012,0.0,1.0
2771,Naan Sigappu Manithan,12686966,0,12686966,2014.csv,2014,0.0,1.0
2772,The Past,12673462,1331747,11341715,2013.csv,2013,0.10508154756766541,0.8949184524323346
2773,Redemption,12671109,36895,12634214,2013.csv,2013,0.0029117419793326695,0.9970882580206674
2774,The Green Inferno,12666449,7192291,5474158,2015.csv,2015,0.5678222049447323,0.43217779505526766
2775,Le chant du loup,12652790,0,12652790,2019.csv,2019,0.0,1.0
2776,Collectors,12640113,0,12640113,2020.csv,2020,0.0,1.0
2777,Made in Dagenham,12629471,1095369,11534102,2010.csv,2010,0.08673118612806506,0.9132688138719349
2778,Whistle Blower,12628888,0,12628888,2014.csv,2014,0.0,1.0
2779,"Humanoid Monster, Bem the Movie",12628578,0,12628578,2012.csv,2012,0.0,1.0
2780,The Worst Week of My Life 2011 Re-release,12628562,0,12628562,2011.csv,2011,0.0,1.0
2781,Luis and the Aliens,12627729,169710,12458019,2018.csv,2018,0.013439471182823135,0.9865605288171768
2782,News of the World,12621890,12621890,0,2020.csv,2020,1.0,0.0
2783,Aibou shirîzu: X Day,12615121,0,12615121,2013.csv,2013,0.0,1.0
2784,It Boy,12604999,0,12604999,2013.csv,2013,0.0,1.0
2785,Their Finest,12597262,3603484,8993778,2017.csv,2017,0.2860529534116223,0.7139470465883777
2786,Kamen Rider Heisei Generations Forever,12587899,0,12587899,2018.csv,2018,0.0,1.0
2787,No Escapes,12575166,0,12575166,2020.csv,2020,0.0,1.0
2788,Hunting Season,12571431,0,12571431,2010.csv,2010,0.0,1.0
2789,Glove,12569995,0,12569995,2011.csv,2011,0.0,1.0
2790,People Like Us,12558931,12434778,124153,2012.csv,2012,0.9901143656255457,0.009885634374454322
2791,Whatcha Wearin'?,12534479,0,12534479,2012.csv,2012,0.0,1.0
2792,The Ages of Love,12493369,0,12493369,2011.csv,2011,0.0,1.0
2793,Second Chance,12481191,0,12481191,2011.csv,2011,0.0,1.0
2794,A Second Chance,12468099,0,12468099,2014.csv,2014,0.0,1.0
2795,Troubleshooter,12460480,0,12460480,2010.csv,2010,0.0,1.0
2796,The Jungle Bunch,12459081,0,12459081,2017.csv,2017,0.0,1.0
2797,The Promise,12448676,8224288,4224388,2017.csv,2017,0.6606556392021128,0.33934436079788727
2798,Can You Ever Forgive Me?,12442161,8803865,3638296,2018.csv,2018,0.707583272712835,0.292416727287165
2799,Heart for Heaven,12435610,0,12435610,2015.csv,2015,0.0,1.0
2800,Princess and Seven Kung Fu Masters,12416890,0,12416890,2013.csv,2013,0.0,1.0
2801,Confessions of a Brazilian Call Girl,12380488,0,12380488,2011.csv,2011,0.0,1.0
2802,MBA Partners,12369340,0,12369340,2016.csv,2016,0.0,1.0
2803,Rampant,12359573,167937,12191636,2018.csv,2018,0.013587605332320138,0.9864123946676798
2804,Did You... Score?,12351892,0,12351892,2012.csv,2012,0.0,1.0
2805,Spread Your Wings,12332267,0,12332267,2019.csv,2019,0.0,1.0
2806,War of the Buttons,12326773,0,12326773,2011.csv,2011,0.0,1.0
2807,Solan og Ludvig - Jul i Flåklypa,12313639,0,12313639,2013.csv,2013,0.0,1.0
2808,Marrowbone,12294931,1377,12293554,2017.csv,2017,0.00011199737517843735,0.9998880026248216
2809,The Beatles: Eight Days a Week - The Touring Years,12283800,2930414,9353386,2016.csv,2016,0.23855924062586495,0.761440759374135
2810,Humshakals,12278365,0,12278365,2014.csv,2014,0.0,1.0
2811,Very Ordinary Couple,12273555,0,12273555,2013.csv,2013,0.0,1.0
2812,The Man Who Knew Infinity,12252684,3866794,8385890,2016.csv,2016,0.3155875071943421,0.684412492805658
2813,Sai'er Hao Da Dinying 3: Zhanshen Lianmeng,12230000,0,12230000,2013.csv,2013,0.0,1.0
2814,Children...,12229392,0,12229392,2011.csv,2011,0.0,1.0
2815,Gainsbourg: A Heroic Life,12220456,233007,11987449,2010.csv,2010,0.0190669644406068,0.9809330355593932
2816,The Guillotines,12217440,5290,12212150,2012.csv,2012,0.0004329875980565487,0.9995670124019435
2817,The Current War: Director's Cut,12217160,5979540,6237620,2019.csv,2019,0.48943780714994317,0.5105621928500568
2818,Tomorrow's Joe,12208614,0,12208614,2011.csv,2011,0.0,1.0
2819,I Married an Anti-Fan,12194083,89408,12104675,2016.csv,2016,0.007332080649278835,0.9926679193507212
2820,Way Back Home 2013 Re-release,12184128,0,12184128,2013.csv,2013,0.0,1.0
2821,Zarafa,12168769,0,12168769,2012.csv,2012,0.0,1.0
2822,Little Women,12165890,1379497,10786393,2018.csv,2018,0.11339055342436928,0.8866094465756307
2823,Satyagraha,12161138,0,12161138,2011.csv,2011,0.0,1.0
2824,Ducobu 3,12157793,0,12157793,2020.csv,2020,0.0,1.0
2825,Miss & Mrs. Cops,12147170,104578,12042592,2019.csv,2019,0.008609248080005466,0.9913907519199945
2826,Bachelorette,12128575,447954,11680621,2012.csv,2012,0.03693377004305947,0.9630662299569406
2827,Chihayafuru Part I,12116649,0,12116649,2016.csv,2016,0.0,1.0
2828,Barney's Version,12104765,4439201,7665564,2011.csv,2011,0.3667316961543657,0.6332683038456344
2829,Crystal Skies of Yesterday,12104346,0,12104346,2018.csv,2018,0.0,1.0
2830,Frau Ella,12080943,0,12080943,2013.csv,2013,0.0,1.0
2831,Stoker,12077441,1714221,10363220,2012.csv,2012,0.14193577927642123,0.8580642207235788
2832,The Connection,12062441,190980,11871461,2014.csv,2014,0.01583261630046522,0.9841673836995348
2833,The Bookshop,12055868,1588150,10467718,2017.csv,2017,0.13173253058178805,0.868267469418212
2834,Tamara Drewe,12037973,560391,11477582,2010.csv,2010,0.04655194026436178,0.9534480597356382
2835,Night Train to Lisbon,12020387,0,12020387,2013.csv,2013,0.0,1.0
2836,I Am Love,12014663,5005465,7009198,2010.csv,2010,0.4166130169443787,0.5833869830556213
2837,A Most Violent Year,12007070,5749134,6257936,2014.csv,2014,0.47881239969451334,0.5211876003054867
2838,Kamen Rider Wizard in Magic Land,12003461,0,12003461,2013.csv,2013,0.0,1.0
2839,The Assassin,11991669,632542,11359127,2015.csv,2015,0.052748453947486375,0.9472515460525136
2840,Eine ganz heiße Nummer,11989112,0,11989112,2011.csv,2011,0.0,1.0
2841,Mere Brother Ki Dulhan,11983381,496172,11487209,2011.csv,2011,0.041405009153927426,0.9585949908460726
2842,Outrage Coda,11983269,0,11983269,2017.csv,2017,0.0,1.0
2843,Carrossel 2: O Sumiço de Maria Joaquina,11972853,0,11972853,2016.csv,2016,0.0,1.0
2844,City Hunter: Shinjuku Private Eyes,11962753,0,11962753,2019.csv,2019,0.0,1.0
2845,Stefan v/s Kramer,11959834,0,11959834,2012.csv,2012,0.0,1.0
2846,Bogowie,11953322,0,11953322,2014.csv,2014,0.0,1.0
2847,12 Suicidal Teens,11950916,0,11950916,2019.csv,2019,0.0,1.0
2848,Mirreyes contra Godinez,11940579,0,11940579,2019.csv,2019,0.0,1.0
2849,The King's Avatar: For the Glory,11933801,0,11933801,2019.csv,2019,0.0,1.0
2850,This Must Be the Place,11928909,143979,11784930,2011.csv,2011,0.012069754241565594,0.9879302457584344
2851,The Guardian Brothers,11902156,0,11902156,2015.csv,2015,0.0,1.0
2852,Blitz,11895069,0,11895069,2011.csv,2011,0.0,1.0
2853,Kano,11890062,0,11890062,2014.csv,2014,0.0,1.0
2854,The Warring States,11868961,68961,11800000,2011.csv,2011,0.005810196865589161,0.9941898031344109
2855,Viceroy's House,11868221,1105717,10762504,2017.csv,2017,0.09316619567498785,0.9068338043250121
2856,Baadshaho,11859437,0,11859437,2017.csv,2017,0.0,1.0
2857,Balloon,11859396,34222,11825174,2018.csv,2018,0.0028856444291092058,0.9971143555708908
2858,Boy Erased,11853081,6788692,5064389,2018.csv,2018,0.5727364893566491,0.4272635106433509
2859,¡Asu Mare!,11852786,0,11852786,2013.csv,2013,0.0,1.0
2860,Precure All Stars New Stage Movie: Friends of the Future,11848319,0,11848319,2012.csv,2012,0.0,1.0
2861,Un fantastico via vai,11846676,0,11846676,2013.csv,2013,0.0,1.0
2862,Unstoppable,11845347,101417,11743930,2018.csv,2018,0.008561758469380424,0.9914382415306195
2863,Kites,11844500,1643486,10201014,2010.csv,2010,0.13875520283675968,0.8612447971632403
2864,Berlin Kaplani,11842023,0,11842023,2012.csv,2012,0.0,1.0
2865,Wo zhi nv ren xin,11838177,123526,11714651,2011.csv,2011,0.010434545791974559,0.9895654542080254
2866,Last Letter,11834622,180946,11653676,2018.csv,2018,0.015289546214488303,0.9847104537855117
2867,Cinderella and the Secret Prince,11833683,0,11833683,2018.csv,2018,0.0,1.0
2868,Promising Young Woman,11818580,6194580,5624000,2020.csv,2020,0.5241391097746091,0.47586089022539085
2869,Ash Is Purest White,11813509,422814,11390695,2018.csv,2018,0.03579072060638376,0.9642092793936162
2870,Legend No. 17,11811335,0,11811335,2020.csv,2020,0.0,1.0
2871,Roco Kingdom 4: Go! Valley of the Giants,11810000,0,11810000,2015.csv,2015,0.0,1.0
2872,Getaway,11806432,10501938,1304494,2013.csv,2013,0.8895098874918349,0.11049011250816504
2873,The Divine Fury,11799556,102982,11696574,2019.csv,2019,0.0087276165306559,0.9912723834693441
2874,Jannat 2,11798448,0,11798448,2012.csv,2012,0.0,1.0
2875,As One,11794204,0,11794204,2012.csv,2012,0.0,1.0
2876,Win Win,11789613,10179275,1610338,2011.csv,2011,0.8634104444310429,0.1365895555689572
2877,Toni Erdmann,11784207,1479387,10304820,2016.csv,2016,0.12553980085380373,0.8744601991461962
2878,Up in the Wind,11783108,0,11783108,2014.csv,2014,0.0,1.0
2879,The Interview,11782625,6105175,5677450,2014.csv,2014,0.5181506667656826,0.4818493332343175
2880,The Man Cave,11774200,0,11774200,2014.csv,2014,0.0,1.0
2881,Museum,11757642,0,11757642,2016.csv,2016,0.0,1.0
2882,Ryuzo and the Seven Henchmen,11757243,0,11757243,2015.csv,2015,0.0,1.0
2883,C'est Si Bon,11750035,164167,11585868,2015.csv,2015,0.013971617956882681,0.9860283820431173
2884,There's No Place Like Home,11740817,0,11740817,2018.csv,2018,0.0,1.0
2885,I Love Wolffy 2,11730000,0,11730000,2013.csv,2013,0.0,1.0
2886,Lion's Heart,11719123,0,11719123,2013.csv,2013,0.0,1.0
2887,The Seventh Dwarf,11703629,0,11703629,2014.csv,2014,0.0,1.0
2888,Wotakoi: Love Is Hard for Otaku,11702371,0,11702371,2020.csv,2020,0.0,1.0
2889,Tik Tok,11702016,0,11702016,2016.csv,2016,0.0,1.0
2890,Padre no hay más que uno 2: La llegada de la suegra,11700000,0,11700000,2020.csv,2020,0.0,1.0
2891,Fighting,11690000,0,11690000,2014.csv,2014,0.0,1.0
2892,Seeking a Friend for the End of the World,11681781,7078738,4603043,2012.csv,2012,0.6059639364922181,0.3940360635077819
2893,I 2 soliti idioti,11676024,0,11676024,2012.csv,2012,0.0,1.0
2894,My Brilliant Life,11670114,0,11670114,2014.csv,2014,0.0,1.0
2895,Eiga Purikyua ôru sutâzu DX 2: Kibou no hikari Reinbô jueru o mamore!,11653289,0,11653289,2010.csv,2010,0.0,1.0
2896,Big Is Beautiful,11646824,0,11646824,2012.csv,2012,0.0,1.0
2897,Bring the Soul: The Movie,11641119,4809800,6831319,2019.csv,2019,0.41317333840501075,0.5868266615949893
2898,Erased,11636849,0,11636849,2016.csv,2016,0.0,1.0
2899,Back to Burgundy,11625884,257610,11368274,2017.csv,2017,0.02215831501501305,0.9778416849849869
2900,The Lunchbox 2013 Re-release,11621581,4235151,7386430,2013.csv,2013,0.36442124354681177,0.6355787564531883
2901,Federal Bank Heist,11618444,0,11618444,2011.csv,2011,0.0,1.0
2902,"Fala Sério, Mãe!",11616161,0,11616161,2017.csv,2017,0.0,1.0
2903,"Uta no Prince Sama Maji Love Kingdom, The Movie",11597863,0,11597863,2019.csv,2019,0.0,1.0
2904,Delicacy,11597420,498584,11098836,2011.csv,2011,0.042990941088621434,0.9570090589113786
2905,Mary Magdalene,11585369,0,11585369,2018.csv,2018,0.0,1.0
2906,Winx Club 3D: Magical Adventure,11583758,0,11583758,2010.csv,2010,0.0,1.0
2907,Fisherman's Friends,11576847,0,11576847,2019.csv,2019,0.0,1.0
2908,Kung Fu Monster,11576368,0,11576368,2018.csv,2018,0.0,1.0
2909,Department Q: The Absent One,11536119,0,11536119,2014.csv,2014,0.0,1.0
2910,L'ora legale,11514055,0,11514055,2017.csv,2017,0.0,1.0
2911,Haute Cuisine,11509942,217883,11292059,2012.csv,2012,0.01892998244474212,0.9810700175552579
2912,Buried Secrets,11500000,0,11500000,2010.csv,2010,0.0,1.0
2913,Yolki poslednie,11498365,0,11498365,2018.csv,2018,0.0,1.0
2914,For Love,11487632,0,11487632,2016.csv,2016,0.0,1.0
2915,Fists of Legend,11478881,134213,11344668,2013.csv,2013,0.011692167555356658,0.9883078324446434
2916,The Hunt,11472187,5812500,5659687,2020.csv,2020,0.5066601511987209,0.4933398488012791
2917,Escort in Love,11471250,0,11471250,2011.csv,2011,0.0,1.0
2918,50 First Kisses,11465365,0,11465365,2018.csv,2018,0.0,1.0
2919,Golden Slumber,11458607,0,11458607,2010.csv,2010,0.0,1.0
2920,Genitori & figli:) - Agitare bene prima dell'uso,11455266,0,11455266,2010.csv,2010,0.0,1.0
2921,Double Dhamaal,11445869,543646,10902223,2011.csv,2011,0.0474971363030627,0.9525028636969373
2922,Your Lie in April,11444510,0,11444510,2016.csv,2016,0.0,1.0
2923,Off Course,11438207,0,11438207,2015.csv,2015,0.0,1.0
2924,Trumbo,11430025,7857741,3572284,2015.csv,2015,0.6874649005579603,0.3125350994420397
2925,Pyungyangsung,11427627,0,11427627,2011.csv,2011,0.0,1.0
2926,Seasons,11425100,150092,11275008,2016.csv,2016,0.013137040376014214,0.9868629596239857
2927,Tutto tutto niente niente,11420371,0,11420371,2012.csv,2012,0.0,1.0
2928,Sea Fog,11418310,0,11418310,2014.csv,2014,0.0,1.0
2929,Fun Size,11417362,9409538,2007824,2012.csv,2012,0.8241429149745799,0.17585708502542005
2930,Yolki 1914,11409949,0,11409949,2014.csv,2014,0.0,1.0
2931,Union of Salvation,11401318,0,11401318,2019.csv,2019,0.0,1.0
2932,A Flat for Three,11398541,0,11398541,2012.csv,2012,0.0,1.0
2933,The King's Case Note,11383493,90959,11292534,2017.csv,2017,0.007990429651074587,0.9920095703489255
2934,The Mountain II,11378898,0,11378898,2016.csv,2016,0.0,1.0
2935,Door Lock,11376878,0,11376878,2018.csv,2018,0.0,1.0
2936,Like a Cat on a Highway,11369741,0,11369741,2017.csv,2017,0.0,1.0
2937,King of Thieves,11353515,7518,11345997,2018.csv,2018,0.0006621737849467764,0.9993378262150532
2938,Love Fiction,11352431,0,11352431,2012.csv,2012,0.0,1.0
2939,Bajirao Mastani,11350917,6557047,4793870,2015.csv,2015,0.577666720671114,0.4223332793288859
2940,The Apparition,11350665,4936819,6413846,2012.csv,2012,0.4349365433655209,0.5650634566344791
2941,Snow Flower and the Secret Fan,11348205,1348205,10000000,2011.csv,2011,0.11880337022463024,0.8811966297753697
2942,All That Glitters,11345366,0,11345366,2010.csv,2010,0.0,1.0
2943,One Step Away,11320000,0,11320000,2014.csv,2014,0.0,1.0
2944,"It's Not You, It's Me",11301956,1339911,9962045,2010.csv,2010,0.11855567301801564,0.8814443269819844
2945,Di san zhong ai qing,11299163,0,11299163,2015.csv,2015,0.0,1.0
2946,Sorry If I Want to Marry You,11285031,0,11285031,2010.csv,2010,0.0,1.0
2947,"Nativity 3: Dude, Where's My Donkey?!",11283866,0,11283866,2014.csv,2014,0.0,1.0
2948,Tomorrow,11277905,62510,11215395,2015.csv,2015,0.00554269609470908,0.994457303905291
2949,At Eternity's Gate,11235662,2294915,8940747,2018.csv,2018,0.20425276232054684,0.7957472376794531
2950,Rudhramadevi,11229399,0,11229399,2015.csv,2015,0.0,1.0
2951,Kiseki: Sobito of That Day,11185497,0,11185497,2017.csv,2017,0.0,1.0
2952,Straw Dogs,11168712,10324441,844271,2010.csv,2010,0.9244074876315191,0.0755925123684808
2953,Ida,11156836,3827060,7329776,2013.csv,2013,0.343023774840824,0.656976225159176
2954,Takers 2010 Re-release,11149687,0,11149687,2010.csv,2010,0.0,1.0
2955,Gloria Bell,11145006,5611123,5533883,2019.csv,2019,0.5034652291797779,0.49653477082022207
2956,The Tiger,11132086,0,11132086,2015.csv,2015,0.0,1.0
2957,Bicycling with Molière,11123929,59874,11064055,2013.csv,2013,0.0053824507509891515,0.9946175492490108
2958,We Are Your Friends,11122090,3591417,7530673,2015.csv,2015,0.32290846414657676,0.6770915358534232
2959,Welcome Mr. President,11115274,0,11115274,2013.csv,2013,0.0,1.0
2960,Dragon Quest: Your Story,11114288,0,11114288,2019.csv,2019,0.0,1.0
2961,The Adventure of Afanti,11113411,0,11113411,2018.csv,2018,0.0,1.0
2962,Conviction 2010 Re-release,11104555,6783129,4321426,2010.csv,2010,0.6108420373441349,0.3891579626558651
2963,The Warrior's Way,11103434,5666340,5437094,2010.csv,2010,0.510323202713683,0.489676797286317
2964,Chuchangmin,11102663,0,11102663,2011.csv,2011,0.0,1.0
2965,The Belko Experiment,11084630,10166820,917810,2017.csv,2017,0.9171997621932352,0.08280023780676486
2966,77 Heartbreaks,11077852,0,11077852,2017.csv,2017,0.0,1.0
2967,Action Jackson,11060963,256872,10804091,2014.csv,2014,0.023223294391274973,0.976776705608725
2968,Jilla,11050289,0,11050289,2014.csv,2014,0.0,1.0
2969,Horrid Henry: The Movie,11045966,0,11045966,2011.csv,2011,0.0,1.0
2970,The Vanished Murderer,11040802,0,11040802,2015.csv,2015,0.0,1.0
2971,Promised Land,11039031,7597898,3441133,2012.csv,2012,0.6882758097155448,0.3117241902844552
2972,Battle of Xiangjiang River,11037772,0,11037772,2017.csv,2017,0.0,1.0
2973,Chto tvoryat muzhchiny!,11028171,0,11028171,2013.csv,2013,0.0,1.0
2974,The Butterfly's Dream,11028096,0,11028096,2013.csv,2013,0.0,1.0
2975,Last Night,11027222,99000,10928222,2010.csv,2010,0.008977782436954657,0.9910222175630453
2976,"Where'd You Go, Bernadette",11025353,9198356,1826997,2019.csv,2019,0.8342912920792649,0.16570870792073505
2977,La boda de Valentina,11021794,2783739,8238055,2018.csv,2018,0.2525667781488204,0.7474332218511796
2978,The Loft,11016443,6002684,5013759,2014.csv,2014,0.5448840428802655,0.45511595711973457
2979,Traffickers,11004374,0,11004374,2012.csv,2012,0.0,1.0
2980,Gringo,11001627,4969853,6031774,2018.csv,2018,0.4517380020246096,0.5482619979753903
2981,I Am Losing Weight,10999346,0,10999346,2018.csv,2018,0.0,1.0
2982,[REC] 3: Genesis,10998667,9600,10989067,2012.csv,2012,0.0008728330442225408,0.9991271669557774
2983,Invisibles,10993752,0,10993752,2019.csv,2019,0.0,1.0
2984,Nova Zembla,10987361,0,10987361,2011.csv,2011,0.0,1.0
2985,The Voice of Sin,10983063,0,10983063,2020.csv,2020,0.0,1.0
2986,The Leakers,10982231,0,10982231,2018.csv,2018,0.0,1.0
2987,Hyde Park on Hudson,10980481,6376145,4604336,2012.csv,2012,0.5806799356057353,0.41932006439426467
2988,Justin Bieber's Believe,10980157,6206566,4773591,2013.csv,2013,0.5652529376401448,0.43474706235985516
2989,Animal Crackers,10979164,0,10979164,2018.csv,2018,0.0,1.0
2990,Friend Request,10975390,3759078,7216312,2016.csv,2016,0.3425006309570776,0.6574993690429224
2991,Deep,10972294,0,10972294,2017.csv,2017,0.0,1.0
2992,The Florida Project,10971298,5904366,5066932,2017.csv,2017,0.538164764096281,0.46183523590371894
2993,Fake Fiction,10970000,0,10970000,2013.csv,2013,0.0,1.0
2994,Le brio,10968212,0,10968212,2017.csv,2017,0.0,1.0
2995,The Best Movie 3-DE,10959765,0,10959765,2011.csv,2011,0.0,1.0
2996,High & Low: The Movie 2 - End of Sky,10956658,0,10956658,2017.csv,2017,0.0,1.0
2997,Happy Little Submarine: 20000 Leagues under the Sea,10949902,0,10949902,2018.csv,2018,0.0,1.0
2998,Laplace's Witch,10919843,0,10919843,2018.csv,2018,0.0,1.0
2999,Chinese Take-Out,10911008,0,10911008,2011.csv,2011,0.0,1.0
3000,Jonah Hex,10903312,10547117,356195,2010.csv,2010,0.9673314860658853,0.0326685139341147
3001,Samyy luchshiy den!,10903254,0,10903254,2015.csv,2015,0.0,1.0
3002,A Natale mi sposo,10902369,0,10902369,2010.csv,2010,0.0,1.0
3003,One Chance,10900434,101196,10799238,2013.csv,2013,0.009283667053990695,0.9907163329460094
3004,The Italian,10899518,0,10899518,2010.csv,2010,0.0,1.0
3005,A Bag of Marbles,10898998,411318,10487680,2017.csv,2017,0.037739065554466565,0.9622609344455334
3006,The Darkness,10898293,10753574,144719,2016.csv,2016,0.9867209479502891,0.013279052049710905
3007,It's for Your Own Good,10873271,0,10873271,2017.csv,2017,0.0,1.0
3008,Tinker Bell and the Great Fairy Rescue,10872752,0,10872752,2010.csv,2010,0.0,1.0
3009,Eiga Suîto Purikyua: Torimodose! Kokoro ga tsunagu kiseki no merodi,10871826,0,10871826,2011.csv,2011,0.0,1.0
3010,Eiga Purikyua ôru sutâzu DX 3: Mirai ni todoke! Sekai o tsunagu nijiiro no hana,10866071,0,10866071,2011.csv,2011,0.0,1.0
3011,Only You,10857889,61565,10796324,2015.csv,2015,0.005670070858156682,0.9943299291418434
3012,Mao Fengmei 2016 Re-release,10854121,0,10854121,2016.csv,2016,0.0,1.0
3013,Mr Black: Green Star,10849131,0,10849131,2015.csv,2015,0.0,1.0
3014,Bis,10846026,0,10846026,2015.csv,2015,0.0,1.0
3015,Vai que Cola: O Filme,10845468,0,10845468,2015.csv,2015,0.0,1.0
3016,Violet Evergarden: Eternity and the Auto Memories Doll,10841702,0,10841702,2019.csv,2019,0.0,1.0
3017,Danny Collins,10835752,5637066,5198686,2015.csv,2015,0.5202284068516887,0.47977159314831125
3018,Maya the Bee: The Honey Games,10824302,0,10824302,2018.csv,2018,0.0,1.0
3019,Le crocodile du Botswanga,10820100,0,10820100,2014.csv,2014,0.0,1.0
3020,Sayonara itsuka,10817922,0,10817922,2010.csv,2010,0.0,1.0
3021,Flying Monsters 3D with David Attenborough,10813862,5705874,5107988,2011.csv,2011,0.5276444252756324,0.4723555747243677
3022,¡Asu Mare! 2,10785879,0,10785879,2015.csv,2015,0.0,1.0
3023,Me contro Te - Il film: La vendetta del Signor S,10779891,0,10779891,2020.csv,2020,0.0,1.0
3024,The Bros,10776902,0,10776902,2017.csv,2017,0.0,1.0
3025,Ninja Kids!!!,10776262,0,10776262,2011.csv,2011,0.0,1.0
3026,Coming Soon,10769798,0,10769798,2014.csv,2014,0.0,1.0
3027,Ten Days Without Mom,10769678,0,10769678,2017.csv,2017,0.0,1.0
3028,Gokaiger Goseiger Super Sentai 199 Hero Great Battle,10758185,0,10758185,2011.csv,2011,0.0,1.0
3029,A Matchless Man,10751422,0,10751422,2010.csv,2010,0.0,1.0
3030,Ajin: Demi-Human,10750712,0,10750712,2017.csv,2017,0.0,1.0
3031,Mr. Happiness,10748185,0,10748185,2016.csv,2016,0.0,1.0
3032,Tutta colpa di Freud,10736157,0,10736157,2014.csv,2014,0.0,1.0
3033,Golden Slumber,10733326,94450,10638876,2018.csv,2018,0.008799695453208073,0.991200304546792
3034,A Stroke of Luck,10730040,0,10730040,2016.csv,2016,0.0,1.0
3035,What a Wonderful Family!,10728188,0,10728188,2016.csv,2016,0.0,1.0
3036,Obsessed,10721585,0,10721585,2014.csv,2014,0.0,1.0
3037,Galapagos 2016 Re-release,10718800,0,10718800,2016.csv,2016,0.0,1.0
3038,What We Did on Our Holiday,10714112,0,10714112,2014.csv,2014,0.0,1.0
3039,Our Kind of Traitor,10711027,3153157,7557870,2016.csv,2016,0.2943841893032293,0.7056158106967707
3040,Prom,10702246,10130219,572027,2011.csv,2011,0.9465507520570916,0.05344924794290843
3041,Mortal Kombat,10700000,0,10700000,2021.csv,2021,0.0,1.0
3042,HeartCatch PreCure the Movie: Fashion Show in the Flower Capital... Really?!,10695038,0,10695038,2010.csv,2010,0.0,1.0
3043,Impractical Jokers: The Movie,10691091,10691091,0,2020.csv,2020,1.0,0.0
3044,Inseparable Bros,10682665,0,10682665,2019.csv,2019,0.0,1.0
3045,The Mole Song: Hong Kong Capriccio,10677009,0,10677009,2016.csv,2016,0.0,1.0
3046,Buddha Mountain,10673606,0,10673606,2011.csv,2011,0.0,1.0
3047,Shinjuku Swan,10662923,0,10662923,2015.csv,2015,0.0,1.0
3048,High Society,10659805,0,10659805,2017.csv,2017,0.0,1.0
3049,I Fine..Thank You Love You,10657812,0,10657812,2014.csv,2014,0.0,1.0
3050,The Sessions,10656155,6002451,4653704,2012.csv,2012,0.563284880897472,0.4367151191025281
3051,Red Joan,10647493,1579730,9067763,2018.csv,2018,0.14836638070576802,0.851633619294232
3052,A Bolt from the Blue,10645439,0,10645439,2014.csv,2014,0.0,1.0
3053,Hot Young Bloods,10644513,0,10644513,2014.csv,2014,0.0,1.0
3054,Wolf Girl and Black Prince,10639039,0,10639039,2016.csv,2016,0.0,1.0
3055,Only God Forgives,10635126,779188,9855938,2013.csv,2013,0.07326551655335348,0.9267344834466466
3056,Shinchan: Crash! Scribble Kingdom and Almost Four Heroes,10628463,0,10628463,2020.csv,2020,0.0,1.0
3057,My Old Lady,10606667,4013786,6592881,2014.csv,2014,0.37842104404710736,0.6215789559528927
3058,Polityka,10602835,0,10602835,2019.csv,2019,0.0,1.0
3059,One Second,10600000,0,10600000,2020.csv,2020,0.0,1.0
3060,Honest Candidate,10597464,0,10597464,2020.csv,2020,0.0,1.0
3061,Blessed Madness,10588217,0,10588217,2018.csv,2018,0.0,1.0
3062,Coin Locker Girl,10582907,0,10582907,2015.csv,2015,0.0,1.0
3063,LOL,10578643,0,10578643,2012.csv,2012,0.0,1.0
3064,Drucker in the Dugout,10569460,0,10569460,2011.csv,2011,0.0,1.0
3065,Gentlemen of Fortune,10560943,0,10560943,2012.csv,2012,0.0,1.0
3066,Precure All Stars New Stage 2,10560526,0,10560526,2013.csv,2013,0.0,1.0
3067,The Phone,10551318,40516,10510802,2015.csv,2015,0.0038398994324690054,0.996160100567531
3068,Roco Kingdom: The Desire of Dragon,10550000,0,10550000,2013.csv,2013,0.0,1.0
3069,Moms' Night Out,10536956,10429707,107249,2014.csv,2014,0.9898216334964292,0.01017836650357086
3070,Thread of Lies,10522797,0,10522797,2014.csv,2014,0.0,1.0
3071,Get Low,10522511,9176933,1345578,2010.csv,2010,0.8721238685329006,0.12787613146709945
3072,Black Widow Business,10504345,0,10504345,2016.csv,2016,0.0,1.0
3073,Até Que a Sorte nos Separe 3: A Falência Final,10502937,0,10502937,2015.csv,2015,0.0,1.0
3074,Wetlands,10501000,0,10501000,2013.csv,2013,0.0,1.0
3075,I Am Dragon,10495305,0,10495305,2015.csv,2015,0.0,1.0
3076,The Little House,10488932,0,10488932,2014.csv,2014,0.0,1.0
3077,Jo's Boy,10479322,0,10479322,2011.csv,2011,0.0,1.0
3078,The Leisure Seeker,10472180,3226443,7245737,2017.csv,2017,0.308096594978314,0.691903405021686
3079,The Hole,10457002,0,10457002,2010.csv,2010,0.0,1.0
3080,"Och, Karol 2",10455379,0,10455379,2011.csv,2011,0.0,1.0
3081,Gintama: The Movie,10453259,0,10453259,2010.csv,2010,0.0,1.0
3082,No Longer Human,10452114,0,10452114,2019.csv,2019,0.0,1.0
3083,Let Him Go,10448550,9358025,1090525,2020.csv,2020,0.895629058577506,0.10437094142249403
3084,Krack,10442916,0,10442916,2021.csv,2021,0.0,1.0
3085,Mood Indigo,10435322,303187,10132135,2013.csv,2013,0.029053918987837653,0.9709460810121624
3086,Furious,10433259,9996,10423263,2017.csv,2017,0.0009580898931005164,0.9990419101068995
3087,Every Day,10421847,6102076,4319771,2018.csv,2018,0.5855081157879213,0.4144918842120787
3088,Initiation Love,10416510,0,10416510,2015.csv,2015,0.0,1.0
3089,My Paparotti,10416126,0,10416126,2013.csv,2013,0.0,1.0
3090,The Black Devil and the White Prince,10415892,0,10415892,2016.csv,2016,0.0,1.0
3091,The Perfect Match,10414738,9669521,745217,2016.csv,2016,0.9284459196189093,0.07155408038109072
3092,Casino Royale 2019 Re-release,10402035,0,10402035,2019.csv,2019,0.0,1.0
3093,Swing Kids,10397408,222001,10175407,2018.csv,2018,0.0213515714685814,0.9786484285314186
3094,Minari,10391772,2151855,8239917,2021.csv,2021,0.20707296118506063,0.7929270388149393
3095,Eiga Sumairu Purikyua!: Ehon no naka wa minna chiguhagu!,10379456,0,10379456,2012.csv,2012,0.0,1.0
3096,Gnome Alone,10373182,0,10373182,2017.csv,2017,0.0,1.0
3097,Lobster Cop,10373129,85693,10287436,2018.csv,2018,0.008261056042010082,0.9917389439579899
3098,Howling,10368295,0,10368295,2012.csv,2012,0.0,1.0
3099,Queen of Katwe,10367161,8874389,1492772,2016.csv,2016,0.8560095671322168,0.14399043286778318
3100,Rzhevskiy protiv Napoleona,10365684,0,10365684,2012.csv,2012,0.0,1.0
3101,Fünf Freunde 3,10362820,0,10362820,2014.csv,2014,0.0,1.0
3102,Möbius,10357345,0,10357345,2013.csv,2013,0.0,1.0
3103,Tot eshchyo Karloson!,10353078,0,10353078,2012.csv,2012,0.0,1.0
3104,Street Dancer 3D,10339127,0,10339127,2020.csv,2020,0.0,1.0
3105,Main Tera Hero,10338463,274579,10063884,2014.csv,2014,0.026558976900144634,0.9734410230998554
3106,Yo-kai Watch: Forever Friends,10336365,0,10336365,2018.csv,2018,0.0,1.0
3107,Money Trap,10327763,0,10327763,2019.csv,2019,0.0,1.0
3108,25 km/h,10323404,0,10323404,2018.csv,2018,0.0,1.0
3109,Crows Explode,10315875,0,10315875,2014.csv,2014,0.0,1.0
3110,Hide and Seek,10315084,0,10315084,2016.csv,2016,0.0,1.0
3111,Kin,10313019,5718096,4594923,2018.csv,2018,0.5544541321993104,0.4455458678006896
3112,The Babadook,10312540,964413,9348127,2014.csv,2014,0.09351847362531442,0.9064815263746856
3113,Meitantei Conan: Hiiro no fuzai shômei,10308627,0,10308627,2021.csv,2021,0.0,1.0
3114,3-D Sex and Zen: Extreme Ecstasy,10306807,153215,10153592,2011.csv,2011,0.014865418553000944,0.9851345814469991
3115,Stone,10300416,1810078,8490338,2010.csv,2010,0.17572863076598072,0.8242713692340193
3116,English Vinglish,10299150,1862086,8437064,2012.csv,2012,0.18079996892947475,0.8192000310705252
3117,Star Watching Dog,10298964,0,10298964,2011.csv,2011,0.0,1.0
3118,Galaxy Kaidô,10291672,0,10291672,2015.csv,2015,0.0,1.0
3119,Kamen Rider Heisei Generations Final: Build & Ex-Aid with Legend Riders,10289397,0,10289397,2017.csv,2017,0.0,1.0
3120,If Cats Disappeared from the World,10284664,0,10284664,2016.csv,2016,0.0,1.0
3121,Crazy New Year's Eve,10280378,0,10280378,2015.csv,2015,0.0,1.0
3122,The Worst Christmas of My Life,10275097,0,10275097,2012.csv,2012,0.0,1.0
3123,Girls vs Gangsters,10265819,37115,10228704,2018.csv,2018,0.0036153959075257416,0.9963846040924743
3124,Cape Nostalgia,10258016,0,10258016,2014.csv,2014,0.0,1.0
3125,Les Lyonnais,10249599,0,10249599,2011.csv,2011,0.0,1.0
3126,Prophecy,10238535,0,10238535,2015.csv,2015,0.0,1.0
3127,Wished,10238078,0,10238078,2017.csv,2017,0.0,1.0
3128,Chennai Express,10234653,5307960,4926693,2013.csv,2013,0.5186262787805312,0.4813737212194688
3129,The Miracle Season,10230620,10230620,0,2018.csv,2018,1.0,0.0
3130,Anohana: The Flower We Saw That Day,10219593,0,10219593,2013.csv,2013,0.0,1.0
3131,I Love Hong Kong,10219319,0,10219319,2011.csv,2011,0.0,1.0
3132,Babies,10219306,7320323,2898983,2010.csv,2010,0.7163229088159215,0.28367709118407847
3133,The Brink,10217493,0,10217493,2017.csv,2017,0.0,1.0
3134,The Best of Enemies,10209813,10205616,4197,2019.csv,2019,0.9995889248902012,0.0004110751097987789
3135,Gambit,10200000,0,10200000,2012.csv,2012,0.0,1.0
3136,My Spy,10200000,0,10200000,2020.csv,2020,0.0,1.0
3137,Peter Rabbit 2,10200000,0,10200000,2021.csv,2021,0.0,1.0
3138,Meu Passado Me Condena 2: O Filme,10198232,0,10198232,2015.csv,2015,0.0,1.0
3139,Senna,10197661,1612430,8585231,2010.csv,2010,0.15811763109207103,0.841882368907929
3140,BTS World Tour: Love Yourself in Seoul,10195760,3509917,6685843,2019.csv,2019,0.34425261088923237,0.6557473891107676
3141,Perfect Number,10187540,0,10187540,2012.csv,2012,0.0,1.0
3142,Indovina chi viene a Natale?,10181248,0,10181248,2013.csv,2013,0.0,1.0
3143,For Greater Glory: The True Story of Cristiada,10173682,5672846,4500836,2012.csv,2012,0.557600090114867,0.44239990988513306
3144,Klassentreffen 1.0,10166333,0,10166333,2018.csv,2018,0.0,1.0
3145,Café Funiculi Funicula,10164971,0,10164971,2018.csv,2018,0.0,1.0
3146,7th Floor,10151069,0,10151069,2013.csv,2013,0.0,1.0
3147,Women in Temptation,10140804,0,10140804,2010.csv,2010,0.0,1.0
3148,Ben Is Back,10134204,3703184,6431020,2018.csv,2018,0.36541439268441805,0.634585607315582
3149,Mr. and Mrs. Incredible,10131360,0,10131360,2011.csv,2011,0.0,1.0
3150,My SO Has Got Depression,10127426,0,10127426,2011.csv,2011,0.0,1.0
3151,"Tonight, at the Movies",10122115,0,10122115,2018.csv,2018,0.0,1.0
3152,Trespass,10117966,24094,10093872,2011.csv,2011,0.00238130865432835,0.9976186913456716
3153,Marshall,10116816,10051659,65157,2017.csv,2017,0.9935595349366836,0.006440465063316364
3154,Iron Sky,10109659,122082,9987577,2012.csv,2012,0.012075778223578065,0.9879242217764219
3155,Gone with the Light,10102949,0,10102949,2019.csv,2019,0.0,1.0
3156,Bibi & Tina: Perfect Pandemonium,10097791,0,10097791,2017.csv,2017,0.0,1.0
3157,Bernie,10090641,9206470,884171,2012.csv,2012,0.9123771225237326,0.08762287747626736
3158,Oddball,10089011,0,10089011,2015.csv,2015,0.0,1.0
3159,A Little Chaos,10084623,558173,9526450,2015.csv,2015,0.05534892082728328,0.9446510791727167
3160,The Vanished,10083104,0,10083104,2018.csv,2018,0.0,1.0
3161,Aile Arasinda,10081222,0,10081222,2017.csv,2017,0.0,1.0
3162,Gladiators of Rome,10079201,8201,10071000,2012.csv,2012,0.000813655764975815,0.9991863442350242
3163,A Better Tomorrow 2018,10067151,0,10067151,2018.csv,2018,0.0,1.0
3164,The Asadas,10066797,0,10066797,2020.csv,2020,0.0,1.0
3165,The Snow Queen: Mirrorlands,10063871,0,10063871,2018.csv,2018,0.0,1.0
3166,Papillon,10060903,2335896,7725007,2018.csv,2018,0.23217558105867833,0.7678244189413217
3167,August. Eighth,10060072,0,10060072,2012.csv,2012,0.0,1.0
3168,Leberkäsjunkie,10057790,0,10057790,2019.csv,2019,0.0,1.0
3169,Say 'I Love You',10047557,0,10047557,2014.csv,2014,0.0,1.0
3170,Portrait of a Lady on Fire,10043341,3759854,6283487,2019.csv,2019,0.3743628738683671,0.6256371261316329
3171,Ivan Tsarevich i Seryy Volk 3,10033929,0,10033929,2016.csv,2016,0.0,1.0
3172,The Emperor in August,10032914,0,10032914,2015.csv,2015,0.0,1.0
3173,O Candidato Honesto,10021790,0,10021790,2014.csv,2014,0.0,1.0
3174,The King's Choice,10017316,113231,9904085,2016.csv,2016,0.01130352681297066,0.9886964731870294
3175,Yell for the Blue Sky,10017253,0,10017253,2016.csv,2016,0.0,1.0
3176,Mozu the Movie,9998652,0,9998652,2015.csv,2015,0.0,1.0
3177,Thank You for Your Service,9995692,9536300,459392,2017.csv,2017,0.9540410008631719,0.045958999136828146
3178,The Healer,9979800,0,9979800,2017.csv,2017,0.0,1.0
3179,Alan Partridge,9979601,153426,9826175,2013.csv,2013,0.015373961343745106,0.9846260386562549
3180,Vive la France,9979302,0,9979302,2013.csv,2013,0.0,1.0
3181,The Horse Trader,9970000,0,9970000,2014.csv,2014,0.0,1.0
3182,Forgotten,9968972,0,9968972,2017.csv,2017,0.0,1.0
3183,For Love or Money,9960000,0,9960000,2014.csv,2014,0.0,1.0
3184,I Married a Dumbass,9958164,0,9958164,2016.csv,2016,0.0,1.0
3185,Every Day a Good Day,9956464,0,9956464,2018.csv,2018,0.0,1.0
3186,Detective Conan: The Darkest Nightmare,9953934,0,9953934,2016.csv,2016,0.0,1.0
3187,Our Shining Days,9949926,0,9949926,2017.csv,2017,0.0,1.0
3188,Little Forest,9942250,0,9942250,2018.csv,2018,0.0,1.0
3189,StreetDance 3D,9941976,0,9941976,2010.csv,2010,0.0,1.0
3190,Cyrus,9933873,7468936,2464937,2010.csv,2010,0.7518654607321837,0.24813453926781628
3191,The Goldfinch,9932621,5332621,4600000,2019.csv,2019,0.5368795406569927,0.4631204593430073
3192,Red Shoes and the Seven Dwarfs,9932398,0,9932398,2019.csv,2019,0.0,1.0
3193,The Collection,9929706,6842058,3087648,2012.csv,2012,0.6890494038796314,0.3109505961203685
3194,The Secret,9923066,0,9923066,2016.csv,2016,0.0,1.0
3195,High & Low: The Red Rain,9921150,0,9921150,2016.csv,2016,0.0,1.0
3196,Never Let Me Go,9904795,2434652,7470143,2010.csv,2010,0.24580539021756634,0.7541946097824337
3197,Everest: The Summit of the Gods,9901480,0,9901480,2016.csv,2016,0.0,1.0
3198,The Princess and the Matchmaker,9899017,78900,9820117,2018.csv,2018,0.007970488382836398,0.9920295116171636
3199,Friend Zone,9894885,0,9894885,2019.csv,2019,0.0,1.0
3200,Chinaman's Chance: America's Other Slaves,9891729,0,9891729,2015.csv,2015,0.0,1.0
3201,Arctic Dogs,9879871,5801249,4078622,2019.csv,2019,0.5871786180204175,0.4128213819795825
3202,Parmanu: The Story of Pokhran,9862726,0,9862726,2018.csv,2018,0.0,1.0
3203,The Big Picture,9855357,0,9855357,2010.csv,2010,0.0,1.0
3204,Joyeuse retraite!,9848156,0,9848156,2019.csv,2019,0.0,1.0
3205,Dragon Nest: Warriors' Dawn,9841578,0,9841578,2014.csv,2014,0.0,1.0
3206,The Complex,9841422,0,9841422,2013.csv,2013,0.0,1.0
3207,Ghost,9833553,0,9833553,2010.csv,2010,0.0,1.0
3208,The Grandmaster 2015 Re-release,9830000,0,9830000,2015.csv,2015,0.0,1.0
3209,Pleasant Goat and Big Big Wolf: Amazing Pleasant Goat,9830000,0,9830000,2015.csv,2015,0.0,1.0
3210,The Magnificent Nine,9826255,0,9826255,2016.csv,2016,0.0,1.0
3211,Kiss Me at the Stroke of Midnight,9823872,0,9823872,2019.csv,2019,0.0,1.0
3212,Moskova'nin Sifresi Temel,9819518,0,9819518,2011.csv,2011,0.0,1.0
3213,"Extremely Wicked, Shockingly Evil and Vile",9816572,0,9816572,2019.csv,2019,0.0,1.0
3214,Close Range Love,9812922,0,9812922,2014.csv,2014,0.0,1.0
3215,A Minuscule Adventure,9812387,0,9812387,2019.csv,2019,0.0,1.0
3216,Divorce French Style,9798848,0,9798848,2016.csv,2016,0.0,1.0
3217,Peace Breaker,9796094,0,9796094,2017.csv,2017,0.0,1.0
3218,All Creatures Big And Small,9794228,0,9794228,2015.csv,2015,0.0,1.0
3219,Sumikko Gurashi the Movie: The Unexpected Picture Book and the Secret Child,9794013,0,9794013,2019.csv,2019,0.0,1.0
3220,The Beachnickers,9786399,0,9786399,2018.csv,2018,0.0,1.0
3221,First Time 2017 Re-release,9785305,0,9785305,2017.csv,2017,0.0,1.0
3222,The Stool Pigeon,9783637,0,9783637,2010.csv,2010,0.0,1.0
3223,The War of Loong,9782949,0,9782949,2017.csv,2017,0.0,1.0
3224,The Goddess of Fortune,9780218,0,9780218,2019.csv,2019,0.0,1.0
3225,The Rise of a Tomboy,9769582,0,9769582,2016.csv,2016,0.0,1.0
3226,Young & Beautiful,9757417,61067,9696350,2013.csv,2013,0.0062585210819625725,0.9937414789180374
3227,He Even Has Your Eyes,9755458,0,9755458,2017.csv,2017,0.0,1.0
3228,Girls for Keeps,9754995,0,9754995,2012.csv,2012,0.0,1.0
3229,Phantom Detective,9754195,67054,9687141,2016.csv,2016,0.006874375589169583,0.9931256244108304
3230,The Boy 2016 Re-release,9741025,0,9741025,2016.csv,2016,0.0,1.0
3231,Miracle Apples,9737264,0,9737264,2013.csv,2013,0.0,1.0
3232,Maudie,9733932,6170998,3562934,2017.csv,2017,0.6339676504828675,0.3660323495171324
3233,Guardians,9729418,0,9729418,2017.csv,2017,0.0,1.0
3234,The Odyssey,9722918,0,9722918,2016.csv,2016,0.0,1.0
3235,Fortuna's Eye,9718481,0,9718481,2019.csv,2019,0.0,1.0
3236,Dragon Ball: Mystical Adventure,9714846,0,9714846,2016.csv,2016,0.0,1.0
3237,The Mystery of Henri Pick,9712385,0,9712385,2019.csv,2019,0.0,1.0
3238,V.I.P.,9710283,0,9710283,2017.csv,2017,0.0,1.0
3239,Stolen Identity 2,9687188,0,9687188,2020.csv,2020,0.0,1.0
3240,Rock'n Roll,9684093,0,9684093,2017.csv,2017,0.0,1.0
3241,Popstar: Never Stop Never Stopping,9680029,9639125,40904,2016.csv,2016,0.9957743928246496,0.0042256071753504045
3242,Spacewalk,9677311,0,9677311,2017.csv,2017,0.0,1.0
3243,Diner,9673094,0,9673094,2019.csv,2019,0.0,1.0
3244,One Night Stud,9670000,0,9670000,2015.csv,2015,0.0,1.0
3245,Tod@s Caen,9667157,2670925,6996232,2019.csv,2019,0.2762885717072765,0.7237114282927235
3246,In Darkness,9661759,1041455,8620304,2012.csv,2012,0.10779144874137307,0.892208551258627
3247,Department Q: A Conspiracy of Faith,9651271,0,9651271,2016.csv,2016,0.0,1.0
3248,Overdrive,9650552,7793,9642759,2017.csv,2017,0.0008075185751032687,0.9991924814248967
3249,Parasyte: Part 1,9649013,0,9649013,2015.csv,2015,0.0,1.0
3250,Men Are from Mars... And That's Where I'm Going!,9645549,0,9645549,2014.csv,2014,0.0,1.0
3251,The Shadow Play,9626679,0,9626679,2019.csv,2019,0.0,1.0
3252,On the Road,9617377,744296,8873081,2012.csv,2012,0.07739074801788472,0.9226092519821153
3253,Ji hun,9600000,0,9600000,2021.csv,2021,0.0,1.0
3254,Star Wars: Episode V - The Empire Strikes Back 2015 Re-release,9593937,0,9593937,2015.csv,2015,0.0,1.0
3255,High & Low: The Movie 3 - Final Mission,9591095,0,9591095,2017.csv,2017,0.0,1.0
3256,Paterson,9588282,2152738,7435544,2016.csv,2016,0.22451759345417668,0.7754824065458233
3257,Hysteria,9584256,1804139,7780117,2011.csv,2011,0.1882398592024253,0.8117601407975746
3258,Kochikame - The Movie: Save the Kachidiki Bridge!,9584129,0,9584129,2011.csv,2011,0.0,1.0
3259,Women on the Run,9582448,0,9582448,2019.csv,2019,0.0,1.0
3260,Little Big Master,9573680,0,9573680,2015.csv,2015,0.0,1.0
3261,Wind Blast,9566904,0,9566904,2010.csv,2010,0.0,1.0
3262,God of War,9559524,53000,9506524,2017.csv,2017,0.005544209104972172,0.9944557908950278
3263,The 12th Man,9554803,0,9554803,2017.csv,2017,0.0,1.0
3264,With Open Arms,9548364,0,9548364,2017.csv,2017,0.0,1.0
3265,8 pervykh svidaniy,9541107,0,9541107,2012.csv,2012,0.0,1.0
3266,Corpus Christi,9540252,127240,9413012,2019.csv,2019,0.013337173902743868,0.9866628260972561
3267,"Wanko: The Story of Me, My Family and Rock",9528275,0,9528275,2011.csv,2011,0.0,1.0
3268,Agent Vinod,9520886,698210,8822676,2012.csv,2012,0.07333456151034683,0.9266654384896532
3269,Traffik,9515914,9186156,329758,2018.csv,2018,0.9653466813592473,0.034653318640752745
3270,Ride Like a Girl,9498635,0,9498635,2019.csv,2019,0.0,1.0
3271,The Young and Prodigious T.S. Spivet,9494789,173564,9321225,2013.csv,2013,0.01827992175497528,0.9817200782450247
3272,The Square,9493791,1502347,7991444,2017.csv,2017,0.15824521521487042,0.8417547847851296
3273,What's with This Granny!?,9488949,0,9488949,2019.csv,2019,0.0,1.0
3274,Point Blank,9487445,708215,8779230,2010.csv,2010,0.07464760006513872,0.9253523999348613
3275,Our Time Will Come,9484714,114560,9370154,2017.csv,2017,0.012078382120957996,0.987921617879042
3276,House of Angels,9481984,0,9481984,2010.csv,2010,0.0,1.0
3277,Daytime Shooting Star,9481654,0,9481654,2017.csv,2017,0.0,1.0
3278,The Mayor 2017 Re-release,9476194,96777,9379417,2017.csv,2017,0.010212644443539252,0.9897873555564608
3279,Official Secrets,9473603,1988546,7485057,2019.csv,2019,0.20990387712045777,0.7900961228795422
3280,10 Days with Dad,9470574,856,9469718,2020.csv,2020,9.038522902624488e-05,0.9999096147709737
3281,Promare,9467336,2313596,7153740,2019.csv,2019,0.2443766651991648,0.7556233348008352
3282,Peepli [Live],9460931,757951,8702980,2010.csv,2010,0.08011378584200646,0.9198862141579935
3283,"Tora-san, Wish You Were Here",9459306,0,9459306,2019.csv,2019,0.0,1.0
3284,365 Days,9458590,0,9458590,2020.csv,2020,0.0,1.0
3285,Secret Zoo,9457317,0,9457317,2020.csv,2020,0.0,1.0
3286,Kamen Rider Movie War the Fateful Sengoku Battle: Kamen Rider vs. Kamen Rider Gaim & Wizard,9446183,0,9446183,2013.csv,2013,0.0,1.0
3287,Kirikou and the Men and Women,9442887,0,9442887,2011.csv,2011,0.0,1.0
3288,Andiamo a quel paese,9437265,0,9437265,2014.csv,2014,0.0,1.0
3289,Okay Madam,9433525,0,9433525,2020.csv,2020,0.0,1.0
3290,New Kids Nitro,9428100,0,9428100,2011.csv,2011,0.0,1.0
3291,Ahora o nunca,9425052,0,9425052,2015.csv,2015,0.0,1.0
3292,Tenchi: The Samurai Astronomer,9405840,0,9405840,2012.csv,2012,0.0,1.0
3293,The Big Bad Fox and Other Tales,9399067,35787,9363280,2017.csv,2017,0.0038075055747554517,0.9961924944252446
3294,Super Hero Taisen Kamen Rider feat. Super Sentai: Heisei Rider vs. Showa Rider,9397108,0,9397108,2014.csv,2014,0.0,1.0
3295,This Life,9388513,0,9388513,2012.csv,2012,0.0,1.0
3296,Do Not Disturb,9382573,0,9382573,2014.csv,2014,0.0,1.0
3297,Mobile Suit Gundam 00: A Wakening of the Trailblazer,9381149,0,9381149,2010.csv,2010,0.0,1.0
3298,Bel Ami,9374932,120462,9254470,2012.csv,2012,0.01284937320078695,0.9871506267992131
3299,Amici come prima,9367230,0,9367230,2018.csv,2018,0.0,1.0
3300,Mathilde,9365944,0,9365944,2017.csv,2017,0.0,1.0
3301,The Mimic,9362702,0,9362702,2017.csv,2017,0.0,1.0
3302,You Were Never Really Here,9360514,2528078,6832436,2017.csv,2017,0.2700789721590075,0.7299210278409924
3303,Ladies in Black,9356495,0,9356495,2018.csv,2018,0.0,1.0
3304,Osman Pazarlama,9352939,0,9352939,2016.csv,2016,0.0,1.0
3305,The Human Comedy,9345649,0,9345649,2019.csv,2019,0.0,1.0
3306,Tri bogatyrya i Naslednitsa prestola,9343827,0,9343827,2018.csv,2018,0.0,1.0
3307,Jexi,9341824,6546159,2795665,2019.csv,2019,0.7007367083772933,0.29926329162270665
3308,Suite Française,9337930,0,9337930,2015.csv,2015,0.0,1.0
3309,Saving Private Perez,9330465,1400726,7929739,2011.csv,2011,0.15012392201246133,0.8498760779875387
3310,Replicas,9330075,4046429,5283646,2018.csv,2018,0.4336973711358162,0.5663026288641838
3311,Airlift,9323484,0,9323484,2016.csv,2016,0.0,1.0
3312,MacGruber,9322895,8525600,797295,2010.csv,2010,0.9144798906348296,0.08552010936517036
3313,L'appel de la forêt,9317347,0,9317347,2020.csv,2020,0.0,1.0
3314,Family Way,9308883,0,9308883,2012.csv,2012,0.0,1.0
3315,Peeples,9307166,9177065,130101,2013.csv,2013,0.9860214161861945,0.013978583813805406
3316,"Sex, Love & Therapy",9307095,0,9307095,2014.csv,2014,0.0,1.0
3317,Mid90s,9303022,7362439,1940583,2018.csv,2018,0.7914029441185886,0.20859705588141145
3318,Bigfoot Family,9299373,0,9299373,2020.csv,2020,0.0,1.0
3319,Jerusalem,9279456,8020721,1258735,2013.csv,2013,0.8643525008362559,0.13564749916374408
3320,Saving Santa,9278821,0,9278821,2013.csv,2013,0.0,1.0
3321,Brooklyn's Finest 2010 Re-release,9276608,0,9276608,2010.csv,2010,0.0,1.0
3322,Fatal,9267224,0,9267224,2010.csv,2010,0.0,1.0
3323,Sadako vs. Kayako,9256114,0,9256114,2016.csv,2016,0.0,1.0
3324,Planet Single,9252084,0,9252084,2016.csv,2016,0.0,1.0
3325,The Legend of Qin,9250000,0,9250000,2014.csv,2014,0.0,1.0
3326,To Hell with the Ugly,9246548,0,9246548,2010.csv,2010,0.0,1.0
3327,The Chef,9245235,342667,8902568,2012.csv,2012,0.03706417413943507,0.9629358258605649
3328,Revenge for Love,9242543,0,9242543,2017.csv,2017,0.0,1.0
3329,Promise at Dawn,9242157,0,9242157,2017.csv,2017,0.0,1.0
3330,We Need to Talk About Kevin,9232318,1738692,7493626,2011.csv,2011,0.1883267019181965,0.8116732980818036
3331,It's Only the End of the World,9231823,0,9231823,2016.csv,2016,0.0,1.0
3332,Pretty Cure Super Stars,9229789,0,9229789,2018.csv,2018,0.0,1.0
3333,Chibi Maruko-chan: A Boy from Italy,9225421,0,9225421,2015.csv,2015,0.0,1.0
3334,DokiDoki! PreCure,9220936,0,9220936,2013.csv,2013,0.0,1.0
3335,Ailecek Saskiniz,9216552,0,9216552,2018.csv,2018,0.0,1.0
3336,The Aftermath,9215591,1618497,7597094,2019.csv,2019,0.17562595822666174,0.8243740417733383
3337,Tulip Fever,9204549,2455635,6748914,2017.csv,2017,0.2667849342754327,0.7332150657245673
3338,Çalgi Çengi Ikimiz,9201129,0,9201129,2017.csv,2017,0.0,1.0
3339,Love-Carrot 3,9200378,0,9200378,2010.csv,2010,0.0,1.0
3340,My Cousin Rachel,9200168,2716368,6483800,2017.csv,2017,0.2952519997460916,0.7047480002539084
3341,Cleo,9199988,0,9199988,2015.csv,2015,0.0,1.0
3342,Soulless 2,9194350,0,9194350,2015.csv,2015,0.0,1.0
3343,Vier gegen die Bank,9193243,0,9193243,2016.csv,2016,0.0,1.0
3344,Starting Over Again,9189200,0,9189200,2014.csv,2014,0.0,1.0
3345,Ostwind 2,9185676,0,9185676,2015.csv,2015,0.0,1.0
3346,S.O.S.: Women to the Sea,9183590,0,9183590,2014.csv,2014,0.0,1.0
3347,Let's Go Jets,9176187,0,9176187,2017.csv,2017,0.0,1.0
3348,A Hologram for the King,9169507,4212494,4957013,2016.csv,2016,0.4594024520620356,0.5405975479379644
3349,Planeta Singli 2,9167737,0,9167737,2018.csv,2018,0.0,1.0
3350,Unfinished Song,9166865,1702668,7464197,2013.csv,2013,0.18574158122760617,0.8142584187723938
3351,The Reunion 2: The Funeral,9156541,0,9156541,2014.csv,2014,0.0,1.0
3352,The Raid: Redemption,9148519,4105187,5043332,2012.csv,2012,0.4487269469517416,0.5512730530482585
3353,It Takes a Man and a Woman,9141744,0,9141744,2013.csv,2013,0.0,1.0
3354,Kwai Boo,9140000,0,9140000,2015.csv,2015,0.0,1.0
3355,Ruby Sparks,9128263,2540106,6588157,2012.csv,2012,0.2782682751362444,0.7217317248637556
3356,Frau Müller muss weg!,9127383,0,9127383,2015.csv,2015,0.0,1.0
3357,The Best Summer of My Life,9126625,0,9126625,2018.csv,2018,0.0,1.0
3358,My Piece of the Pie,9123187,6850,9116337,2011.csv,2011,0.0007508341109307526,0.9992491658890692
3359,Searching for Sugar Man,9122406,3696196,5426210,2012.csv,2012,0.40517775683301094,0.5948222431669891
3360,City Of Rock,9118873,312537,8806336,2017.csv,2017,0.034273643245168565,0.9657263567548314
3361,The First Beautiful Thing,9115665,0,9115665,2010.csv,2010,0.0,1.0
3362,Human Capital,9113941,158549,8955392,2014.csv,2014,0.017396316258795178,0.9826036837412048
3363,Miss Sloane,9101546,3500605,5600941,2016.csv,2016,0.3846165255880704,0.6153834744119295
3364,Inception 10th Anniversary re-release,9100000,0,9100000,2020.csv,2020,0.0,1.0
3365,Narratage,9097805,0,9097805,2017.csv,2017,0.0,1.0
3366,Meet the Blacks,9097072,9097072,0,2016.csv,2016,1.0,0.0
3367,Tolkien,9090040,4535154,4554886,2019.csv,2019,0.4989146362392245,0.5010853637607755
3368,"Begin, Again",9085921,0,9085921,2019.csv,2019,0.0,1.0
3369,What a Man Wants,9080272,0,9080272,2018.csv,2018,0.0,1.0
3370,Murder 2,9078349,59000,9019349,2011.csv,2011,0.006498979054451421,0.9935010209455486
3371,Twice Born,9075131,18295,9056836,2012.csv,2012,0.002015948860683113,0.9979840511393169
3372,Me and Earl and the Dying Girl,9074749,6758416,2316333,2015.csv,2015,0.7447496343976016,0.2552503656023985
3373,Monsieur Lazhar,9074711,2009517,7065194,2012.csv,2012,0.22144143212935377,0.7785585678706463
3374,Kardesim Benim,9072024,0,9072024,2016.csv,2016,0.0,1.0
3375,Love Is in the Air,9065716,0,9065716,2012.csv,2012,0.0,1.0
3376,The Last Ronin,9065176,0,9065176,2010.csv,2010,0.0,1.0
3377,Naruto Shippuden the Movie: Blood Prison,9065101,0,9065101,2011.csv,2011,0.0,1.0
3378,Anjaana Anjaani,9062995,854757,8208238,2010.csv,2010,0.09431286235951802,0.905687137640482
3379,The Fifth Estate,9058564,3255008,5803556,2013.csv,2013,0.3593293594878835,0.6406706405121165
3380,Frances Ha,9058065,4069826,4988239,2013.csv,2013,0.4493041284203635,0.5506958715796365
3381,Battle for Sevastopol,9054676,0,9054676,2015.csv,2015,0.0,1.0
3382,To Steal from a Thief,9041187,0,9041187,2016.csv,2016,0.0,1.0
3383,Incarnate,9037058,4799774,4237284,2016.csv,2016,0.5311213007596056,0.4688786992403944
3384,Like Crazy,9029150,107362,8921788,2016.csv,2016,0.011890598782831163,0.9881094012171688
3385,Truman,9027600,210840,8816760,2015.csv,2015,0.02335504453010767,0.9766449554698924
3386,The Legend of Pig Warrior,9023944,0,9023944,2019.csv,2019,0.0,1.0
3387,"Two Days, One Night",9016922,1436243,7580679,2014.csv,2014,0.15928306799149422,0.8407169320085058
3388,Marshland,9014591,0,9014591,2014.csv,2014,0.0,1.0
3389,Ducoboo 2: Crazy Vacation,9013064,0,9013064,2012.csv,2012,0.0,1.0
3390,Monica Z,9004094,0,9004094,2013.csv,2013,0.0,1.0
3391,Three Many Weddings,8996139,0,8996139,2013.csv,2013,0.0,1.0
3392,Super Express,8980243,0,8980243,2016.csv,2016,0.0,1.0
3393,Dog × Police: The K-9 Force,8976044,0,8976044,2011.csv,2011,0.0,1.0
3394,We Are So Young,8975573,0,8975573,2013.csv,2013,0.0,1.0
3395,Champion,8974547,97472,8877075,2018.csv,2018,0.010860938162115592,0.9891390618378844
3396,Neuilly Yo Mama II,8970297,0,8970297,2018.csv,2018,0.0,1.0
3397,Perfect Game,8960806,0,8960806,2011.csv,2011,0.0,1.0
3398,The Last Recipe: Memory of Giraffe's Tongue,8960664,0,8960664,2017.csv,2017,0.0,1.0
3399,Break the Silence: The Movie,8954345,0,8954345,2020.csv,2020,0.0,1.0
3400,The Lobster 2016 Re-release,8952351,8700374,251977,2016.csv,2016,0.9718535388078506,0.028146461192149416
3401,The Closet,8948595,0,8948595,2020.csv,2020,0.0,1.0
3402,How About Adolf?,8947326,0,8947326,2018.csv,2018,0.0,1.0
3403,Man of Men,8936453,0,8936453,2019.csv,2019,0.0,1.0
3404,Murder at Shijinso,8934857,0,8934857,2019.csv,2019,0.0,1.0
3405,Thesis on a Homicide,8932920,0,8932920,2013.csv,2013,0.0,1.0
3406,The Perfect Date,8927094,0,8927094,2010.csv,2010,0.0,1.0
3407,Super Hero Taisen Z: Kamen Rider vs. Super Sentai vs. Space Sheriff,8918825,0,8918825,2013.csv,2013,0.0,1.0
3408,Downhill,8899195,8287061,612134,2020.csv,2020,0.9312146772826081,0.06878532271739185
3409,I Hate Summer,8885798,0,8885798,2020.csv,2020,0.0,1.0
3410,Bibi & Tina,8882377,0,8882377,2014.csv,2014,0.0,1.0
3411,Hannah Arendt,8880936,717205,8163731,2013.csv,2013,0.08075781651843905,0.919242183481561
3412,Running Man,8873200,0,8873200,2013.csv,2013,0.0,1.0
3413,The Art of Loving: Story of Michalina Wislocka,8869345,0,8869345,2017.csv,2017,0.0,1.0
3414,Ju-on: The Beginning of the End,8867935,0,8867935,2014.csv,2014,0.0,1.0
3415,Gromkaya svyaz,8864882,0,8864882,2019.csv,2019,0.0,1.0
3416,Les blagues de Toto,8859185,0,8859185,2020.csv,2020,0.0,1.0
3417,Bluebeard,8855737,43144,8812593,2017.csv,2017,0.0048718700656986535,0.9951281299343013
3418,The Anthem of the Heart,8852989,0,8852989,2015.csv,2015,0.0,1.0
3419,The Traitor,8851996,296027,8555969,2019.csv,2019,0.033441836168927326,0.9665581638310726
3420,30 jours max,8844803,0,8844803,2020.csv,2020,0.0,1.0
3421,The Legend of the Christmas Witch,8843257,0,8843257,2018.csv,2018,0.0,1.0
3422,All Together,8835903,43180,8792723,2012.csv,2012,0.004886880265661585,0.9951131197343385
3423,Happy Little Submarine 3: Rainbow Treasure,8830000,0,8830000,2013.csv,2013,0.0,1.0
3424,Soof,8829814,0,8829814,2013.csv,2013,0.0,1.0
3425,Speckles: The Tarbosaurus,8828562,0,8828562,2012.csv,2012,0.0,1.0
3426,Get the Gringo,8826837,0,8826837,2012.csv,2012,0.0,1.0
3427,The Reef 2: High Tide,8820622,0,8820622,2012.csv,2012,0.0,1.0
3428,Famous Five 2,8813759,0,8813759,2013.csv,2013,0.0,1.0
3429,Morgan,8809407,3915251,4894156,2016.csv,2016,0.4444397903286793,0.5555602096713207
3430,Captive State,8808611,5958315,2850296,2019.csv,2019,0.6764193582847511,0.32358064171524886
3431,Sunshine on Leith,8804555,0,8804555,2013.csv,2013,0.0,1.0
3432,A Samurai Chronicle,8804424,0,8804424,2014.csv,2014,0.0,1.0
3433,Allah'ýn sevdiði kulun,8797985,0,8797985,2011.csv,2011,0.0,1.0
3434,Mientras duermes,8791590,0,8791590,2011.csv,2011,0.0,1.0
3435,Lilly the Witch: The Journey to Mandolan,8787410,0,8787410,2011.csv,2011,0.0,1.0
3436,Yugo and Lala 2,8779915,0,8779915,2014.csv,2014,0.0,1.0
3437,The Body,8779609,0,8779609,2012.csv,2012,0.0,1.0
3438,Honey 2,8775693,0,8775693,2011.csv,2011,0.0,1.0
3439,Sorry We Missed You,8773135,28273,8744862,2019.csv,2019,0.003222679236099752,0.9967773207639002
3440,Scandal Maker,8772485,0,8772485,2016.csv,2016,0.0,1.0
3441,7 Days in Entebbe,8771432,3326885,5444547,2018.csv,2018,0.379286415262639,0.620713584737361
3442,Enchanted Kingdom,8766058,0,8766058,2014.csv,2014,0.0,1.0
3443,Samurai Hustle Returns,8763957,0,8763957,2016.csv,2016,0.0,1.0
3444,The 47 Ronin in Debt,8760116,0,8760116,2019.csv,2019,0.0,1.0
3445,Marguerite,8754356,506677,8247679,2015.csv,2015,0.0578771299682124,0.9421228700317876
3446,Charming,8751856,0,8751856,2018.csv,2018,0.0,1.0
3447,La folle histoire de Max et Léon,8750678,543,8750135,2016.csv,2016,6.205233468766649e-05,0.9999379476653123
3448,Slapstick Brothers,8747994,0,8747994,2011.csv,2011,0.0,1.0
3449,The Villainess,8737458,27741,8709717,2017.csv,2017,0.003174950883884077,0.9968250491161159
3450,The Last Message,8736200,0,8736200,2012.csv,2012,0.0,1.0
3451,Seer V,8730000,0,8730000,2014.csv,2014,0.0,1.0
3452,Aarakshan,8726551,651096,8075455,2011.csv,2011,0.07461092016765845,0.9253890798323415
3453,The Snow White Murder Case,8721394,0,8721394,2014.csv,2014,0.0,1.0
3454,Eunkyo,8719790,0,8719790,2012.csv,2012,0.0,1.0
3455,Code Geass: Lelouch of the Re;Surrection 2019 Re-release,8715612,522805,8192807,2019.csv,2019,0.05998488689032967,0.9400151131096703
3456,The Secret Garden,8708204,0,8708204,2020.csv,2020,0.0,1.0
3457,Romantik Komedi 2: Bekarliga Veda,8701745,0,8701745,2013.csv,2013,0.0,1.0
3458,Step by Step,8700784,0,8700784,2017.csv,2017,0.0,1.0
3459,"Cheer Up, Mr. Lee",8700048,0,8700048,2019.csv,2019,0.0,1.0
3460,Iron Mask,8685794,0,8685794,2019.csv,2019,0.0,1.0
3461,Mardaani 2,8680109,0,8680109,2019.csv,2019,0.0,1.0
3462,Chihayafuru Part II,8674783,0,8674783,2016.csv,2016,0.0,1.0
3463,Husband Factor,8674655,0,8674655,2015.csv,2015,0.0,1.0
3464,Love in Disguise,8665577,0,8665577,2010.csv,2010,0.0,1.0
3465,Le Week-end,8652213,2225098,6427115,2013.csv,2013,0.257170968860799,0.7428290311392011
3466,A Banana? At This Time of Night?,8652004,0,8652004,2018.csv,2018,0.0,1.0
3467,Buddy,8645255,0,8645255,2013.csv,2013,0.0,1.0
3468,Himmatwala,8644563,270880,8373683,2013.csv,2013,0.03133530289501042,0.9686646971049896
3469,Dark World 2010 Re-release,8628997,0,8628997,2010.csv,2010,0.0,1.0
3470,Dark World,8628997,0,8628997,2010.csv,2010,0.0,1.0
3471,Proof of Innocence,8624967,0,8624967,2016.csv,2016,0.0,1.0
3472,Eltilerin Savasi,8613864,0,8613864,2020.csv,2020,0.0,1.0
3473,Love Contractually,8613029,0,8613029,2017.csv,2017,0.0,1.0
3474,Aircraft Carrier Ibuki,8611013,0,8611013,2019.csv,2019,0.0,1.0
3475,Psychic Kusuo,8608809,0,8608809,2017.csv,2017,0.0,1.0
3476,Pope Francis: A Man of His Word,8608385,2008385,6600000,2018.csv,2018,0.23330566651003642,0.7666943334899635
3477,The Big Call,8595808,0,8595808,2017.csv,2017,0.0,1.0
3478,The Little Ghost,8589894,0,8589894,2013.csv,2013,0.0,1.0
3479,Nanimono,8577483,0,8577483,2016.csv,2016,0.0,1.0
3480,Dedemin Fisi,8573963,0,8573963,2016.csv,2016,0.0,1.0
3481,The Palace,8570000,0,8570000,2013.csv,2013,0.0,1.0
3482,Under The Rainbow,8569178,0,8569178,2013.csv,2013,0.0,1.0
3483,The Final Master,8551269,0,8551269,2012.csv,2012,0.0,1.0
3484,Kikoriki: Team Invincible,8545653,0,8545653,2011.csv,2011,0.0,1.0
3485,Cold War,8542830,0,8542830,2012.csv,2012,0.0,1.0
3486,A View of Love,8540794,0,8540794,2010.csv,2010,0.0,1.0
3487,"Connasse, princesse des coeurs",8540288,0,8540288,2015.csv,2015,0.0,1.0
3488,Schutzengel,8530346,0,8530346,2012.csv,2012,0.0,1.0
3489,Space Dogs,8530226,14408,8515818,2010.csv,2010,0.0016890525526521807,0.9983109474473478
3490,When Hitler Stole Pink Rabbit,8529779,0,8529779,2019.csv,2019,0.0,1.0
3491,Natale col boss,8528805,0,8528805,2015.csv,2015,0.0,1.0
3492,Our Brand Is Crisis,8527658,7002261,1525397,2015.csv,2015,0.8211235722633342,0.1788764277366658
3493,Precure All Stars New Stage 3,8526335,0,8526335,2014.csv,2014,0.0,1.0
3494,What If,8526288,3493000,5033288,2014.csv,2014,0.40967417474052015,0.5903258252594799
3495,The Magic Brush,8520000,0,8520000,2014.csv,2014,0.0,1.0
3496,You Shine in the Moonlight,8514011,0,8514011,2019.csv,2019,0.0,1.0
3497,Wrath of Silence,8512220,0,8512220,2018.csv,2018,0.0,1.0
3498,MONSTERZ: Monsutâzu,8505632,0,8505632,2014.csv,2014,0.0,1.0
3499,Stronger,8503658,4211129,4292529,2017.csv,2017,0.495213824450607,0.504786175549393
3500,Slow Video,8494658,0,8494658,2014.csv,2014,0.0,1.0
3501,Tune in for Love,8494414,0,8494414,2019.csv,2019,0.0,1.0
3502,Piranha 3DD,8493728,376512,8117216,2012.csv,2012,0.044328238436644074,0.9556717615633559
3503,Amityville: The Awakening,8481997,742,8481255,2017.csv,2017,8.747939901417083e-05,0.9999125206009858
3504,"Help, I Shrunk My Teacher",8477416,0,8477416,2015.csv,2015,0.0,1.0
3505,A-X-L,8467697,6501381,1966316,2018.csv,2018,0.767786211528353,0.232213788471647
3506,The Outrage,8457741,44745,8412996,2010.csv,2010,0.005290419746833109,0.9947095802531669
3507,Naruto Shippûden: The Lost Tower 2010 Re-release,8453188,0,8453188,2010.csv,2010,0.0,1.0
3508,Phone Call to the Bar 2,8451562,0,8451562,2013.csv,2013,0.0,1.0
3509,Vacanze ai Caraibi,8447319,0,8447319,2015.csv,2015,0.0,1.0
3510,Casa de mi Padre,8446952,5909483,2537469,2012.csv,2012,0.6995994531518588,0.3004005468481412
3511,A Street Cat Named Bob,8446262,82703,8363559,2016.csv,2016,0.009791668787920621,0.9902083312120794
3512,Tayna Sukharevoy bashni. Charodey ravnovesiya,8442829,0,8442829,2015.csv,2015,0.0,1.0
3513,The Way 2010 Re-release,8437872,4430765,4007107,2010.csv,2010,0.5251045524274367,0.4748954475725633
3514,The Big Bee,8437050,0,8437050,2015.csv,2015,0.0,1.0
3515,Condorito: The Movie,8431194,447719,7983475,2017.csv,2017,0.053102680355830975,0.946897319644169
3516,Raees,8428190,3262954,5165236,2017.csv,2017,0.38714765566509535,0.6128523443349047
3517,Malasaña 32,8421833,0,8421833,2020.csv,2020,0.0,1.0
3518,Battle of Warsaw 1920,8417043,0,8417043,2011.csv,2011,0.0,1.0
3519,Toriko 3D: Kaimaku! Gurume adobenchâ!,8410203,0,8410203,2011.csv,2011,0.0,1.0
3520,Kamen Rider Gaim: Great Soccer Battle! Golden Fruits Cup!,8405854,0,8405854,2014.csv,2014,0.0,1.0
3521,Roommates Wanted,8405304,0,8405304,2016.csv,2016,0.0,1.0
3522,Malang,8399765,0,8399765,2020.csv,2020,0.0,1.0
3523,The Golden Era,8396062,102931,8293131,2014.csv,2014,0.012259437817395823,0.9877405621826042
3524,Sadako 2 3D,8385405,0,8385405,2013.csv,2013,0.0,1.0
3525,Filth,8377987,34411,8343576,2013.csv,2013,0.004107311219270214,0.9958926887807298
3526,Wir sind die Neuen,8373880,0,8373880,2014.csv,2014,0.0,1.0
3527,PAW Patrol: Mighty Pups,8373241,0,8373241,2018.csv,2018,0.0,1.0
3528,Snabba Cash,8369756,205741,8164015,2010.csv,2010,0.024581481228365558,0.9754185187716344
3529,The Love Punch,8366493,266588,8099905,2014.csv,2014,0.031863768965084895,0.9681362310349151
3530,Some Like It Cold,8358478,0,8358478,2014.csv,2014,0.0,1.0
3531,Venus in Fur,8350026,373605,7976421,2013.csv,2013,0.04474297445301368,0.9552570255469863
3532,I Am Not Your Negro,8345298,7123919,1221379,2017.csv,2017,0.8536446511556568,0.14635534884434326
3533,The Big Score,8335944,0,8335944,2016.csv,2016,0.0,1.0
3534,Te jing dui,8332573,0,8332573,2019.csv,2019,0.0,1.0
3535,Old Cinderella,8330000,0,8330000,2014.csv,2014,0.0,1.0
3536,Tini: The New Life of Violetta 2016 Re-release,8321696,0,8321696,2016.csv,2016,0.0,1.0
3537,Khatta Meetha,8319469,541904,7777565,2010.csv,2010,0.06513684947921557,0.9348631505207844
3538,Time Renegades,8312361,59425,8252936,2016.csv,2016,0.007148991724493198,0.9928510082755068
3539,London Boulevard,8307227,16075,8291152,2010.csv,2010,0.0019350620850977108,0.9980649379149023
3540,Mune: Guardian of the Moon,8305708,0,8305708,2015.csv,2015,0.0,1.0
3541,The Spies,8304356,0,8304356,2012.csv,2012,0.0,1.0
3542,When Mom Is Away,8299778,0,8299778,2019.csv,2019,0.0,1.0
3543,Beremennyy,8297966,0,8297966,2011.csv,2011,0.0,1.0
3544,"Help, I Shrunk My Parents",8292310,0,8292310,2018.csv,2018,0.0,1.0
3545,Battalion,8292235,0,8292235,2015.csv,2015,0.0,1.0
3546,Birthday,8291726,0,8291726,2019.csv,2019,0.0,1.0
3547,The Office,8290521,63675,8226846,2015.csv,2015,0.007680458200395367,0.9923195417996047
3548,Up for Love,8273919,0,8273919,2016.csv,2016,0.0,1.0
3549,You Are God,8267630,0,8267630,2012.csv,2012,0.0,1.0
3550,Burnt by the Sun 2,8266778,0,8266778,2010.csv,2010,0.0,1.0
3551,Sen Kimsin?,8261075,0,8261075,2012.csv,2012,0.0,1.0
3552,Anonymous,8252627,0,8252627,2014.csv,2014,0.0,1.0
3553,Hamilton: In the Interest of the Nation,8249053,0,8249053,2012.csv,2012,0.0,1.0
3554,Kill Me Please 2017 Re-release,8242805,0,8242805,2017.csv,2017,0.0,1.0
3555,My Worst Nightmare,8226544,21952,8204592,2011.csv,2011,0.0026684352505742387,0.9973315647494257
3556,Amongst Heroes,8224084,0,8224084,2010.csv,2010,0.0,1.0
3557,The Scent,8211138,0,8211138,2012.csv,2012,0.0,1.0
3558,Runway Cop,8209016,0,8209016,2012.csv,2012,0.0,1.0
3559,Return of the Cuckoo,8198787,0,8198787,2015.csv,2015,0.0,1.0
3560,Otto's Eleven,8184947,0,8184947,2010.csv,2010,0.0,1.0
3561,Cave of Forgotten Dreams,8183347,5304920,2878427,2011.csv,2011,0.6482579805060203,0.35174201949397965
3562,The Big Year,8179416,7204138,975278,2011.csv,2011,0.880764347968119,0.11923565203188101
3563,Holy Mess,8172351,0,8172351,2015.csv,2015,0.0,1.0
3564,Midnight FM,8171078,0,8171078,2010.csv,2010,0.0,1.0
3565,Memories,8139310,0,8139310,2015.csv,2015,0.0,1.0
3566,A Resistance,8137893,0,8137893,2019.csv,2019,0.0,1.0
3567,Walk of Shame,8122990,59209,8063781,2014.csv,2014,0.0072890647409389895,0.992710935259061
3568,Through the Fire,8122023,0,8122023,2018.csv,2018,0.0,1.0
3569,Cities in Love,8120000,0,8120000,2015.csv,2015,0.0,1.0
3570,The Man Who Invented Christmas,8117668,5676486,2441182,2017.csv,2017,0.6992754569415749,0.30072454305842516
3571,Dino King 3D: Journey to Fire Mountain,8112673,0,8112673,2018.csv,2018,0.0,1.0
3572,Ernest & Celestine,8111137,262075,7849062,2012.csv,2012,0.03231051331027943,0.9676894866897205
3573,The Outback,8106158,0,8106158,2012.csv,2012,0.0,1.0
3574,The New Year's Eve of Old Lee,8099301,25358,8073943,2016.csv,2016,0.0031308874679432212,0.9968691125320568
3575,Inseparables 2019 Re-release,8099228,0,8099228,2019.csv,2019,0.0,1.0
3576,"So Long, My Son",8096596,0,8096596,2019.csv,2019,0.0,1.0
3577,Soof 2,8095275,0,8095275,2016.csv,2016,0.0,1.0
3578,The Company Men,8087000,4441272,3645728,2011.csv,2011,0.5491865957709905,0.4508134042290095
3579,Whisper If I Forget,8079191,0,8079191,2014.csv,2014,0.0,1.0
3580,The Crossing 2,8070921,0,8070921,2015.csv,2015,0.0,1.0
3581,Sahara,8061843,0,8061843,2017.csv,2017,0.0,1.0
3582,Friends of Friends,8055417,0,8055417,2014.csv,2014,0.0,1.0
3583,Fullmetal Alchemist,8053641,0,8053641,2017.csv,2017,0.0,1.0
3584,Nice to Meet You,8051388,0,8051388,2018.csv,2018,0.0,1.0
3585,Colombiana 2013 Re-release,8050000,0,8050000,2013.csv,2013,0.0,1.0
3586,Heroine,8036853,598668,7438185,2012.csv,2012,0.07449035088734358,0.9255096491126564
3587,Tanguy Is Back,8033866,0,8033866,2019.csv,2019,0.0,1.0
3588,Your Eyes Tell,8020474,0,8020474,2020.csv,2020,0.0,1.0
3589,The House Where the Mermaid Sleeps,8011220,0,8011220,2018.csv,2018,0.0,1.0
3590,One Man and His Cow,8003756,0,8003756,2016.csv,2016,0.0,1.0
3591,My King,8003331,54114,7949217,2015.csv,2015,0.0067614347076236135,0.9932385652923764
3592,Disobedience,8003180,3498782,4504398,2018.csv,2018,0.4371739733455951,0.5628260266544048
3593,Life Itself,7997774,4102648,3895126,2018.csv,2018,0.5129737349417476,0.48702626505825247
3594,Denial,7994527,4073489,3921038,2016.csv,2016,0.5095347104337755,0.4904652895662245
3595,Crô: O Filme,7988278,0,7988278,2013.csv,2013,0.0,1.0
3596,Sakura Guardian in the North,7978105,0,7978105,2018.csv,2018,0.0,1.0
3597,The Fixies: Top Secret,7976551,0,7976551,2017.csv,2017,0.0,1.0
3598,Metallica Through the Never,7975812,3419967,4555845,2013.csv,2013,0.42879232860553884,0.5712076713944612
3599,Gurasuhoppâ,7971675,0,7971675,2015.csv,2015,0.0,1.0
3600,The Team,7970084,0,7970084,2014.csv,2014,0.0,1.0
3601,Tough as Iron,7943977,0,7943977,2013.csv,2013,0.0,1.0
3602,Chasing Mavericks,7942116,6002756,1939360,2012.csv,2012,0.7558131863095428,0.2441868136904573
3603,Suspiria,7942093,2483472,5458621,2018.csv,2018,0.3126974211961507,0.6873025788038493
3604,Gogol. The Beginning,7939761,0,7939761,2017.csv,2017,0.0,1.0
3605,Planeta Singli 3,7935472,0,7935472,2019.csv,2019,0.0,1.0
3606,AI Amok,7932191,0,7932191,2020.csv,2020,0.0,1.0
3607,White Fang,7928696,0,7928696,2018.csv,2018,0.0,1.0
3608,Measuring the World,7925562,0,7925562,2012.csv,2012,0.0,1.0
3609,Brigada: Naslednik,7917683,0,7917683,2012.csv,2012,0.0,1.0
3610,7 Guardians of the Tomb,7910928,0,7910928,2018.csv,2018,0.0,1.0
3611,Marriage Blue,7903932,0,7903932,2013.csv,2013,0.0,1.0
3612,Insanity,7901512,0,7901512,2015.csv,2015,0.0,1.0
3613,The Treacherous,7899033,0,7899033,2015.csv,2015,0.0,1.0
3614,Kamen Rider Ghost: The 100 Eyecons and Ghost's Fateful Moment,7897263,0,7897263,2016.csv,2016,0.0,1.0
3615,The Ark of Mr Chow,7894075,54075,7840000,2015.csv,2015,0.006850074264559179,0.9931499257354408
3616,Porn in the Hood,7893757,0,7893757,2012.csv,2012,0.0,1.0
3617,Bunshinsaba 3,7890000,0,7890000,2014.csv,2014,0.0,1.0
3618,Pavarotti,7885016,4600249,3284767,2019.csv,2019,0.5834165713804512,0.4165834286195488
3619,Vampire Sisters,7883772,0,7883772,2012.csv,2012,0.0,1.0
3620,The Battle of Jangsari,7883200,70853,7812347,2019.csv,2019,0.008987847574589,0.991012152425411
3621,Black Water,7882387,0,7882387,2018.csv,2018,0.0,1.0
3622,Big Match,7880684,0,7880684,2014.csv,2014,0.0,1.0
3623,Inside Job,7871522,4312735,3558787,2010.csv,2010,0.5478908653243935,0.4521091346756066
3624,A Day,7868316,0,7868316,2017.csv,2017,0.0,1.0
3625,The Roommates Party,7862364,0,7862364,2015.csv,2015,0.0,1.0
3626,For a Few Bullets,7860447,30142,7830305,2016.csv,2016,0.0038346419739233657,0.9961653580260766
3627,Salut d'Amour,7858183,22480,7835703,2015.csv,2015,0.0028607122028082065,0.9971392877971917
3628,Touken Ranbu: The Movie,7858150,0,7858150,2019.csv,2019,0.0,1.0
3629,Qualquer Gato Vira-Lata,7856048,0,7856048,2011.csv,2011,0.0,1.0
3630,It May Be Love But It Doesn't Show,7855434,0,7855434,2011.csv,2011,0.0,1.0
3631,"Caution, Hazardous Wife: The Movie",7854817,0,7854817,2021.csv,2021,0.0,1.0
3632,The Freshmen,7853811,0,7853811,2018.csv,2018,0.0,1.0
3633,Vincent Wants to Sea,7851439,0,7851439,2010.csv,2010,0.0,1.0
3634,Pele: Birth of a Legend,7846608,57046,7789562,2016.csv,2016,0.007270147814189265,0.9927298521858108
3635,"Lord, Give Me Patience",7840331,0,7840331,2017.csv,2017,0.0,1.0
3636,The Lost Prince,7837980,0,7837980,2020.csv,2020,0.0,1.0
3637,The Lady,7832142,355391,7476751,2011.csv,2011,0.04537596483822689,0.9546240351617731
3638,Famous Five,7823413,0,7823413,2012.csv,2012,0.0,1.0
3639,Renoir,7816573,2293798,5522775,2013.csv,2013,0.2934531539589024,0.7065468460410975
3640,Ali Baba and the Seven Dwarfs,7816034,0,7816034,2015.csv,2015,0.0,1.0
3641,Little Big Panda,7812864,0,7812864,2011.csv,2011,0.0,1.0
3642,Dongju: The Portrait of a Poet,7809531,56550,7752981,2016.csv,2016,0.007241151869427242,0.9927588481305728
3643,Qué León,7807916,2607916,5200000,2018.csv,2018,0.33400922858288945,0.6659907714171105
3644,Bibi & Tina voll verhext!,7807600,0,7807600,2014.csv,2014,0.0,1.0
3645,Axel 2: Adventures of the Spacekids,7806368,0,7806368,2017.csv,2017,0.0,1.0
3646,Bad Words,7804337,7779614,24723,2014.csv,2014,0.9968321460234226,0.0031678539765773828
3647,Pitbull. Nowe porzadki,7802960,0,7802960,2016.csv,2016,0.0,1.0
3648,Carrossel: O Filme,7802639,0,7802639,2015.csv,2015,0.0,1.0
3649,Long Live the King,7801577,0,7801577,2019.csv,2019,0.0,1.0
3650,Amazing Grace,7796112,4450456,3345656,2018.csv,2018,0.5708558317274046,0.4291441682725954
3651,Warsaw '44,7795076,0,7795076,2014.csv,2014,0.0,1.0
3652,False Trail,7778326,0,7778326,2011.csv,2011,0.0,1.0
3653,Soar Into the Sun,7772028,0,7772028,2012.csv,2012,0.0,1.0
3654,Twilight Gangsters,7765343,0,7765343,2010.csv,2010,0.0,1.0
3655,Will You Be There?,7762907,0,7762907,2016.csv,2016,0.0,1.0
3656,The Marriage Escape,7760946,0,7760946,2020.csv,2020,0.0,1.0
3657,By the Grace of God,7755652,67059,7688593,2019.csv,2019,0.00864646840781407,0.991353531592186
3658,8 novykh svidaniy,7752894,0,7752894,2015.csv,2015,0.0,1.0
3659,Muita Calma Nessa Hora,7744506,0,7744506,2010.csv,2010,0.0,1.0
3660,3 idiotas,7738470,1249233,6489237,2017.csv,2017,0.16143152328561072,0.8385684767143893
3661,Certified Copy,7736632,1373975,6362657,2010.csv,2010,0.17759342825146654,0.8224065717485335
3662,Spirited Away Studio Ghibli Fest 2020,7733107,0,7733107,2020.csv,2020,0.0,1.0
3663,Love Live! Sunshine!! The School Idol Movie: Over The Rainbow,7733048,34135,7698913,2019.csv,2019,0.004414171488396296,0.9955858285116037
3664,Un + une,7732614,0,7732614,2015.csv,2015,0.0,1.0
3665,Explosion,7731410,122700,7608710,2017.csv,2017,0.015870326369963564,0.9841296736300365
3666,Cedar Rapids,7728936,6861102,867834,2011.csv,2011,0.8877162393374716,0.11228376066252845
3667,Selam,7728852,0,7728852,2013.csv,2013,0.0,1.0
3668,Mia madre,7723656,303002,7420654,2015.csv,2015,0.03923038519581918,0.9607696148041808
3669,Hayabusa: The Long Voyage Home,7713159,0,7713159,2012.csv,2012,0.0,1.0
3670,Snow Flower,7709399,0,7709399,2019.csv,2019,0.0,1.0
3671,The Sweeney,7708312,26650,7681662,2012.csv,2012,0.0034573068656276497,0.9965426931343724
3672,Kevin Hart: Laugh at My Pain,7706436,7706436,0,2011.csv,2011,1.0,0.0
3673,BPM (Beats Per Minute),7704369,125189,7579180,2017.csv,2017,0.01624909191135575,0.9837509080886443
3674,The Disappearance of Haruhi Suzumiya,7701498,0,7701498,2010.csv,2010,0.0,1.0
3675,Who Am I,7700259,0,7700259,2014.csv,2014,0.0,1.0
3676,Penguins,7699452,7699452,0,2019.csv,2019,1.0,0.0
3677,No,7699095,2343664,5355431,2012.csv,2012,0.30440772584310233,0.6955922741568976
3678,Squadron 303,7694425,0,7694425,2018.csv,2018,0.0,1.0
3679,Neposredstvenno Kakha,7692780,0,7692780,2020.csv,2020,0.0,1.0
3680,Declaration of War,7691610,59100,7632510,2011.csv,2011,0.007683696911309856,0.9923163030886901
3681,Finding Fanny,7685784,615691,7070093,2014.csv,2014,0.08010776779571219,0.9198922322042878
3682,Leave No Trace,7682928,6046104,1636824,2018.csv,2018,0.7869530991309563,0.21304690086904368
3683,Princess Mononoke Studio Ghibli Fest 2020,7673207,0,7673207,2020.csv,2020,0.0,1.0
3684,I Am: Sm Town Live World Tour In Madison Square Garden,7665780,0,7665780,2012.csv,2012,0.0,1.0
3685,Leopardi,7664764,0,7664764,2014.csv,2014,0.0,1.0
3686,Lolo,7663798,24134,7639664,2015.csv,2015,0.0031490913513117125,0.9968509086486883
3687,Praybeyt Benjamin,7654855,0,7654855,2011.csv,2011,0.0,1.0
3688,Paper Planes,7646673,0,7646673,2015.csv,2015,0.0,1.0
3689,Return of the Mafia,7646534,0,7646534,2012.csv,2012,0.0,1.0
3690,Beautiful World,7641409,0,7641409,2012.csv,2012,0.0,1.0
3691,Sauerkrautkoma,7640109,0,7640109,2018.csv,2018,0.0,1.0
3692,Youth Never Returns,7636318,0,7636318,2015.csv,2015,0.0,1.0
3693,Pandas,7635778,7574012,61766,2018.csv,2018,0.9919109748869074,0.008089025113092601
3694,Just Getting Started,7634022,6069605,1564417,2017.csv,2017,0.7950730296559271,0.2049269703440729
3695,The White Crow,7622595,1828784,5793811,2019.csv,2019,0.23991619651837728,0.7600838034816227
3696,Fullmetal Alchemist: The Sacred Star of Milos,7621364,177802,7443562,2011.csv,2011,0.023329419773153465,0.9766705802268465
3697,Rafadan Tayfa 2: Göbeklitepe,7616298,0,7616298,2019.csv,2019,0.0,1.0
3698,The Emperor of Paris,7611035,0,7611035,2018.csv,2018,0.0,1.0
3699,ABCD (Any Body Can Dance),7610738,222098,7388640,2013.csv,2013,0.029182189690408474,0.9708178103095916
3700,Only Lovers Left Alive,7609187,1879534,5729653,2013.csv,2013,0.24700851746710917,0.7529914825328908
3701,A Street Cat Named Bob 2018 Re-release,7606781,0,7606781,2018.csv,2018,0.0,1.0
3702,Hükümet Kadin 2013 Re-release,7603249,0,7603249,2013.csv,2013,0.0,1.0
3703,Thor: Legend of the Magical Hammer,7600557,0,7600557,2011.csv,2011,0.0,1.0
3704,Klovn Forever,7585569,5700,7579869,2015.csv,2015,0.0007514268211125625,0.9992485731788875
3705,Verliefd op Ibiza,7581025,0,7581025,2013.csv,2013,0.0,1.0
3706,"Coconut, the Little Dragon",7580620,0,7580620,2014.csv,2014,0.0,1.0
3707,Zhenikh,7580125,0,7580125,2016.csv,2016,0.0,1.0
3708,Burning,7578063,718991,6859072,2018.csv,2018,0.09487793912507721,0.9051220608749228
3709,Matinee,7576145,0,7576145,2019.csv,2019,0.0,1.0
3710,Miss You Already,7573997,1162653,6411344,2015.csv,2015,0.15350587015019942,0.8464941298498005
3711,The Best Is Yet to Come,7571799,0,7571799,2019.csv,2019,0.0,1.0
3712,Guzaarish,7564310,1017335,6546975,2010.csv,2010,0.13449144733624085,0.8655085526637591
3713,The Heist of the Century,7558890,0,7558890,2020.csv,2020,0.0,1.0
3714,Hippocrates: Diary of a French Doctor,7555591,23050,7532541,2014.csv,2014,0.003050720982647155,0.9969492790173529
3715,Monica and Friends: Bonds,7554706,0,7554706,2019.csv,2019,0.0,1.0
3716,"Kiki, Love to Love",7551282,12450,7538832,2016.csv,2016,0.001648726666544833,0.9983512733334552
3717,Insane,7550254,0,7550254,2016.csv,2016,0.0,1.0
3718,The Advocate: A Missing Body,7550177,50162,7500015,2015.csv,2015,0.006643817754206292,0.9933561822457937
3719,Take Me Home Tonight,7550073,6928068,622005,2011.csv,2011,0.9176160283483352,0.08238397165166482
3720,A Bigger Splash,7545758,2024099,5521659,2015.csv,2015,0.2682432964322471,0.7317567035677529
3721,Donui mat,7539438,0,7539438,2012.csv,2012,0.0,1.0
3722,Albert Nobbs,7532259,3014696,4517563,2011.csv,2011,0.4002379631396106,0.5997620368603894
3723,Kamen Rider Reiwa: The First Generation,7529337,0,7529337,2019.csv,2019,0.0,1.0
3724,Ah Boys to Men II,7517054,0,7517054,2013.csv,2013,0.0,1.0
3725,Beirut,7509436,5019226,2490210,2018.csv,2018,0.6683892105878524,0.3316107894121476
3726,Where Do We Go Now?,7507008,531997,6975011,2011.csv,2011,0.07086671547439406,0.929133284525606
3727,The Whistleblower,7505141,280851,7224290,2019.csv,2019,0.037421149049698066,0.9625788509503019
3728,Fukushima 50,7494243,0,7494243,2020.csv,2020,0.0,1.0
3729,Mortal Ouija,7489619,0,7489619,2019.csv,2019,0.0,1.0
3730,Open Season 3,7487555,0,7487555,2010.csv,2010,0.0,1.0
3731,Frantz,7478354,880883,6597471,2016.csv,2016,0.11779102727685799,0.882208972723142
3732,Wild 7,7477941,0,7477941,2011.csv,2011,0.0,1.0
3733,Gogol. Viy,7471349,0,7471349,2018.csv,2018,0.0,1.0
3734,F.C. De Kampioenen,7471304,0,7471304,2013.csv,2013,0.0,1.0
3735,Killer Toon,7468796,0,7468796,2013.csv,2013,0.0,1.0
3736,Way to Find the Best Life,7466578,0,7466578,2019.csv,2019,0.0,1.0
3737,The Tall Man,7462847,0,7462847,2012.csv,2012,0.0,1.0
3738,Ostwind 3: Aufbruch nach Ora,7456105,0,7456105,2017.csv,2017,0.0,1.0
3739,Big Game,7455398,24752,7430646,2015.csv,2015,0.0033200105480619547,0.996679989451938
3740,Black Nativity,7454185,7018189,435996,2013.csv,2013,0.941509903497163,0.058490096502837
3741,I'll See You in My Dreams,7452512,7449681,2831,2015.csv,2015,0.999620128085671,0.00037987191432902086
3742,Hunter x Hunter: The Last Mission,7449778,0,7449778,2013.csv,2013,0.0,1.0
3743,Einstein and Einstein,7448509,0,7448509,2018.csv,2018,0.0,1.0
3744,Belleville Cop,7446815,0,7446815,2018.csv,2018,0.0,1.0
3745,Yu-Gi-Oh!: The Dark Side of Dimensions,7445186,1015339,6429847,2016.csv,2016,0.13637523629362652,0.8636247637063735
3746,Amitiés sincères,7445019,0,7445019,2013.csv,2013,0.0,1.0
3747,Finding Mr. Destiny,7444073,0,7444073,2010.csv,2010,0.0,1.0
3748,Prizrak,7442911,0,7442911,2015.csv,2015,0.0,1.0
3749,Brittany Runs a Marathon,7442106,7189808,252298,2019.csv,2019,0.9660985747851482,0.033901425214851816
3750,Mayday Life,7435496,85912,7349584,2019.csv,2019,0.011554306531803662,0.9884456934681963
3751,Genius,7435006,1361045,6073961,2016.csv,2016,0.1830590318286226,0.8169409681713774
3752,"Remi, Nobody's Boy",7434840,0,7434840,2018.csv,2018,0.0,1.0
3753,Beatriz at Dinner,7425391,7115854,309537,2017.csv,2017,0.958313710348721,0.04168628965127897
3754,The Morning After,7423443,0,7423443,2018.csv,2018,0.0,1.0
3755,Witching and Bitching,7422695,0,7422695,2013.csv,2013,0.0,1.0
3756,The Mystical Laws,7415910,0,7415910,2012.csv,2012,0.0,1.0
3757,Brazilian Western,7415529,0,7415529,2013.csv,2013,0.0,1.0
3758,God's Not Dead: A Light in Darkness,7414178,5728940,1685238,2018.csv,2018,0.7727006284445828,0.2272993715554172
3759,My World,7406037,0,7406037,2013.csv,2013,0.0,1.0
3760,Goodbye Christopher Robin,7401949,1735251,5666698,2017.csv,2017,0.23443163415473411,0.7655683658452659
3761,The Innocents,7400324,1065665,6334659,2016.csv,2016,0.14400247881038722,0.8559975211896128
3762,Sakurada Gate Incident,7394930,0,7394930,2010.csv,2010,0.0,1.0
3763,Hükümet Kadin,7392014,0,7392014,2013.csv,2013,0.0,1.0
3764,On the Way to School,7390938,0,7390938,2013.csv,2013,0.0,1.0
3765,Happy Little Submarines 4 - Adventures of Octopus,7390000,0,7390000,2014.csv,2014,0.0,1.0
3766,Survival Game,7387436,0,7387436,2016.csv,2016,0.0,1.0
3767,Deliha,7384858,0,7384858,2014.csv,2014,0.0,1.0
3768,The Great Passage,7362767,0,7362767,2013.csv,2013,0.0,1.0
3769,"Pettson and Findus: A Little Nuisance, a Great Friendship",7362745,0,7362745,2014.csv,2014,0.0,1.0
3770,Return of the Hero,7362730,37108,7325622,2018.csv,2018,0.005039978377585488,0.9949600216224145
3771,Missing Woman,7356458,0,7356458,2016.csv,2016,0.0,1.0
3772,Lupin III: The First,7355549,136368,7219181,2019.csv,2019,0.018539472716448492,0.9814605272835515
3773,Us in the U.S.,7354579,0,7354579,2013.csv,2013,0.0,1.0
3774,Compadres,7353544,3127773,4225771,2016.csv,2016,0.4253422567404234,0.5746577432595766
3775,Asura,7353354,0,7353354,2018.csv,2018,0.0,1.0
3776,Pretty Cure Miracle Universe,7350621,0,7350621,2019.csv,2019,0.0,1.0
3777,Bride for Rent,7348239,0,7348239,2014.csv,2014,0.0,1.0
3778,McDull: Me & My Mum,7346610,0,7346610,2014.csv,2014,0.0,1.0
3779,A Company Man,7339398,0,7339398,2012.csv,2012,0.0,1.0
3780,The Young Messiah,7330338,6490401,839937,2016.csv,2016,0.8854163341444828,0.11458366585551717
3781,Broken,7326038,0,7326038,2014.csv,2014,0.0,1.0
3782,A City Called Macau,7322128,0,7322128,2019.csv,2019,0.0,1.0
3783,The Tribe,7318071,0,7318071,2018.csv,2018,0.0,1.0
3784,Even the Rain,7313485,518017,6795468,2011.csv,2011,0.07083039070976423,0.9291696092902357
3785,Kuroko's Basketball: Last Game,7313308,0,7313308,2017.csv,2017,0.0,1.0
3786,Apparition,7312653,0,7312653,2016.csv,2016,0.0,1.0
3787,Mann tut was Mann kann,7304731,0,7304731,2012.csv,2012,0.0,1.0
3788,Patiala House,7298915,0,7298915,2011.csv,2011,0.0,1.0
3789,The Suicide Forecast,7295261,0,7295261,2011.csv,2011,0.0,1.0
3790,The Beaver,7294800,970816,6323984,2011.csv,2011,0.13308329220814827,0.8669167077918517
3791,Monkey King Reborn,7290000,0,7290000,2021.csv,2021,0.0,1.0
3792,Bilet na Vegas,7286913,0,7286913,2013.csv,2013,0.0,1.0
3793,The Midwife,7286136,603582,6682554,2017.csv,2017,0.08283979327314231,0.9171602067268577
3794,Poveri ma ricchissimi,7285527,0,7285527,2017.csv,2017,0.0,1.0
3795,No Mercy,7282606,0,7282606,2010.csv,2010,0.0,1.0
3796,The Anderssons in Greece,7279565,0,7279565,2012.csv,2012,0.0,1.0
3797,Policeman and Me,7278360,0,7278360,2017.csv,2017,0.0,1.0
3798,Rebels,7276133,0,7276133,2019.csv,2019,0.0,1.0
3799,Hanni & Nanni 3,7275454,0,7275454,2013.csv,2013,0.0,1.0
3800,Poveri ma ricchi,7272904,0,7272904,2016.csv,2016,0.0,1.0
3801,Full Speed,7268779,0,7268779,2016.csv,2016,0.0,1.0
3802,The Chart of Love,7259785,0,7259785,2014.csv,2014,0.0,1.0
3803,A Long Way Down,7257942,13347,7244595,2014.csv,2014,0.0018389510414935804,0.9981610489585064
3804,Never on the First Night,7255685,0,7255685,2014.csv,2014,0.0,1.0
3805,What We Do in the Shadows,7251226,3469224,3782002,2014.csv,2014,0.4784327505445286,0.5215672494554714
3806,Run for Love,7250876,0,7250876,2016.csv,2016,0.0,1.0
3807,Inazuma Eleven: The Movie,7243674,0,7243674,2012.csv,2012,0.0,1.0
3808,Zip & Zap and the Marble Gang,7242740,0,7242740,2013.csv,2013,0.0,1.0
3809,Bon Bini Holland 2,7237986,0,7237986,2018.csv,2018,0.0,1.0
3810,Let There Be Light,7233471,7233471,0,2017.csv,2017,1.0,0.0
3811,Courted,7227045,0,7227045,2015.csv,2015,0.0,1.0
3812,Camille Rewinds,7223101,0,7223101,2012.csv,2012,0.0,1.0
3813,Ivan Tsarevich and the Grey Wolf 4,7217184,0,7217184,2019.csv,2019,0.0,1.0
3814,Birth of the Dragon,7215027,6901965,313062,2017.csv,2017,0.95660972578481,0.043390274215190046
3815,20th Century Women,7214806,5664764,1550042,2016.csv,2016,0.785158187205588,0.21484181279441195
3816,Love Lasts Three Years,7211547,0,7211547,2012.csv,2012,0.0,1.0
3817,Naughty Grandma 2,7209951,0,7209951,2019.csv,2019,0.0,1.0
3818,Animal Kingdom,7208231,1044039,6164192,2010.csv,2010,0.14483983657016541,0.8551601634298346
3819,Tricky Old Dogs,7205775,0,7205775,2018.csv,2018,0.0,1.0
3820,Grandma,7205073,6980524,224549,2015.csv,2015,0.9688345975120585,0.03116540248794148
3821,La scuola più bella del mondo,7200564,0,7200564,2014.csv,2014,0.0,1.0
3822,Animal,7196268,0,7196268,2013.csv,2013,0.0,1.0
3823,Control,7193515,0,7193515,2013.csv,2013,0.0,1.0
3824,Akko's Secret,7192718,0,7192718,2012.csv,2012,0.0,1.0
3825,Not My Day,7186834,0,7186834,2014.csv,2014,0.0,1.0
3826,Gonzaga: From Father to Son,7183742,0,7183742,2012.csv,2012,0.0,1.0
3827,Heroes Wanted,7179946,0,7179946,2016.csv,2016,0.0,1.0
3828,Timbuktu,7179391,1076075,6103316,2014.csv,2014,0.1498838829087314,0.8501161170912686
3829,The Courier,7179317,4910448,2268869,2021.csv,2021,0.6839714697094446,0.3160285302905555
3830,Heroic Losers,7176273,0,7176273,2019.csv,2019,0.0,1.0
3831,Hypnotisören,7168568,0,7168568,2012.csv,2012,0.0,1.0
3832,Blade of the Immortal,7162617,150532,7012085,2017.csv,2017,0.021016340815095937,0.978983659184904
3833,Toc Toc,7158925,0,7158925,2017.csv,2017,0.0,1.0
3834,Jesus Loves Me,7158880,0,7158880,2012.csv,2012,0.0,1.0
3835,The Anderssons Hit the Road,7155992,0,7155992,2013.csv,2013,0.0,1.0
3836,The (UN)perfect Guy,7154649,0,7154649,2020.csv,2020,0.0,1.0
3837,The Big Trip,7147367,0,7147367,2019.csv,2019,0.0,1.0
3838,De Gaulle,7145454,0,7145454,2020.csv,2020,0.0,1.0
3839,Gogol. A Terrible Vengeance,7141571,0,7141571,2018.csv,2018,0.0,1.0
3840,Mammuth,7137183,0,7137183,2010.csv,2010,0.0,1.0
3841,Wild Rose,7123449,1635117,5488332,2019.csv,2019,0.22954007251262695,0.770459927487373
3842,Baar Baar Dekho,7122579,981947,6140632,2016.csv,2016,0.13786396753198527,0.8621360324680147
3843,Hanni & Nanni,7119791,0,7119791,2010.csv,2010,0.0,1.0
3844,Kamen Rider Drive: Surprise Future,7118376,0,7118376,2015.csv,2015,0.0,1.0
3845,Postman Pat: The Movie,7102455,1519,7100936,2014.csv,2014,0.00021386971124773055,0.9997861302887523
3846,Boomerang Family,7102103,0,7102103,2013.csv,2013,0.0,1.0
3847,Incendies,7099598,2071334,5028264,2011.csv,2011,0.2917537021110209,0.7082462978889791
3848,McDull: Pork of Music 2017 Re-release,7093313,0,7093313,2017.csv,2017,0.0,1.0
3849,Back to the Wharf,7090000,0,7090000,2020.csv,2020,0.0,1.0
3850,The Most Beautiful Day in the World,7088166,0,7088166,2019.csv,2019,0.0,1.0
3851,Crying 100 Times: Every Raindrop Falls,7086598,0,7086598,2013.csv,2013,0.0,1.0
3852,In Safe Hands,7086596,1737,7084859,2018.csv,2018,0.0002451106285725897,0.9997548893714274
3853,Adu,7085946,0,7085946,2020.csv,2020,0.0,1.0
3854,De nieuwe wildernis,7084997,0,7084997,2013.csv,2013,0.0,1.0
3855,GG Bond: Ultimate Battle,7080000,0,7080000,2015.csv,2015,0.0,1.0
3856,A Dog's Courage,7072240,0,7072240,2019.csv,2019,0.0,1.0
3857,Reminiscence,7065019,0,7065019,2017.csv,2017,0.0,1.0
3858,Dreamy Eyes,7061163,0,7061163,2019.csv,2019,0.0,1.0
3859,Always Be with You,7052423,0,7052423,2017.csv,2017,0.0,1.0
3860,Naples in Veils,7050856,0,7050856,2017.csv,2017,0.0,1.0
3861,Roco Kingdom 3,7050000,0,7050000,2014.csv,2014,0.0,1.0
3862,You're My Pet,7039663,0,7039663,2011.csv,2011,0.0,1.0
3863,O chyom govoryat muzhchiny. Prodolzhenie,7035897,0,7035897,2018.csv,2018,0.0,1.0
3864,The Map Against the World,7035812,34034,7001778,2016.csv,2016,0.004837252615618496,0.9951627473843815
3865,The Best Years,7035246,0,7035246,2020.csv,2020,0.0,1.0
3866,Marie-Francine,7034772,0,7034772,2017.csv,2017,0.0,1.0
3867,Head Over Heels 3,7033642,0,7033642,2019.csv,2019,0.0,1.0
3868,The Joneses,7031729,1475746,5555983,2010.csv,2010,0.2098695783071276,0.7901304216928724
3869,Fuga de cerebros 2,7030376,0,7030376,2011.csv,2011,0.0,1.0
3870,En solitaire,7029858,0,7029858,2013.csv,2013,0.0,1.0
3871,Cosmopolis,7029095,763556,6265539,2012.csv,2012,0.10862792436295142,0.8913720756370486
3872,The Killing of a Sacred Deer,7027336,2291901,4735435,2017.csv,2017,0.3261408021474994,0.6738591978525006
3873,My Darling Is a Foreigner,7020126,0,7020126,2010.csv,2010,0.0,1.0
3874,The Dumpling Affair,7017501,0,7017501,2017.csv,2017,0.0,1.0
3875,Pretty Cure Super Stars,7017326,0,7017326,2018.csv,2018,0.0,1.0
3876,Un Natale stupefacente,7015989,0,7015989,2014.csv,2014,0.0,1.0
3877,The Kid with a Bike,7011798,1470000,5541798,2011.csv,2011,0.20964665553685374,0.7903533444631463
3878,The Last Station 2010 Re-release,7003548,0,7003548,2010.csv,2010,0.0,1.0
3879,Jack Strong,7002827,0,7002827,2014.csv,2014,0.0,1.0
3880,Jessabelle,6998359,0,6998359,2014.csv,2014,0.0,1.0
3881,Amazing,6990000,0,6990000,2013.csv,2013,0.0,1.0
3882,To Each His Own,6988027,0,6988027,2017.csv,2017,0.0,1.0
3883,Team Batista Final: Kerberos No Shouzou,6987812,0,6987812,2014.csv,2014,0.0,1.0
3884,The Bride,6985353,0,6985353,2017.csv,2017,0.0,1.0
3885,Goon,6985158,4168528,2816630,2012.csv,2012,0.5967693214670305,0.40323067853296946
3886,Yeom-lyeok,6981970,0,6981970,2018.csv,2018,0.0,1.0
3887,Kôdaike no hitobito,6978689,0,6978689,2016.csv,2016,0.0,1.0
3888,Spycies,6978537,0,6978537,2020.csv,2020,0.0,1.0
3889,Halal police d'État,6973154,0,6973154,2011.csv,2011,0.0,1.0
3890,The Unholy,6967056,6733474,233582,2021.csv,2021,0.966473356895653,0.03352664310434709
3891,Ask This of Rikyu,6966862,0,6966862,2013.csv,2013,0.0,1.0
3892,The Princess of Montpensier,6965201,352428,6612773,2010.csv,2010,0.05059839622718713,0.9494016037728129
3893,11-11-11,6963872,32771,6931101,2011.csv,2011,0.004705859039339034,0.9952941409606609
3894,We Love,6961334,0,6961334,2018.csv,2018,0.0,1.0
3895,Hatred,6960645,0,6960645,2016.csv,2016,0.0,1.0
3896,The Clown,6955643,0,6955643,2011.csv,2011,0.0,1.0
3897,S.I.U.,6954255,0,6954255,2011.csv,2011,0.0,1.0
3898,The Salesman,6953604,2402067,4551537,2016.csv,2016,0.3454420182685123,0.6545579817314877
3899,Crossroads,6943105,0,6943105,2011.csv,2011,0.0,1.0
3900,Always,6941450,0,6941450,2011.csv,2011,0.0,1.0
3901,"Treintona, Soltera y Fantástica",6932071,0,6932071,2016.csv,2016,0.0,1.0
3902,Çok Filim Hareketler Bunlar,6928959,0,6928959,2010.csv,2010,0.0,1.0
3903,The Command,6926443,0,6926443,2018.csv,2018,0.0,1.0
3904,The Spectacular Now,6918591,6854611,63980,2013.csv,2013,0.9907524523418135,0.009247547658186472
3905,Hasee Toh Phasee,6914987,646035,6268952,2014.csv,2014,0.09342533832673872,0.9065746616732613
3906,Don 2,6913518,3680306,3233212,2011.csv,2011,0.5323347679141068,0.46766523208589317
3907,Ivan the Incredible,6907409,0,6907409,2012.csv,2012,0.0,1.0
3908,Fünf Freunde 4,6904651,0,6904651,2015.csv,2015,0.0,1.0
3909,The Collini Case,6901301,0,6901301,2019.csv,2019,0.0,1.0
3910,Centurion,6890432,123570,6766862,2010.csv,2010,0.01793356352693126,0.9820664364730688
3911,Barbara,6889185,1013902,5875283,2012.csv,2012,0.147172996515553,0.852827003484447
3912,Jim Button and the Wild 13,6880898,0,6880898,2020.csv,2020,0.0,1.0
3913,Viva l'Italia,6880371,0,6880371,2012.csv,2012,0.0,1.0
3914,The Awakening,6879667,209696,6669971,2011.csv,2011,0.03048054506126532,0.9695194549387347
3915,Talvar,6879098,342370,6536728,2015.csv,2015,0.049769606422237336,0.9502303935777626
3916,Heartbeat,6869987,0,6869987,2011.csv,2011,0.0,1.0
3917,Golden Chickensss,6866023,0,6866023,2014.csv,2014,0.0,1.0
3918,Haru wo seotte,6853262,0,6853262,2014.csv,2014,0.0,1.0
3919,Antebellum,6852361,0,6852361,2020.csv,2020,0.0,1.0
3920,Proud of Me,6849959,0,6849959,2018.csv,2018,0.0,1.0
3921,National Theatre Live: Fleabag,6848451,326283,6522168,2019.csv,2019,0.047643328396450524,0.9523566716035494
3922,Bacon on the Side,6846472,0,6846472,2010.csv,2010,0.0,1.0
3923,Macross Frontier: The Wings of Goodbye,6845201,0,6845201,2011.csv,2011,0.0,1.0
3924,Dog Days,6842356,6809080,33276,2018.csv,2018,0.995136762834322,0.004863237165678021
3925,The Bugle from Gutian,6836934,0,6836934,2019.csv,2019,0.0,1.0
3926,Commitment,6834802,76543,6758259,2013.csv,2013,0.011199007666937535,0.9888009923330625
3927,72 Tenants of Prosperity,6833354,0,6833354,2010.csv,2010,0.0,1.0
3928,Jai Gangaajal,6831758,0,6831758,2016.csv,2016,0.0,1.0
3929,My Love Story!!,6830188,0,6830188,2015.csv,2015,0.0,1.0
3930,The Lady Shogun and Her Men 2012 Re-release,6827946,0,6827946,2012.csv,2012,0.0,1.0
3931,Ibiza,6822634,0,6822634,2019.csv,2019,0.0,1.0
3932,GG Bond: Guarding,6821075,0,6821075,2017.csv,2017,0.0,1.0
3933,The Reunion,6820097,0,6820097,2011.csv,2011,0.0,1.0
3934,Collide,6817535,2280004,4537531,2016.csv,2016,0.3344323131454404,0.6655676868545596
3935,Race 3,6817391,1690861,5126530,2018.csv,2018,0.2480217138785204,0.7519782861214797
3936,Hoodwinked Too! Hood vs. Evil 2014 Re-release,6817189,0,6817189,2014.csv,2014,0.0,1.0
3937,Bran Nue Dae,6812530,113568,6698962,2010.csv,2010,0.016670458698897474,0.9833295413011025
3938,Armor Hero Atlas,6810000,0,6810000,2014.csv,2014,0.0,1.0
3939,Bruce Lee - The Fighter,6806042,0,6806042,2015.csv,2015,0.0,1.0
3940,Fuga di cervelli,6804918,0,6804918,2013.csv,2013,0.0,1.0
3941,The Names of Love,6803887,514237,6289650,2010.csv,2010,0.07557988543901449,0.9244201145609855
3942,Silver Spoon,6803548,0,6803548,2014.csv,2014,0.0,1.0
3943,The Trouble with You,6795812,0,6795812,2018.csv,2018,0.0,1.0
3944,King Naresuan: Part Three,6790191,0,6790191,2011.csv,2011,0.0,1.0
3945,Baahubali: The Beginning,6787855,6738000,49855,2015.csv,2015,0.9926552644392079,0.007344735560792032
3946,Happy Little Submarine: Magic Box of Time 2015 Re-release,6787300,0,6787300,2015.csv,2015,0.0,1.0
3947,A Little Bit of Heaven,6778388,15375,6763013,2011.csv,2011,0.002268238407125706,0.9977317615928742
3948,Playing Doctor,6774594,0,6774594,2014.csv,2014,0.0,1.0
3949,The Anderssons Rock the Mountains,6772812,0,6772812,2014.csv,2014,0.0,1.0
3950,Unforgiven,6763059,0,6763059,2013.csv,2013,0.0,1.0
3951,The Sun Is also a Star,6750029,4950029,1800000,2019.csv,2019,0.7333344790074235,0.26666552099257645
3952,A Letter to Momo,6748888,71712,6677176,2012.csv,2012,0.010625750494007309,0.9893742495059927
3953,Resturlaub,6747405,0,6747405,2011.csv,2011,0.0,1.0
3954,The Little Penguin Pororo's Racing Adventure,6743451,0,6743451,2013.csv,2013,0.0,1.0
3955,The Resident,6742156,0,6742156,2011.csv,2011,0.0,1.0
3956,Telling Tales,6740968,0,6740968,2015.csv,2015,0.0,1.0
3957,Midnight Special,6740647,3712282,3028365,2016.csv,2016,0.5507308126356416,0.44926918736435834
3958,Wild Card,6738764,0,6738764,2015.csv,2015,0.0,1.0
3959,Just to Be Sure,6726393,0,6726393,2017.csv,2017,0.0,1.0
3960,The Snows of Kilimanjaro,6726049,0,6726049,2011.csv,2011,0.0,1.0
3961,Psy 3: W imie zasad,6725146,0,6725146,2020.csv,2020,0.0,1.0
3962,Churchill,6724365,1281258,5443107,2017.csv,2017,0.19053962716182124,0.8094603728381787
3963,Cesar Chavez 2014 Re-release,6719925,5571497,1148428,2014.csv,2014,0.8291010688363337,0.17089893116366625
3964,Pati Patni Aur Woh,6712525,874044,5838481,2019.csv,2019,0.13021091169120413,0.8697890883087959
3965,Tiec Trang Mau,6709383,0,6709383,2020.csv,2020,0.0,1.0
3966,Ex 2: Still Friends?,6704951,0,6704951,2011.csv,2011,0.0,1.0
3967,El infierno,6703873,0,6703873,2010.csv,2010,0.0,1.0
3968,Jab Tak Hai Jaan,6703114,3047539,3655575,2012.csv,2012,0.45464525890504026,0.5453547410949597
3969,Chronicle of a Blood Merchant,6702181,0,6702181,2015.csv,2015,0.0,1.0
3970,Bleed for This,6698679,5083906,1614773,2016.csv,2016,0.7589415763914049,0.24105842360859506
3971,Kaizoku Sentai Gokaiger vs. Space Sheriff Gavan: The Movie,6688303,0,6688303,2012.csv,2012,0.0,1.0
3972,Muita Calma Nessa Hora 2,6682223,0,6682223,2014.csv,2014,0.0,1.0
3973,3096 Tage,6677474,0,6677474,2013.csv,2013,0.0,1.0
3974,"Snowflake, the White Gorilla",6674402,0,6674402,2011.csv,2011,0.0,1.0
3975,Fahrenheit 11/9,6674168,6352306,321862,2018.csv,2018,0.9517749628118441,0.048225037188155885
3976,GG Bond 2,6670000,0,6670000,2014.csv,2014,0.0,1.0
3977,The Immortal,6667823,0,6667823,2019.csv,2019,0.0,1.0
3978,Incir Reçeli 2,6664484,0,6664484,2014.csv,2014,0.0,1.0
3979,Innocence,6659968,0,6659968,2020.csv,2020,0.0,1.0
3980,Son of Saul,6659121,1777043,4882078,2015.csv,2015,0.2668584937861919,0.7331415062138081
3981,April Fools,6652777,0,6652777,2015.csv,2015,0.0,1.0
3982,Meow,6651598,0,6651598,2017.csv,2017,0.0,1.0
3983,Blade Runner Secret Cinema/Final Cut,6644842,0,6644842,2017.csv,2017,0.0,1.0
3984,Lost White,6640736,0,6640736,2016.csv,2016,0.0,1.0
3985,The Conquest,6637166,74474,6562692,2011.csv,2011,0.011220752953896287,0.9887792470461038
3986,Southside with You,6628603,6304223,324380,2016.csv,2016,0.9510635951496869,0.04893640485031311
3987,Windstorm,6626314,0,6626314,2013.csv,2013,0.0,1.0
3988,Red Dog: True Blue,6625303,0,6625303,2016.csv,2016,0.0,1.0
3989,Teenosaurus Rex,6618024,0,6618024,2017.csv,2017,0.0,1.0
3990,Pieta,6616296,22080,6594216,2012.csv,2012,0.003337214659078131,0.9966627853409219
3991,Boss Wants a Happy Ending,6615264,0,6615264,2014.csv,2014,0.0,1.0
3992,The World of Kanako,6611265,0,6611265,2014.csv,2014,0.0,1.0
3993,Billion,6606931,0,6606931,2019.csv,2019,0.0,1.0
3994,Saenai hiroin no sodatekata,6606609,0,6606609,2019.csv,2019,0.0,1.0
3995,Detective Gui,6600000,0,6600000,2015.csv,2015,0.0,1.0
3996,The Red Turtle,6591789,921974,5669815,2016.csv,2016,0.13986703761300612,0.8601329623869939
3997,Fatale,6591122,6306897,284225,2020.csv,2020,0.956877599898773,0.043122400101227074
3998,Prey 2019 Re-release,6589175,0,6589175,2019.csv,2019,0.0,1.0
3999,Man of Vendetta,6588417,0,6588417,2010.csv,2010,0.0,1.0
4000,Presumed Guilty,6585640,0,6585640,2011.csv,2011,0.0,1.0
4001,We Are Brothers,6581575,0,6581575,2014.csv,2014,0.0,1.0
4002,Soorma,6579645,390077,6189568,2018.csv,2018,0.05928541737434163,0.9407145826256583
4003,Shubh Mangal Zyada Saavdhan,6574905,0,6574905,2020.csv,2020,0.0,1.0
4004,Silver Skates,6573398,0,6573398,2020.csv,2020,0.0,1.0
4005,Ghanchakkar,6571685,203044,6368641,2013.csv,2013,0.030896794353350777,0.9691032056466492
4006,Do You See Me?,6571282,0,6571282,2014.csv,2014,0.0,1.0
4007,Bunny Drop,6569857,0,6569857,2011.csv,2011,0.0,1.0
4008,The Raid 2,6566916,2627209,3939707,2014.csv,2014,0.4000673984561398,0.5999326015438602
4009,A Melody to Remember,6559996,44263,6515733,2016.csv,2016,0.006747412650861372,0.9932525873491387
4010,The Crucifixion,6554322,0,6554322,2017.csv,2017,0.0,1.0
4011,Fasten Your Seatbelts,6549909,0,6549909,2014.csv,2014,0.0,1.0
4012,From the Land of the Moon,6547983,47748,6500235,2016.csv,2016,0.007292016488130773,0.9927079835118692
4013,Days of Our Own,6545251,0,6545251,2016.csv,2016,0.0,1.0
4014,Chhapaak,6532100,604334,5927766,2020.csv,2020,0.09251756709174691,0.907482432908253
4015,The Stolen Princess,6530901,0,6530901,2018.csv,2018,0.0,1.0
4016,Kakekomi,6528543,0,6528543,2015.csv,2015,0.0,1.0
4017,Hanni and Nanni 2,6523603,0,6523603,2012.csv,2012,0.0,1.0
4018,No Other Woman,6522701,0,6522701,2011.csv,2011,0.0,1.0
4019,Loro 1,6521238,0,6521238,2018.csv,2018,0.0,1.0
4020,The Measure of a Man,6518931,112391,6406540,2015.csv,2015,0.017240710171652376,0.9827592898283476
4021,All Inclusive 2018 Re-release,6517607,0,6517607,2018.csv,2018,0.0,1.0
4022,Dressed to Marry,6515448,0,6515448,2014.csv,2014,0.0,1.0
4023,"New York, I Love You 2010 Re-release",6507581,0,6507581,2010.csv,2010,0.0,1.0
4024,The Lobster,6504366,376871,6127495,2015.csv,2015,0.057941235164195866,0.9420587648358041
4025,The Cobbler,6501058,0,6501058,2015.csv,2015,0.0,1.0
4026,Wadjda,6499169,1347747,5151422,2012.csv,2012,0.20737220404639423,0.7926277959536058
4027,Jealous,6497695,0,6497695,2017.csv,2017,0.0,1.0
4028,It's Kind of a Funny Story,6491240,6363628,127612,2010.csv,2010,0.9803408901843099,0.01965910981569007
4029,Bleach the Movie: Hell Verse 2010 Re-release,6488991,0,6488991,2010.csv,2010,0.0,1.0
4030,Everybody Loves Somebody,6481798,1915789,4566009,2017.csv,2017,0.2955644406073747,0.7044355593926254
4031,"What a Wonderful Family! 3: My Wife, My Life",6474589,0,6474589,2018.csv,2018,0.0,1.0
4032,The New Adventures of Cinderella,6466643,0,6466643,2017.csv,2017,0.0,1.0
4033,Il professor Cenerentolo,6462232,0,6462232,2015.csv,2015,0.0,1.0
4034,Gloria,6461559,2107925,4353634,2013.csv,2013,0.32622545116433976,0.6737745488356602
4035,Delibal,6457515,0,6457515,2015.csv,2015,0.0,1.0
4036,Panfilov's 28,6457240,0,6457240,2016.csv,2016,0.0,1.0
4037,The King's Letters,6454970,0,6454970,2019.csv,2019,0.0,1.0
4038,Natsume's Book of Friends,6442104,0,6442104,2018.csv,2018,0.0,1.0
4039,Hammamet,6434874,0,6434874,2020.csv,2020,0.0,1.0
4040,Waiting for Superman,6433688,6417135,16553,2010.csv,2010,0.9974271366594091,0.002572863340590964
4041,S: The Last Policeman: Recovery of Our Future,6425190,0,6425190,2015.csv,2015,0.0,1.0
4042,Dear Tutu,6425179,0,6425179,2017.csv,2017,0.0,1.0
4043,Run the Race,6424420,6424420,0,2019.csv,2019,1.0,0.0
4044,Same Kind of Different as Me,6423605,6423605,0,2017.csv,2017,1.0,0.0
4045,K.G.F: Chapter 1,6421597,0,6421597,2018.csv,2018,0.0,1.0
4046,2 + 2,6418254,0,6418254,2012.csv,2012,0.0,1.0
4047,Wonderful Nightmare,6416760,0,6416760,2015.csv,2015,0.0,1.0
4048,Kamen Rider Heisei Generations: Dr. Pac-Man vs. Ex-Aid & Ghost with Legend Rider,6414904,0,6414904,2016.csv,2016,0.0,1.0
4049,Fixies vs Krabots,6413907,0,6413907,2019.csv,2019,0.0,1.0
4050,Gotti,6412349,4343227,2069122,2018.csv,2018,0.6773223041977284,0.3226776958022715
4051,A los 40,6411771,0,6411771,2014.csv,2014,0.0,1.0
4052,The Mustang,6405816,5043620,1362196,2019.csv,2019,0.7873501205779249,0.2126498794220752
4053,Lindenberg! Mach dein Ding,6404964,0,6404964,2020.csv,2020,0.0,1.0
4054,Dragon Rider,6402404,0,6402404,2020.csv,2020,0.0,1.0
4055,The Admiral,6398252,0,6398252,2015.csv,2015,0.0,1.0
4056,Midnight Swan,6397065,0,6397065,2020.csv,2020,0.0,1.0
4057,Andel Páne 2,6397046,0,6397046,2016.csv,2016,0.0,1.0
4058,Nausicaä of the Valley of the Wind 2020 Re-release,6395525,0,6395525,2020.csv,2020,0.0,1.0
4059,A Journey Through Time with Antony,6389648,127381,6262267,2015.csv,2015,0.01993552696486567,0.9800644730351343
4060,Bride and Groom,6384565,0,6384565,2018.csv,2018,0.0,1.0
4061,Operation Carwash: A Worldwide Corruption Scandal Made in Brazil,6382550,0,6382550,2017.csv,2017,0.0,1.0
4062,"Love Me, Love Me Not",6379631,0,6379631,2020.csv,2020,0.0,1.0
4063,Here Comes Every Body,6373398,0,6373398,2012.csv,2012,0.0,1.0
4064,The Mafia Kills Only in Summer,6369335,0,6369335,2013.csv,2013,0.0,1.0
4065,"Farewell, My Queen",6366835,1597998,4768837,2012.csv,2012,0.25098781419653565,0.7490121858034644
4066,Dumped,6366790,0,6366790,2018.csv,2018,0.0,1.0
4067,The Mistress,6362114,0,6362114,2012.csv,2012,0.0,1.0
4068,Life Back Then,6360462,0,6360462,2011.csv,2011,0.0,1.0
4069,Impossibility Defense,6356312,0,6356312,2018.csv,2018,0.0,1.0
4070,Kis Kisko Pyaar Karoon,6355432,0,6355432,2015.csv,2015,0.0,1.0
4071,Shinjuku Swan II,6355297,0,6355297,2017.csv,2017,0.0,1.0
4072,Dino Time,6353856,0,6353856,2012.csv,2012,0.0,1.0
4073,The Monkey King Havoc in Heavens Palace 2017 Re-release,6347492,0,6347492,2017.csv,2017,0.0,1.0
4074,Women of Mafia 2,6347417,0,6347417,2019.csv,2019,0.0,1.0
4075,Greenberg,6344112,4234170,2109942,2010.csv,2010,0.6674172839319357,0.3325827160680644
4076,Railways,6343854,0,6343854,2010.csv,2010,0.0,1.0
4077,Hector and the Search for Happiness,6337728,1124445,5213283,2014.csv,2014,0.17742083598412553,0.8225791640158745
4078,Hampstead,6335171,144396,6190775,2017.csv,2017,0.02279275492326884,0.9772072450767312
4079,Closed Circuit,6331939,5750401,581538,2013.csv,2013,0.9081579907829181,0.09184200921708184
4080,An Inspector Calls,6331372,0,6331372,2015.csv,2015,0.0,1.0
4081,Honnouji Hotel,6330984,0,6330984,2017.csv,2017,0.0,1.0
4082,Persona Non Grata,6325922,0,6325922,2015.csv,2015,0.0,1.0
4083,Simply Black,6323750,0,6323750,2020.csv,2020,0.0,1.0
4084,Inside or Outside,6323457,0,6323457,2016.csv,2016,0.0,1.0
4085,Song Of Love,6323085,0,6323085,2019.csv,2019,0.0,1.0
4086,Traffic Department,6322254,0,6322254,2013.csv,2013,0.0,1.0
4087,The Legend of the Mummies of Guanajuato,6321314,0,6321314,2014.csv,2014,0.0,1.0
4088,The Merciless,6321112,0,6321112,2017.csv,2017,0.0,1.0
4089,Kizumonogatari Part 1: Tekketsu,6319100,0,6319100,2016.csv,2016,0.0,1.0
4090,The Hidden Face,6318409,0,6318409,2011.csv,2011,0.0,1.0
4091,The Last Women Standing,6313827,163406,6150421,2015.csv,2015,0.02588065843425865,0.9741193415657413
4092,The Kitchen,6313817,0,6313817,2017.csv,2017,0.0,1.0
4093,He's on Duty,6313107,0,6313107,2010.csv,2010,0.0,1.0
4094,Lowriders,6312033,6303560,8473,2017.csv,2017,0.9986576432664405,0.0013423567335595363
4095,Kaasan Mom's Life,6309343,0,6309343,2011.csv,2011,0.0,1.0
4096,Go Lala Go 2,6308232,0,6308232,2012.csv,2012,0.0,1.0
4097,Absolutely Anything,6303792,20169,6283623,2015.csv,2015,0.003199502775472287,0.9968004972245277
4098,A Late Quartet,6303709,1562548,4741161,2012.csv,2012,0.24787755906879586,0.7521224409312042
4099,Antoinette dans les Cévennes,6299870,0,6299870,2020.csv,2020,0.0,1.0
4100,Sara's Notebook,6298717,0,6298717,2018.csv,2018,0.0,1.0
4101,La croisière,6298642,0,6298642,2011.csv,2011,0.0,1.0
4102,My Boyfriend's Meds,6292780,2971116,3321664,2020.csv,2020,0.47214680951820975,0.5278531904817902
4103,Pitbull. Ostanti pies,6291978,0,6291978,2018.csv,2018,0.0,1.0
4104,Os Parças,6290388,0,6290388,2017.csv,2017,0.0,1.0
4105,Xin DaTou Er Zi He Xiao Tou Ba Ba Zhi Mi Mi Ji Hua,6290000,0,6290000,2014.csv,2014,0.0,1.0
4106,Docteur?,6278182,0,6278182,2019.csv,2019,0.0,1.0
4107,Hospitality Department,6275245,0,6275245,2013.csv,2013,0.0,1.0
4108,Bill & Ted Face the Music,6274027,3439660,2834367,2020.csv,2020,0.5482379977006793,0.4517620022993207
4109,Max Steel,6272403,3818664,2453739,2016.csv,2016,0.6088039942586597,0.3911960057413403
4110,Metal Fight Bay Blade the Movie & Duel Masters 2010,6260631,0,6260631,2010.csv,2010,0.0,1.0
4111,God Willing,6246660,0,6246660,2015.csv,2015,0.0,1.0
4112,Samurai Shifters,6246509,0,6246509,2019.csv,2019,0.0,1.0
4113,Family For Rent,6243133,0,6243133,2015.csv,2015,0.0,1.0
4114,Automata,6237990,0,6237990,2014.csv,2014,0.0,1.0
4115,Solovey-Razboynik,6236954,0,6236954,2012.csv,2012,0.0,1.0
4116,The Idolmaster Movie: Beyond the Brilliant Future!,6234533,0,6234533,2014.csv,2014,0.0,1.0
4117,Space Dogs: Adventure to the Moon,6232433,0,6232433,2014.csv,2014,0.0,1.0
4118,The Crocodiles: All for One,6226507,0,6226507,2011.csv,2011,0.0,1.0
4119,Görümce,6225902,0,6225902,2016.csv,2016,0.0,1.0
4120,Vortex,6225444,0,6225444,2019.csv,2019,0.0,1.0
4121,The Test,6224290,0,6224290,2013.csv,2013,0.0,1.0
4122,Norman,6217567,3814868,2402699,2017.csv,2017,0.6135628293189281,0.38643717068107186
4123,The Deal,6217271,0,6217271,2015.csv,2015,0.0,1.0
4124,Unbroken: Path to Redemption,6216897,6216897,0,2018.csv,2018,1.0,0.0
4125,"Don't Cry, Mommy",6216889,0,6216889,2012.csv,2012,0.0,1.0
4126,Sampiyon,6214362,0,6214362,2018.csv,2018,0.0,1.0
4127,Attack the Block,6206022,1024175,5181847,2011.csv,2011,0.16502922484000218,0.8349707751599978
4128,All Inclusive ili Vsyo vklyucheno!,6204495,0,6204495,2011.csv,2011,0.0,1.0
4129,Great Expectations,6202879,258656,5944223,2012.csv,2012,0.041699346384154845,0.9583006536158452
4130,The Final Judgement,6200881,0,6200881,2012.csv,2012,0.0,1.0
4131,The Snitch Cartel,6197324,0,6197324,2012.csv,2012,0.0,1.0
4132,Never Look Away,6193234,1304042,4889192,2018.csv,2018,0.2105591359861423,0.7894408640138577
4133,Seer,6192965,0,6192965,2011.csv,2011,0.0,1.0
4134,Yeh Jawaani Hai Deewani,6189998,3827466,2362532,2013.csv,2013,0.6183307329016907,0.38166926709830923
4135,It's a Fairy!,6186539,0,6186539,2016.csv,2016,0.0,1.0
4136,Illang: The Wolf Brigade,6186447,0,6186447,2018.csv,2018,0.0,1.0
4137,Immortal Hero,6180032,43007,6137025,2019.csv,2019,0.006959025454884376,0.9930409745451156
4138,Police Dog Dream,6174380,0,6174380,2010.csv,2010,0.0,1.0
4139,Mad Mom,6170982,0,6170982,2018.csv,2018,0.0,1.0
4140,Tuscan Wedding,6170884,0,6170884,2014.csv,2014,0.0,1.0
4141,The Autopsy of Jane Doe,6170043,10474,6159569,2016.csv,2016,0.0016975570510610704,0.9983024429489389
4142,Tiger & Bunny: The Rising,6168617,34471,6134146,2014.csv,2014,0.005588124534235146,0.9944118754657648
4143,Keep Calm and Be a Superstar,6168544,0,6168544,2018.csv,2018,0.0,1.0
4144,Alice and the Mayor,6163499,0,6163499,2019.csv,2019,0.0,1.0
4145,Life Is a Wonderful Thing,6161728,0,6161728,2010.csv,2010,0.0,1.0
4146,Darker Than Night,6160114,870063,5290051,2014.csv,2014,0.14124137962381866,0.8587586203761813
4147,The Patriarch,6156936,2156047,4000889,2016.csv,2016,0.3501818112125902,0.6498181887874098
4148,Kocan Kadar Konus: Dirilis,6155274,0,6155274,2016.csv,2016,0.0,1.0
4149,Yo-kai Watch Jam The Movie: Yo-kai Academy Y - Can a Cat be a Hero?,6154894,0,6154894,2019.csv,2019,0.0,1.0
4150,Iron Ivan,6153545,0,6153545,2014.csv,2014,0.0,1.0
4151,Kath & Kimderella,6150771,0,6150771,2012.csv,2012,0.0,1.0
4152,Four Lions,6148687,304616,5844071,2010.csv,2010,0.0495416338480069,0.9504583661519931
4153,Ploey,6146292,77815,6068477,2018.csv,2018,0.012660478870837898,0.9873395211291621
4154,Ace Attorney,6145395,0,6145395,2012.csv,2012,0.0,1.0
4155,Naughty Grandma,6143216,0,6143216,2017.csv,2017,0.0,1.0
4156,King Naresuan 5,6136917,0,6136917,2014.csv,2014,0.0,1.0
4157,At River's Edge,6136255,0,6136255,2011.csv,2011,0.0,1.0
4158,Podatek od milosci,6134686,0,6134686,2018.csv,2018,0.0,1.0
4159,Dedemin Insanlari,6130561,0,6130561,2011.csv,2011,0.0,1.0
4160,Mobile Suit Gundam Narrative,6126259,259224,5867035,2018.csv,2018,0.04231358811307194,0.957686411886928
4161,Verónica,6123089,0,6123089,2017.csv,2017,0.0,1.0
4162,Gang Tie Fei Long Zhi Zai Jian Ao Te Man,6120728,0,6120728,2017.csv,2017,0.0,1.0
4163,Ultraman Saga,6120006,0,6120006,2012.csv,2012,0.0,1.0
4164,Happy Family,6111219,0,6111219,2010.csv,2010,0.0,1.0
4165,The Duelist,6101904,13450,6088454,2016.csv,2016,0.0022042300239400684,0.9977957699760599
4166,Ice Age: The Meltdown 2014 Re-release,6095750,0,6095750,2014.csv,2014,0.0,1.0
4167,The Trip to Italy,6089109,2880537,3208572,2014.csv,2014,0.4730637930771152,0.5269362069228848
4168,Hotel Belgrade,6085537,0,6085537,2020.csv,2020,0.0,1.0
4169,This Guy's in Love with U Mare!,6082709,0,6082709,2012.csv,2012,0.0,1.0
4170,Lady Maiko,6081729,0,6081729,2014.csv,2014,0.0,1.0
4171,High & Low: The Worst,6081142,0,6081142,2019.csv,2019,0.0,1.0
4172,Oh My God,6080330,0,6080330,2012.csv,2012,0.0,1.0
4173,Bygones Be Bygones,6076337,0,6076337,2017.csv,2017,0.0,1.0
4174,The Ideal Palace,6067463,0,6067463,2019.csv,2019,0.0,1.0
4175,The Trough,6061514,0,6061514,2018.csv,2018,0.0,1.0
4176,The Adventures of Sinbad,6060000,0,6060000,2013.csv,2013,0.0,1.0
4177,Hayabusa,6056604,0,6056604,2011.csv,2011,0.0,1.0
4178,The Yellow Eyes of the Crocodiles,6056272,0,6056272,2014.csv,2014,0.0,1.0
4179,Beautiful Lies,6054202,0,6054202,2010.csv,2010,0.0,1.0
4180,Meet the Mormons,6047363,6047363,0,2014.csv,2014,1.0,0.0
4181,One Wild Moment,6045343,0,6045343,2015.csv,2015,0.0,1.0
4182,She's Funny That Way,6034851,111996,5922855,2015.csv,2015,0.01855820466818485,0.9814417953318152
4183,Journey to the Christmas Star,6031008,0,6031008,2012.csv,2012,0.0,1.0
4184,The Legacy Of Dr. Death: Black File,6024046,0,6024046,2020.csv,2020,0.0,1.0
4185,Børning,6015494,0,6015494,2014.csv,2014,0.0,1.0
4186,Matru ki Bijlee ka Mandola,6009116,0,6009116,2013.csv,2013,0.0,1.0
4187,Eight Ranger 2,6007941,0,6007941,2014.csv,2014,0.0,1.0
4188,The Illusionist,6007194,2231474,3775720,2010.csv,2010,0.3714669444669175,0.6285330555330825
4189,Blue Exorcist: The Movie,5994921,21796,5973125,2012.csv,2012,0.0036357443242371335,0.9963642556757629
4190,The Broken Circle Breakdown,5990754,175058,5815696,2012.csv,2012,0.029221363454416588,0.9707786365455834
4191,Judas and the Black Messiah,5990000,5285000,705000,2021.csv,2021,0.8823038397328882,0.11769616026711185
4192,The Rhythm Section,5989583,5437971,551612,2020.csv,2020,0.9079047740051353,0.09209522599486475
4193,"Cyrano, My Love",5985822,351019,5634803,2019.csv,2019,0.058641737091413675,0.9413582629085864
4194,You Will Be My Son,5985600,0,5985600,2011.csv,2011,0.0,1.0
4195,A Man in a Hurry,5984514,0,5984514,2018.csv,2018,0.0,1.0
4196,Parallel Life,5976223,0,5976223,2010.csv,2010,0.0,1.0
4197,Liberation,5975914,0,5975914,2019.csv,2019,0.0,1.0
4198,Jak zostalem gangsterem. Historia prawdziwa,5975729,0,5975729,2020.csv,2020,0.0,1.0
4199,Princess Lillifee and the Little Unicorn,5972430,0,5972430,2011.csv,2011,0.0,1.0
4200,Fantastic Journey to Oz,5970922,0,5970922,2017.csv,2017,0.0,1.0
4201,Unforgiven,5969619,0,5969619,2018.csv,2018,0.0,1.0
4202,Learning to Drive,5967516,3447633,2519883,2015.csv,2015,0.5777333483479559,0.4222666516520442
4203,The Apprehenders,5963910,0,5963910,2011.csv,2011,0.0,1.0
4204,The Goldfish,5961121,0,5961121,2019.csv,2019,0.0,1.0
4205,Genghis Khan,5957524,0,5957524,2018.csv,2018,0.0,1.0
4206,National Song Contest,5953187,0,5953187,2013.csv,2013,0.0,1.0
4207,The Immigrant,5952884,2025328,3927556,2013.csv,2013,0.340226350790642,0.659773649209358
4208,Russendisko,5952091,0,5952091,2012.csv,2012,0.0,1.0
4209,Balala the Fairies: Princess Camellia,5950000,0,5950000,2015.csv,2015,0.0,1.0
4210,All Saints,5942565,5802208,140357,2017.csv,2017,0.9763810745023404,0.02361892549765968
4211,"Last Winter, We Parted",5941231,0,5941231,2018.csv,2018,0.0,1.0
4212,"Bystree, chem kroliki",5938041,0,5938041,2014.csv,2014,0.0,1.0
4213,Laws of the Universe Part 1,5937936,0,5937936,2018.csv,2018,0.0,1.0
4214,Miss Forever,5932063,0,5932063,2019.csv,2019,0.0,1.0
4215,Ghost Sweepers,5931660,0,5931660,2012.csv,2012,0.0,1.0
4216,Late Autumn,5929771,0,5929771,2011.csv,2011,0.0,1.0
4217,Yucatán,5922726,0,5922726,2018.csv,2018,0.0,1.0
4218,How Are You,5921481,0,5921481,2017.csv,2017,0.0,1.0
4219,Dealer/Healer,5919976,0,5919976,2017.csv,2017,0.0,1.0
4220,Water and Fire,5919180,0,5919180,2013.csv,2013,0.0,1.0
4221,How to Be a Good Wife,5916091,0,5916091,2020.csv,2020,0.0,1.0
4222,Penguin Bloom,5908280,0,5908280,2021.csv,2021,0.0,1.0
4223,Crimea,5904389,0,5904389,2017.csv,2017,0.0,1.0
4224,Jolly LLB,5903218,0,5903218,2013.csv,2013,0.0,1.0
4225,Kolpaçino 3. Devre,5902752,0,5902752,2016.csv,2016,0.0,1.0
4226,My Father's Guests,5902718,0,5902718,2010.csv,2010,0.0,1.0
4227,Drowning Love,5895838,0,5895838,2016.csv,2016,0.0,1.0
4228,Vampire Sisters 3: Journey to Transylvania,5894544,0,5894544,2016.csv,2016,0.0,1.0
4229,Death of a Nation,5885881,5885881,0,2018.csv,2018,1.0,0.0
4230,Maggie's Plan,5883891,3351735,2532156,2016.csv,2016,0.5696460046591618,0.43035399534083824
4231,Blue Story,5881391,0,5881391,2019.csv,2019,0.0,1.0
4232,Twiceborn,5880157,11527,5868630,2020.csv,2020,0.001960321807734045,0.9980396781922659
4233,No Rest for the Wicked,5878860,0,5878860,2011.csv,2011,0.0,1.0
4234,Hello Carbot the Movie: The Cretaceous Period,5876438,0,5876438,2018.csv,2018,0.0,1.0
4235,Testament of Youth,5874883,1822250,4052633,2015.csv,2015,0.31017638989576474,0.6898236101042353
4236,My Life as a Zucchini,5872598,309766,5562832,2016.csv,2016,0.05274769361022157,0.9472523063897784
4237,Wonderful Radio,5857353,0,5857353,2012.csv,2012,0.0,1.0
4238,Tracks,5853509,510007,5343502,2014.csv,2014,0.08712842160147016,0.9128715783985298
4239,The Balkan Line,5849400,0,5849400,2019.csv,2019,0.0,1.0
4240,Men in Hope 2011 Re-release,5847126,0,5847126,2011.csv,2011,0.0,1.0
4241,20 Feet from Stardom,5839368,4946445,892923,2013.csv,2013,0.847085677765128,0.152914322234872
4242,What a Wonderful Family,5837878,0,5837878,2017.csv,2017,0.0,1.0
4243,She's Dating the Gangster,5837612,0,5837612,2014.csv,2014,0.0,1.0
4244,Kirakira Pretty Cure A La Mode the Movie,5832342,0,5832342,2017.csv,2017,0.0,1.0
4245,The Royal Bride,5830719,0,5830719,2020.csv,2020,0.0,1.0
4246,SMS für Dich,5828223,0,5828223,2016.csv,2016,0.0,1.0
4247,Young Goethe in Love,5826565,162138,5664427,2010.csv,2010,0.027827373418128864,0.9721726265818711
4248,Wannabe Widowed,5824753,0,5824753,2013.csv,2013,0.0,1.0
4249,Love+Sling,5823505,0,5823505,2018.csv,2018,0.0,1.0
4250,The Guilty Ones,5823434,0,5823434,2019.csv,2019,0.0,1.0
4251,Puella Magi Madoka Magica the Movie Part 1: Beginnings,5816330,180440,5635890,2012.csv,2012,0.031022999038912855,0.9689770009610872
4252,Sea Level,5813098,0,5813098,2011.csv,2011,0.0,1.0
4253,We Are Family,5813070,0,5813070,2016.csv,2016,0.0,1.0
4254,Love at Second Sight,5810856,0,5810856,2019.csv,2019,0.0,1.0
4255,Anadolu Kartallari,5810196,0,5810196,2011.csv,2011,0.0,1.0
4256,24 Hours to Live,5805201,0,5805201,2017.csv,2017,0.0,1.0
4257,Phillauri,5805030,467596,5337434,2017.csv,2017,0.08055014358237597,0.919449856417624
4258,One Week Friends,5804519,0,5804519,2017.csv,2017,0.0,1.0
4259,The Little Penguin Pororo's Dinosaur Island Adventure,5803077,0,5803077,2017.csv,2017,0.0,1.0
4260,Sunny: Our Hearts Beat Together,5799863,0,5799863,2018.csv,2018,0.0,1.0
4261,The Man from the Future,5799606,0,5799606,2011.csv,2011,0.0,1.0
4262,Beyond,5796679,0,5796679,2010.csv,2010,0.0,1.0
4263,Beasts Clawing at Straws,5796059,0,5796059,2020.csv,2020,0.0,1.0
4264,Phoenix,5793245,3184472,2608773,2014.csv,2014,0.5496870924671752,0.4503129075328249
4265,The Wizard of Oz 2013 3D/IMAX Release,5787802,5633202,154600,2013.csv,2013,0.9732886508557135,0.026711349144286554
4266,My Love or My Passion,5786238,0,5786238,2017.csv,2017,0.0,1.0
4267,The Place,5784397,0,5784397,2017.csv,2017,0.0,1.0
4268,Dylan Dog: Dead of Night,5782515,1186538,4595977,2011.csv,2011,0.20519410671654115,0.7948058932834589
4269,"Joséphine, Pregnant & Fabulous",5777198,0,5777198,2016.csv,2016,0.0,1.0
4270,The Skeleton Twins,5776640,5284309,492331,2014.csv,2014,0.9147720820407711,0.08522791795922889
4271,Gekijo-ban Tiger & Bunny -The Rising,5776323,0,5776323,2012.csv,2012,0.0,1.0
4272,Ghayal Once Again,5775619,0,5775619,2016.csv,2016,0.0,1.0
4273,A Funny Man,5772688,0,5772688,2011.csv,2011,0.0,1.0
4274,My Brother Loves Me Too Much,5758464,0,5758464,2017.csv,2017,0.0,1.0
4275,Deadly Code,5757236,0,5757236,2013.csv,2013,0.0,1.0
4276,Furie,5756185,594788,5161397,2019.csv,2019,0.10333024390286275,0.8966697560971373
4277,Dragon Force: Rise of Ultraman,5755641,0,5755641,2019.csv,2019,0.0,1.0
4278,Ladda Land,5755172,0,5755172,2011.csv,2011,0.0,1.0
4279,Ah Boys to Men,5751428,0,5751428,2012.csv,2012,0.0,1.0
4280,Nyanki,5751022,0,5751022,2012.csv,2012,0.0,1.0
4281,All Stars,5749245,0,5749245,2013.csv,2013,0.0,1.0
4282,Magic Tree House,5747918,0,5747918,2012.csv,2012,0.0,1.0
4283,The Disappointments Room,5745040,2423468,3321572,2016.csv,2016,0.42183657555038784,0.5781634244496122
4284,I Am Your Mom,5743612,0,5743612,2018.csv,2018,0.0,1.0
4285,Under the Skin,5735963,2614251,3121712,2014.csv,2014,0.4557649691952336,0.5442350308047663
4286,Carbon,5734206,0,5734206,2017.csv,2017,0.0,1.0
4287,The King's Musketeers,5728960,0,5728960,2018.csv,2018,0.0,1.0
4288,The Devil's Double,5728213,1361512,4366701,2011.csv,2011,0.2376852955712366,0.7623147044287634
4289,Kingsglaive: Final Fantasy XV,5725482,269980,5455502,2016.csv,2016,0.04715410859731984,0.9528458914026802
4290,Dulce Familia,5725043,0,5725043,2019.csv,2019,0.0,1.0
4291,The House by the Sea,5720804,0,5720804,2017.csv,2017,0.0,1.0
4292,The 100th Love with You,5716791,0,5716791,2017.csv,2017,0.0,1.0
4293,Like for Likes,5715555,50839,5664716,2016.csv,2016,0.008894849231614427,0.9911051507683856
4294,Moulin Rouge! 2017 Re-release,5714701,0,5714701,2017.csv,2017,0.0,1.0
4295,11 A.M.,5713402,0,5713402,2013.csv,2013,0.0,1.0
4296,They Call Me Jeeg,5713331,0,5713331,2016.csv,2016,0.0,1.0
4297,Saaho,5708522,2872057,2836465,2019.csv,2019,0.5031174444103045,0.4968825555896956
4298,My Best Friend's Wedding,5707770,78578,5629192,2016.csv,2016,0.013766847648030668,0.9862331523519693
4299,Sweet Alibis,5707124,0,5707124,2014.csv,2014,0.0,1.0
4300,Akumu Chan the Movie,5707018,0,5707018,2014.csv,2014,0.0,1.0
4301,The Haunted House: The Sky Ghost vs Jormungandr,5705509,0,5705509,2019.csv,2019,0.0,1.0
4302,Santa's Apprentice,5705323,0,5705323,2010.csv,2010,0.0,1.0
4303,Action Replayy,5702135,0,5702135,2010.csv,2010,0.0,1.0
4304,Yeob-gi-jeok-in geu-nyeo 2,5701519,0,5701519,2016.csv,2016,0.0,1.0
4305,Buddha: The Great Departure,5700005,0,5700005,2011.csv,2011,0.0,1.0
4306,The Summit,5699056,0,5699056,2017.csv,2017,0.0,1.0
4307,Poison Berry in My Brain,5697583,0,5697583,2015.csv,2015,0.0,1.0
4308,A Messenger from Heaven,5696781,0,5696781,2013.csv,2013,0.0,1.0
4309,The Kings of Mykonos,5696661,0,5696661,2010.csv,2010,0.0,1.0
4310,Superheroes,5692116,0,5692116,2010.csv,2010,0.0,1.0
4311,Phineas and Ferb the Movie: Candace Against the Universe,5689121,0,5689121,2011.csv,2011,0.0,1.0
4312,The Viral Factor,5687319,220496,5466823,2012.csv,2012,0.03876976128822737,0.9612302387117726
4313,No Filter,5682744,0,5682744,2019.csv,2019,0.0,1.0
4314,I Love Hong Kong 2013,5682465,0,5682465,2013.csv,2013,0.0,1.0
4315,Brave: Gunjyo Senki,5677186,0,5677186,2021.csv,2021,0.0,1.0
4316,Balls,5674287,0,5674287,2010.csv,2010,0.0,1.0
4317,Wish I Was Here,5670776,3591299,2079477,2014.csv,2014,0.6332993932400081,0.36670060675999194
4318,Scoop!,5669344,0,5669344,2016.csv,2016,0.0,1.0
4319,Knight Rusty,5669013,0,5669013,2013.csv,2013,0.0,1.0
4320,Mission Mangal,5667057,3659413,2007644,2019.csv,2019,0.6457342850089561,0.35426571499104387
4321,The Pact,5664404,0,5664404,2012.csv,2012,0.0,1.0
4322,Last Letter,5663972,0,5663972,2020.csv,2020,0.0,1.0
4323,Matrimonio a Parigi,5661517,0,5661517,2011.csv,2011,0.0,1.0
4324,The Finishers,5660973,0,5660973,2014.csv,2014,0.0,1.0
4325,Anomalisa,5659286,3759286,1900000,2015.csv,2015,0.6642686020816053,0.3357313979183946
4326,The Lies She Loved,5657262,0,5657262,2018.csv,2018,0.0,1.0
4327,A Warrior's Tail,5655766,0,5655766,2015.csv,2015,0.0,1.0
4328,The Icebreaker,5653694,0,5653694,2016.csv,2016,0.0,1.0
4329,A Chance Encounter,5652523,0,5652523,2014.csv,2014,0.0,1.0
4330,Mister Twister Goes Camping,5651752,0,5651752,2013.csv,2013,0.0,1.0
4331,The Right Mistake,5650000,0,5650000,2015.csv,2015,0.0,1.0
4332,Don't Stop Me Now,5649257,0,5649257,2019.csv,2019,0.0,1.0
4333,Cuban Fury,5645773,92384,5553389,2014.csv,2014,0.016363392577066063,0.9836366074229339
4334,Incident in a Ghostland,5643957,0,5643957,2018.csv,2018,0.0,1.0
4335,Back to the Future 2014 Re-release,5641847,0,5641847,2014.csv,2014,0.0,1.0
4336,Inuyashiki,5638796,0,5638796,2018.csv,2018,0.0,1.0
4337,Things to Come,5638693,388140,5250553,2016.csv,2016,0.0688351006164017,0.9311648993835983
4338,The Miracle 2: Love,5637997,0,5637997,2019.csv,2019,0.0,1.0
4339,F.C. De Kampioenen 2: Jubilee general,5635272,0,5635272,2015.csv,2015,0.0,1.0
4340,Pagalpanti,5633633,423340,5210293,2019.csv,2019,0.07514511506163074,0.9248548849383692
4341,Wazir,5633588,1124045,4509543,2016.csv,2016,0.19952559541095302,0.800474404589047
4342,"April, May and June",5628939,0,5628939,2019.csv,2019,0.0,1.0
4343,What a Beautiful Surprise,5626528,0,5626528,2015.csv,2015,0.0,1.0
4344,Yowamushi Pedal: The Movie 2020 Re-release,5624218,0,5624218,2020.csv,2020,0.0,1.0
4345,How to Break Up with Your Douchebag,5623811,0,5623811,2017.csv,2017,0.0,1.0
4346,Dalida,5623134,3465,5619669,2017.csv,2017,0.0006162044155447833,0.9993837955844552
4347,Mother and Child,5621971,1110509,4511462,2010.csv,2010,0.19753019003477607,0.802469809965224
4348,The Frozen Ground,5617460,0,5617460,2013.csv,2013,0.0,1.0
4349,Solitary Man,5615390,4360548,1254842,2010.csv,2010,0.7765352005826843,0.22346479941731562
4350,Ah Boys to Men 3: Frogmen,5607373,0,5607373,2015.csv,2015,0.0,1.0
4351,The Source,5605676,0,5605676,2011.csv,2011,0.0,1.0
4352,El Angel,5604680,109608,5495072,2018.csv,2018,0.01955651348515883,0.9804434865148411
4353,The Party,5597950,749827,4848123,2017.csv,2017,0.13394671263587563,0.8660532873641243
4354,Tamara,5595545,0,5595545,2016.csv,2016,0.0,1.0
4355,Sadako,5589910,0,5589910,2019.csv,2019,0.0,1.0
4356,The Last Shot in the Bar,5589299,0,5589299,2017.csv,2017,0.0,1.0
4357,Another,5588517,0,5588517,2012.csv,2012,0.0,1.0
4358,Fathers & Daughters,5587709,0,5587709,2015.csv,2015,0.0,1.0
4359,The French Minister,5586646,12027,5574619,2013.csv,2013,0.0021528122598066892,0.9978471877401933
4360,Suicide Forest Village,5584171,0,5584171,2021.csv,2021,0.0,1.0
4361,Destroyer,5580940,1533324,4047616,2018.csv,2018,0.2747429644468495,0.7252570355531506
4362,Pawn Sacrifice,5578519,2436633,3141886,2014.csv,2014,0.4367885096384901,0.56321149036151
4363,Hate Story 3,5571064,0,5571064,2015.csv,2015,0.0,1.0
4364,Penoza: The Final Chapter,5567617,0,5567617,2019.csv,2019,0.0,1.0
4365,Knock Knock,5567103,36336,5530767,2015.csv,2015,0.00652691354911163,0.9934730864508884
4366,Cua lai vo bau,5564332,0,5564332,2019.csv,2019,0.0,1.0
4367,Dheepan,5562575,261819,5300756,2014.csv,2014,0.047067949645622754,0.9529320503543772
4368,First Love,5556608,218329,5338279,2018.csv,2018,0.03929177656584736,0.9607082234341526
4369,Cetto c'è senzadubbiamente,5556301,0,5556301,2019.csv,2019,0.0,1.0
4370,Dedh Ishqiya,5554054,0,5554054,2014.csv,2014,0.0,1.0
4371,Cousinhood,5552832,0,5552832,2011.csv,2011,0.0,1.0
4372,Escobar: Paradise Lost,5552496,195792,5356704,2014.csv,2014,0.03526197947733776,0.9647380205226622
4373,Two Hearts as One,5552285,0,5552285,2014.csv,2014,0.0,1.0
4374,"Me gusta, pero me asusta",5549592,0,5549592,2017.csv,2017,0.0,1.0
4375,The Clink of Ice,5549266,0,5549266,2010.csv,2010,0.0,1.0
4376,All for One,5548993,0,5548993,2011.csv,2011,0.0,1.0
4377,Terra Formars,5546898,0,5546898,2016.csv,2016,0.0,1.0
4378,The Piper,5546500,0,5546500,2015.csv,2015,0.0,1.0
4379,Dancing Elephant,5546451,0,5546451,2019.csv,2019,0.0,1.0
4380,Klassikokkutulek 2: Pulmad ja matused,5543147,0,5543147,2020.csv,2020,0.0,1.0
4381,Ek Tha Tiger,5543117,2347774,3195343,2012.csv,2012,0.42354761770318033,0.5764523822968196
4382,Last Cab to Darwin,5543036,34193,5508843,2015.csv,2015,0.006168641156218361,0.9938313588437816
4383,Wood Job!,5540404,0,5540404,2014.csv,2014,0.0,1.0
4384,The Boundary,5540000,0,5540000,2014.csv,2014,0.0,1.0
4385,Way Back Home,5538648,0,5538648,2011.csv,2011,0.0,1.0
4386,House of Wolves,5531346,0,5531346,2016.csv,2016,0.0,1.0
4387,Kishiryu Sentai Ryusoulger: Time Slip! Dinosaur Panic!!/Kamen Rider Zi-O: Over Quartzer,5530199,0,5530199,2019.csv,2019,0.0,1.0
4388,Five,5528469,0,5528469,2016.csv,2016,0.0,1.0
4389,Ruby Red,5524381,0,5524381,2013.csv,2013,0.0,1.0
4390,C'est tout pour moi,5521370,0,5521370,2017.csv,2017,0.0,1.0
4391,Empowered,5520738,0,5520738,2018.csv,2018,0.0,1.0
4392,All for Two,5513338,0,5513338,2013.csv,2013,0.0,1.0
4393,Z'olushka,5508956,0,5508956,2012.csv,2012,0.0,1.0
4394,On My Way,5505705,317324,5188381,2013.csv,2013,0.057635489006403355,0.9423645109935966
4395,Dude's Manual,5504560,0,5504560,2018.csv,2018,0.0,1.0
4396,Legendary,5501541,0,5501541,2014.csv,2014,0.0,1.0
4397,Love Addict,5498768,0,5498768,2018.csv,2018,0.0,1.0
4398,Warriors of the Dawn,5497176,84532,5412644,2017.csv,2017,0.015377350115768533,0.9846226498842314
4399,Tale of Tales,5497104,118925,5378179,2015.csv,2015,0.021634118619549492,0.9783658813804506
4400,L'Apprenti Pere Noel 2,5496833,0,5496833,2013.csv,2013,0.0,1.0
4401,Millionaire Dog,5492784,0,5492784,2014.csv,2014,0.0,1.0
4402,Joker,5491108,169181,5321927,2012.csv,2012,0.03080999317441944,0.9691900068255805
4403,A Wizard's Tale,5487261,2150,5485111,2018.csv,2018,0.0003918166094158816,0.9996081833905841
4404,The Lightning Tree,5486106,0,5486106,2010.csv,2010,0.0,1.0
4405,"Someone, Somewhere",5485340,0,5485340,2019.csv,2019,0.0,1.0
4406,Monkey Magic,5484147,0,5484147,2018.csv,2018,0.0,1.0
4407,I Can Quit Whenever I Want,5482323,0,5482323,2014.csv,2014,0.0,1.0
4408,The Solitude of Prime Numbers,5471143,0,5471143,2010.csv,2010,0.0,1.0
4409,Death Is Here 3,5470000,0,5470000,2014.csv,2014,0.0,1.0
4410,Chalet Girl,5468650,1710,5466940,2011.csv,2011,0.00031269143207190075,0.9996873085679281
4411,Man of Tai Chi,5464885,100144,5364741,2013.csv,2013,0.018324996774863513,0.9816750032251365
4412,Seven Days of Himawari and Her Puppies,5463914,0,5463914,2013.csv,2013,0.0,1.0
4413,Key of Life,5463837,0,5463837,2012.csv,2012,0.0,1.0
4414,That's a Crazy Little Thing Called Love,5459981,0,5459981,2016.csv,2016,0.0,1.0
4415,125 Years Memory,5453160,0,5453160,2015.csv,2015,0.0,1.0
4416,Thank You,5452347,463540,4988807,2011.csv,2011,0.08501659927367058,0.9149834007263294
4417,Day of the Falcon,5452142,0,5452142,2011.csv,2011,0.0,1.0
4418,OK Jaanu,5445281,355922,5089359,2017.csv,2017,0.0653633852871872,0.9346366147128128
4419,Fly with the Gold,5443725,0,5443725,2012.csv,2012,0.0,1.0
4420,Precure All Stars the Movie: Everyone Sing Miraculous Magic!,5440957,0,5440957,2016.csv,2016,0.0,1.0
4421,Stay Away from Me,5440949,0,5440949,2013.csv,2013,0.0,1.0
4422,Clover,5438177,0,5438177,2014.csv,2014,0.0,1.0
4423,Hara-Kiri: Death of a Samurai,5435358,75688,5359670,2011.csv,2011,0.013925117719936755,0.9860748822800632
4424,An Inconvenient Sequel: Truth to Power,5433926,3496795,1937131,2017.csv,2017,0.6435117077413274,0.3564882922586726
4425,Hocus Pocus 2020 Re-release,5432992,4828000,604992,2020.csv,2020,0.8886447835741338,0.11135521642586627
4426,The Negotiator: The Movie,5429651,0,5429651,2010.csv,2010,0.0,1.0
4427,Groupies bleiben nicht zum Frühstück,5428839,0,5428839,2010.csv,2010,0.0,1.0
4428,What a Day!,5428592,0,5428592,2017.csv,2017,0.0,1.0
4429,Ghosts of the Abyss 2010 Re-release,5428537,0,5428537,2010.csv,2010,0.0,1.0
4430,Atithi Tum Kab Jaoge?,5426118,0,5426118,2010.csv,2010,0.0,1.0
4431,Børning 2,5419664,0,5419664,2016.csv,2016,0.0,1.0
4432,Lyogok na pomine,5418225,0,5418225,2014.csv,2014,0.0,1.0
4433,The Salt of the Earth,5412189,1343349,4068840,2014.csv,2014,0.24820807255622448,0.7517919274437755
4434,L'étudiante et Monsieur Henri,5411932,761,5411171,2015.csv,2015,0.00014061521837303203,0.999859384781627
4435,Samurai's Promise,5410153,0,5410153,2018.csv,2018,0.0,1.0
4436,Flight from Hell,5410000,0,5410000,2014.csv,2014,0.0,1.0
4437,Happy Heroes,5410000,0,5410000,2013.csv,2013,0.0,1.0
4438,The Royal Tailor,5406469,0,5406469,2014.csv,2014,0.0,1.0
4439,After the Rain,5403417,0,5403417,2018.csv,2018,0.0,1.0
4440,One Direction: Where We Are - The Concert Film,5401797,0,5401797,2014.csv,2014,0.0,1.0
4441,Lady Macbeth,5401447,1129408,4272039,2017.csv,2017,0.2090936002889596,0.7909063997110404
4442,Una Mujer Sin Filtro,5399330,0,5399330,2018.csv,2018,0.0,1.0
4443,The Lost Bladesman,5398324,0,5398324,2011.csv,2011,0.0,1.0
4444,Ask Sana Benzer,5398127,0,5398127,2015.csv,2015,0.0,1.0
4445,Knock,5394474,0,5394474,2017.csv,2017,0.0,1.0
4446,Exit Through the Gift Shop,5386242,3291250,2094992,2010.csv,2010,0.6110475541202939,0.3889524458797061
4447,Truth,5383097,2541854,2841243,2015.csv,2015,0.4721917513282781,0.5278082486717218
4448,After the Storm,5382886,272132,5110754,2016.csv,2016,0.05055503683340126,0.9494449631665988
4449,Kray,5380142,0,5380142,2010.csv,2010,0.0,1.0
4450,Blutzbrüdaz,5378651,0,5378651,2011.csv,2011,0.0,1.0
4451,Dampfnudelblues,5378537,0,5378537,2013.csv,2013,0.0,1.0
4452,Won't Back Down,5378228,5310554,67674,2012.csv,2012,0.9874170451680367,0.012582954831963242
4453,Snekker Andersen og Julenissen,5377420,0,5377420,2016.csv,2016,0.0,1.0
4454,Time You Change,5372702,0,5372702,2010.csv,2010,0.0,1.0
4455,Lost in the Pacific,5368535,0,5368535,2016.csv,2016,0.0,1.0
4456,Naked Normandy,5360820,0,5360820,2018.csv,2018,0.0,1.0
4457,Reunion,5352683,0,5352683,2015.csv,2015,0.0,1.0
4458,La Leyenda del Charro Negro,5351716,0,5351716,2018.csv,2018,0.0,1.0
4459,One Night Only,5350348,0,5350348,2016.csv,2016,0.0,1.0
4460,Intruders,5348049,69136,5278913,2011.csv,2011,0.01292733106970411,0.9870726689302959
4461,The Ward,5343820,0,5343820,2011.csv,2011,0.0,1.0
4462,Black Butler,5342108,0,5342108,2014.csv,2014,0.0,1.0
4463,Much Ado About Nothing,5341221,4328849,1012372,2013.csv,2013,0.8104605669752291,0.18953943302477091
4464,Trollhunter,5341098,253444,5087654,2010.csv,2010,0.04745166630531775,0.9525483336946823
4465,Winx Club: The Mystery of the Abyss,5337409,0,5337409,2014.csv,2014,0.0,1.0
4466,Sky on fire,5335450,78366,5257084,2016.csv,2016,0.014687795781049395,0.9853122042189506
4467,Hadi Insallah,5332286,0,5332286,2014.csv,2014,0.0,1.0
4468,Miss Baek,5326218,0,5326218,2018.csv,2018,0.0,1.0
4469,Dil Toh Baccha Hai Ji,5323307,0,5323307,2011.csv,2011,0.0,1.0
4470,Coexister,5319108,0,5319108,2017.csv,2017,0.0,1.0
4471,Text,5317898,0,5317898,2019.csv,2019,0.0,1.0
4472,My War,5316684,0,5316684,2016.csv,2016,0.0,1.0
4473,Divorce Club,5316313,0,5316313,2020.csv,2020,0.0,1.0
4474,Non ci resta che il crimine,5313885,0,5313885,2019.csv,2019,0.0,1.0
4475,Force,5310437,0,5310437,2011.csv,2011,0.0,1.0
4476,The Invisible Witness,5305407,0,5305407,2018.csv,2018,0.0,1.0
4477,Home: The House Imp,5304736,0,5304736,2012.csv,2012,0.0,1.0
4478,Octonauts: The Ring of Fire,5300000,0,5300000,2021.csv,2021,0.0,1.0
4479,White: The Melody of the Curse,5299831,0,5299831,2011.csv,2011,0.0,1.0
4480,En gång i Phuket,5296419,0,5296419,2012.csv,2012,0.0,1.0
4481,Dyrene i Hakkebakkeskogen,5295452,0,5295452,2016.csv,2016,0.0,1.0
4482,The Meddler 2016 Re-release,5294643,4267218,1027425,2016.csv,2016,0.80595008955278,0.19404991044721995
4483,Madame,5290971,0,5290971,2017.csv,2017,0.0,1.0
4484,Violetta: La emoción del concierto,5288810,0,5288810,2014.csv,2014,0.0,1.0
4485,Don't Let Go,5288011,5215062,72949,2019.csv,2019,0.9862048320247443,0.013795167975255724
4486,The Dognapper,5287921,0,5287921,2013.csv,2013,0.0,1.0
4487,Kajínek,5287130,0,5287130,2010.csv,2010,0.0,1.0
4488,Yol Arkadasim 2,5278470,0,5278470,2018.csv,2018,0.0,1.0
4489,Talaash,5277766,2871956,2405810,2012.csv,2012,0.5441612985494241,0.45583870145057587
4490,My Blind Date With Life,5276805,0,5276805,2017.csv,2017,0.0,1.0
4491,The Stig-Helmer Story,5275505,0,5275505,2011.csv,2011,0.0,1.0
4492,Mustang,5274664,845464,4429200,2015.csv,2015,0.16028774534264173,0.8397122546573582
4493,"7 rzeczy, których nie wiecie o facetach",5267920,0,5267920,2016.csv,2016,0.0,1.0
4494,The Champions,5263784,0,5263784,2014.csv,2014,0.0,1.0
4495,True Story,5261595,4719695,541900,2015.csv,2015,0.8970084166493241,0.10299158335067599
4496,A Lone Scalpel,5261123,0,5261123,2010.csv,2010,0.0,1.0
4497,Sultan 2018 Re-release,5259463,0,5259463,2018.csv,2018,0.0,1.0
4498,Les Misérables: The Staged Concert,5257431,459478,4797953,2019.csv,2019,0.08739591637056197,0.912604083629438
4499,The Truth,5257385,9619,5247766,2019.csv,2019,0.0018296168152037563,0.9981703831847962
4500,The Grump,5256512,0,5256512,2014.csv,2014,0.0,1.0
4501,Mr. Nian,5256007,0,5256007,2016.csv,2016,0.0,1.0
4502,Doctor Proctor's Fart Powder,5254109,0,5254109,2014.csv,2014,0.0,1.0
4503,Walesa: Man of Hope,5250588,0,5250588,2013.csv,2013,0.0,1.0
4504,Rendez-vous chez les Malawas,5249689,0,5249689,2019.csv,2019,0.0,1.0
4505,The Biggest Little Farm,5248412,4366949,881463,2019.csv,2019,0.8320514852873593,0.1679485147126407
4506,Monstrum,5247503,0,5247503,2018.csv,2018,0.0,1.0
4507,The Mighty Angel,5235397,0,5235397,2014.csv,2014,0.0,1.0
4508,Mister Twister: Class of Fun,5231957,0,5231957,2012.csv,2012,0.0,1.0
4509,Split,5227278,0,5227278,2016.csv,2016,0.0,1.0
4510,Momo,5226331,0,5226331,2017.csv,2017,0.0,1.0
4511,Il giorno in più,5225074,0,5225074,2011.csv,2011,0.0,1.0
4512,Tucker and Dale vs Evil,5224938,223838,5001100,2010.csv,2010,0.042840316956871065,0.9571596830431289
4513,Star Twinkle PreCure the Movie: These Feelings Within The Song Of Stars,5222577,0,5222577,2019.csv,2019,0.0,1.0
4514,Two Thumbs Up,5222413,0,5222413,2015.csv,2015,0.0,1.0
4515,Cindy La Regia,5222322,0,5222322,2020.csv,2020,0.0,1.0
4516,Kill the Messenger,5218973,2450846,2768127,2014.csv,2014,0.4696031192343781,0.5303968807656219
4517,Cart,5217944,0,5217944,2014.csv,2014,0.0,1.0
4518,Devil's Pass,5217347,0,5217347,2013.csv,2013,0.0,1.0
4519,Suburra,5217330,0,5217330,2015.csv,2015,0.0,1.0
4520,My Best Friend's Wedding,5217162,0,5217162,2019.csv,2019,0.0,1.0
4521,The Invisible Boy,5216102,0,5216102,2014.csv,2014,0.0,1.0
4522,The New Girlfriend,5215796,146754,5069042,2014.csv,2014,0.028136453189503578,0.9718635468104965
4523,Mountains May Depart,5210160,82913,5127247,2015.csv,2015,0.015913714741965696,0.9840862852580343
4524,The Outlaw,5207679,0,5207679,2010.csv,2010,0.0,1.0
4525,Louis & Luca - The Big Cheese Race,5204792,0,5204792,2015.csv,2015,0.0,1.0
4526,David Brent: Life on the Road,5204054,0,5204054,2016.csv,2016,0.0,1.0
4527,"Zyuden Sentai Kyoryuger vs. Go-Busters: Dinosaur Great Battle! Farewell, Eternal Friends",5202979,0,5202979,2014.csv,2014,0.0,1.0
4528,Death Bell 2: Bloody Camp,5198289,0,5198289,2010.csv,2010,0.0,1.0
4529,Schuks Tshabalala's Survival Guide to South Africa,5194418,0,5194418,2010.csv,2010,0.0,1.0
4530,My African Adventure,5194312,0,5194312,2013.csv,2013,0.0,1.0
4531,Zindagi Na Milegi Dobara,5192743,3108485,2084258,2011.csv,2011,0.5986209985743566,0.4013790014256434
4532,Yoko,5191840,0,5191840,2012.csv,2012,0.0,1.0
4533,Survival Family,5190126,0,5190126,2017.csv,2017,0.0,1.0
4534,Nous York,5189055,0,5189055,2012.csv,2012,0.0,1.0
4535,Sapphire Blue,5188128,0,5188128,2014.csv,2014,0.0,1.0
4536,Oldboy,5186767,2193658,2993109,2013.csv,2013,0.422933592351459,0.577066407648541
4537,Little Big Soldier,5186427,0,5186427,2010.csv,2010,0.0,1.0
4538,Sales gosses,5184002,0,5184002,2017.csv,2017,0.0,1.0
4539,Vampire Sisters 2: Bats in the Belly,5182195,0,5182195,2014.csv,2014,0.0,1.0
4540,Born in the Exile: Sandaime J Soul Brothers no kiseki,5181032,0,5181032,2016.csv,2016,0.0,1.0
4541,All-Round Appraiser Q: The Eyes of Mona Lisa,5180116,0,5180116,2014.csv,2014,0.0,1.0
4542,War of Love,5179068,0,5179068,2010.csv,2010,0.0,1.0
4543,Bañeros 4: Los rompeolas,5176467,0,5176467,2014.csv,2014,0.0,1.0
4544,Skoryy 'Moskva-Rossiya',5173335,0,5173335,2014.csv,2014,0.0,1.0
4545,Baazaar,5170477,0,5170477,2018.csv,2018,0.0,1.0
4546,The Eleventh Chapter,5170000,0,5170000,2021.csv,2021,0.0,1.0
4547,S.O.S.: Women to the Sea 2,5169793,0,5169793,2015.csv,2015,0.0,1.0
4548,The Scythian Lamb,5168006,0,5168006,2018.csv,2018,0.0,1.0
4549,Captain Sabertooth and the Treasure of Lama Rama,5162886,0,5162886,2014.csv,2014,0.0,1.0
4550,Qué le dijiste a Dios?,5161905,0,5161905,2014.csv,2014,0.0,1.0
4551,MI-5,5161464,0,5161464,2015.csv,2015,0.0,1.0
4552,October Baby 2012 Re-release,5157886,5157886,0,2012.csv,2012,1.0,0.0
4553,Brillantissime,5151817,0,5151817,2018.csv,2018,0.0,1.0
4554,Pets United,5151568,0,5151568,2019.csv,2019,0.0,1.0
4555,Ironclad,5151023,0,5151023,2011.csv,2011,0.0,1.0
4556,Outcast,5148503,0,5148503,2014.csv,2014,0.0,1.0
4557,I'm Underage But I'm Not a Child,5146046,0,5146046,2017.csv,2017,0.0,1.0
4558,Rabbit Hole,5140925,2229058,2911867,2010.csv,2010,0.43359084211498905,0.566409157885011
4559,The Legend of Chupacabras,5138140,0,5138140,2016.csv,2016,0.0,1.0
4560,Don Quixote,5132495,0,5132495,2010.csv,2010,0.0,1.0
4561,Deliha 2,5129480,0,5129480,2018.csv,2018,0.0,1.0
4562,The Haunting in Connecticut 2: Ghosts of Georgia,5127434,0,5127434,2013.csv,2013,0.0,1.0
4563,Bizim Hikaye,5122113,0,5122113,2013.csv,2013,0.0,1.0
4564,Jak poslubic milionera,5121361,0,5121361,2019.csv,2019,0.0,1.0
4565,Love Aaj Kal,5120794,0,5120794,2020.csv,2020,0.0,1.0
4566,Together,5120000,0,5120000,2013.csv,2013,0.0,1.0
4567,Poongsan,5110929,0,5110929,2011.csv,2011,0.0,1.0
4568,Masked Ward,5106794,0,5106794,2020.csv,2020,0.0,1.0
4569,In the Fade,5104991,321011,4783980,2017.csv,2017,0.06288179548210761,0.9371182045178924
4570,"Good Day, Ramon",5104868,154356,4950512,2014.csv,2014,0.030237020820126984,0.969762979179873
4571,Action Point,5103663,5059608,44055,2018.csv,2018,0.9913679645384109,0.008632035461589058
4572,Love Without Distance,5100000,0,5100000,2015.csv,2015,0.0,1.0
4573,Kaabil 2019 Re-release,5097469,0,5097469,2019.csv,2019,0.0,1.0
4574,Sobibor,5096619,0,5096619,2018.csv,2018,0.0,1.0
4575,Children of the Sea,5092603,0,5092603,2019.csv,2019,0.0,1.0
4576,Serena,5092129,176391,4915738,2014.csv,2014,0.03463993154925965,0.9653600684507403
4577,Dark Places,5090852,208588,4882264,2014.csv,2014,0.04097310234121911,0.9590268976587809
4578,Locke,5090608,1375769,3714839,2014.csv,2014,0.2702563230168184,0.7297436769831815
4579,Ayyappanum Koshiyum,5088713,0,5088713,2020.csv,2020,0.0,1.0
4580,Selam: Bahara Yolculuk,5085947,0,5085947,2015.csv,2015,0.0,1.0
4581,El Ciudadano Kramer,5084473,0,5084473,2013.csv,2013,0.0,1.0
4582,Baba Parasi,5084342,0,5084342,2020.csv,2020,0.0,1.0
4583,The Liberator,5082098,113067,4969031,2014.csv,2014,0.02224809517644091,0.9777519048235591
4584,The Sense of an Ending,5081495,1274420,3807075,2017.csv,2017,0.2507962715696857,0.7492037284303144
4585,Die Känguru-Chroniken,5081127,0,5081127,2020.csv,2020,0.0,1.0
4586,Dogman,5080147,148225,4931922,2018.csv,2018,0.029177305302385936,0.9708226946976141
4587,Anthropoid,5079219,2964845,2114374,2016.csv,2016,0.583720646815977,0.416279353184023
4588,Konosuba!: God's Blessing on This Wonderful World! - Legend of Crimson,5078942,1134786,3944156,2019.csv,2019,0.22342960403958148,0.7765703959604185
4589,Doctor Who: The Day of the Doctor,5074950,0,5074950,2013.csv,2013,0.0,1.0
4590,Where? Wolf?,5073304,0,5073304,2010.csv,2010,0.0,1.0
4591,Stand Up Guys,5072654,3310031,1762623,2013.csv,2013,0.652524497038434,0.3474755029615661
4592,Venus Talk,5071855,0,5071855,2014.csv,2014,0.0,1.0
4593,Twigson Ties the Knot,5070457,0,5070457,2010.csv,2010,0.0,1.0
4594,South Bound,5070133,0,5070133,2013.csv,2013,0.0,1.0
4595,Mannenharten,5062196,0,5062196,2013.csv,2013,0.0,1.0
4596,Mr. X,5061387,44995,5016392,2015.csv,2015,0.008889855685803121,0.9911101443141969
4597,Monsters,5060438,237301,4823137,2010.csv,2010,0.04689337168047509,0.9531066283195249
4598,Tokyo Ghoul,5060120,0,5060120,2017.csv,2017,0.0,1.0
4599,Nihon rettou: Ikimonotachi no monogatari,5059460,0,5059460,2012.csv,2012,0.0,1.0
4600,ATM: Er Rak Error,5057554,0,5057554,2012.csv,2012,0.0,1.0
4601,K3 Bengeltjes,5056891,0,5056891,2012.csv,2012,0.0,1.0
4602,Far til fire: Til søs,5056491,0,5056491,2012.csv,2012,0.0,1.0
4603,Creepy,5054326,0,5054326,2016.csv,2016,0.0,1.0
4604,The Crocodiles Strike Back,5050298,0,5050298,2010.csv,2010,0.0,1.0
4605,Ye kong que,5045207,0,5045207,2016.csv,2016,0.0,1.0
4606,Table 19,5042014,3614896,1427118,2017.csv,2017,0.7169547724381566,0.28304522756184336
4607,It Comes,5041008,0,5041008,2018.csv,2018,0.0,1.0
4608,Kedi,5037923,2835047,2202876,2017.csv,2017,0.562741232845361,0.4372587671546389
4609,The Real Exorcist,5035830,0,5035830,2020.csv,2020,0.0,1.0
4610,Wendy,5034128,0,5034128,2017.csv,2017,0.0,1.0
4611,Abzurdah,5032788,0,5032788,2015.csv,2015,0.0,1.0
4612,The Pasta Detectives,5031433,0,5031433,2014.csv,2014,0.0,1.0
4613,Colour of the Game,5029820,0,5029820,2017.csv,2017,0.0,1.0
4614,Snow on the Blades,5029712,0,5029712,2014.csv,2014,0.0,1.0
4615,Breathe,5026154,490131,4536023,2017.csv,2017,0.09751611271759679,0.9024838872824033
4616,Xuan Zang,5023106,0,5023106,2016.csv,2016,0.0,1.0
4617,Space Dream,5023009,0,5023009,2011.csv,2011,0.0,1.0
4618,Free Man,5021464,0,5021464,2011.csv,2011,0.0,1.0
4619,Oranges and Sunshine,5017653,143480,4874173,2011.csv,2011,0.028595042343502033,0.9714049576564979
4620,Dad,5015023,0,5015023,2021.csv,2021,0.0,1.0
4621,21 Ways to Ruin a Marriage,5012795,0,5012795,2013.csv,2013,0.0,1.0
4622,Double Lover,5012423,167581,4844842,2017.csv,2017,0.03343313204013309,0.9665668679598669
4623,Worlds Apart,5011560,60298,4951262,2015.csv,2015,0.012031782518816496,0.9879682174811835
4624,Mayday,5011408,0,5011408,2020.csv,2020,0.0,1.0
4625,The Midas Touch,5007766,0,5007766,2013.csv,2013,0.0,1.0
4626,Blindspotting,5006989,4333394,673595,2018.csv,2018,0.8654690473655924,0.13453095263440762
4627,Ju-on: The Final Curse,5006867,0,5006867,2015.csv,2015,0.0,1.0
4628,Hibana,5005352,0,5005352,2017.csv,2017,0.0,1.0
4629,Latte & the Magic Waterstone,5004732,0,5004732,2019.csv,2019,0.0,1.0
4630,What a Wonderful Family! 2017 Re-release,5004572,0,5004572,2017.csv,2017,0.0,1.0
4631,Father of Four,5004233,0,5004233,2010.csv,2010,0.0,1.0
4632,Ice Princess Lily,5000984,0,5000984,2018.csv,2018,0.0,1.0
4633,Marina,4998164,0,4998164,2013.csv,2013,0.0,1.0
4634,High Speed! Free! Starting Summer,4997409,0,4997409,2015.csv,2015,0.0,1.0
4635,Bheeshma,4997080,0,4997080,2020.csv,2020,0.0,1.0
4636,The Girl in the Fog,4996317,0,4996317,2017.csv,2017,0.0,1.0
4637,Pororo 5: Treasure Island Adventure,4994433,0,4994433,2019.csv,2019,0.0,1.0
4638,Hands of Stone,4978353,4712792,265561,2016.csv,2016,0.9466568561932028,0.053343143806797146
4639,Dance with the Jackals 2,4976722,0,4976722,2012.csv,2012,0.0,1.0
4640,Kamen Rider Ex-Aid: True Ending,4973198,0,4973198,2017.csv,2017,0.0,1.0
4641,Loli Pop In Fantasy,4971755,0,4971755,2019.csv,2019,0.0,1.0
4642,Made in Abyss: Dawn of the Deep Soul,4971635,0,4971635,2020.csv,2020,0.0,1.0
4643,The Fox Lover,4970000,0,4970000,2013.csv,2013,0.0,1.0
4644,A Tale of Samurai Cooking - A True Love Story,4968780,0,4968780,2013.csv,2013,0.0,1.0
4645,Take This Waltz,4965950,1239692,3726258,2012.csv,2012,0.24963843776115346,0.7503615622388465
4646,Victoria 2016 Re-release,4964535,0,4964535,2016.csv,2016,0.0,1.0
4647,The Looming Storm,4964366,0,4964366,2017.csv,2017,0.0,1.0
4648,Amazonia,4963609,0,4963609,2013.csv,2013,0.0,1.0
4649,Beloved,4958162,0,4958162,2010.csv,2010,0.0,1.0
4650,Louis & Luca - Mission to the Moon,4957487,0,4957487,2018.csv,2018,0.0,1.0
4651,The Professor and the Madman,4957273,0,4957273,2019.csv,2019,0.0,1.0
4652,Iceman: The Time Traveller,4957041,0,4957041,2018.csv,2018,0.0,1.0
4653,Loft,4956709,0,4956709,2010.csv,2010,0.0,1.0
4654,Magical Girl Lyrical Nanoha the Movie 2nd A's,4950633,0,4950633,2012.csv,2012,0.0,1.0
4655,Samurai Sentai Shinkenger vs. Go-onger Ginmaku Bang!,4948599,0,4948599,2010.csv,2010,0.0,1.0
4656,Tengaramon,4948225,0,4948225,2020.csv,2020,0.0,1.0
4657,Bad Guys Always Die,4944513,0,4944513,2015.csv,2015,0.0,1.0
4658,Dilili in Paris,4943572,0,4943572,2018.csv,2018,0.0,1.0
4659,Take Off 2,4936960,0,4936960,2016.csv,2016,0.0,1.0
4660,Da geht noch was,4936298,0,4936298,2013.csv,2013,0.0,1.0
4661,Pari,4935586,0,4935586,2018.csv,2018,0.0,1.0
4662,Swiss Army Man,4935501,4210454,725047,2016.csv,2016,0.8530955621323955,0.14690443786760451
4663,Mes héros,4934927,0,4934927,2012.csv,2012,0.0,1.0
4664,Nymphomaniac: Vol. II,4934725,327167,4607558,2014.csv,2014,0.06629893256463126,0.9337010674353687
4665,The Hairdresser,4934394,0,4934394,2010.csv,2010,0.0,1.0
4666,Sgt. Stubby: An American Hero,4932694,4015935,916759,2018.csv,2018,0.8141463873493876,0.18585361265061243
4667,Fly Me to the Moon 3D 2013 Re-release,4930000,0,4930000,2013.csv,2013,0.0,1.0
4668,Slack Bay,4925446,112621,4812825,2016.csv,2016,0.022865137492117465,0.9771348625078825
4669,Desierto,4924990,2002036,2922954,2016.csv,2016,0.4065055969656791,0.5934944030343209
4670,A Better Tomorrow 2017 Re-release,4924718,0,4924718,2017.csv,2017,0.0,1.0
4671,A small southern enterprise,4923392,0,4923392,2013.csv,2013,0.0,1.0
4672,Den vyborov 2,4921573,0,4921573,2016.csv,2016,0.0,1.0
4673,Cep Herkülü: Naim Süleymanoglu,4920899,0,4920899,2019.csv,2019,0.0,1.0
4674,Bon Bini Holland,4920623,0,4920623,2015.csv,2015,0.0,1.0
4675,Red,4920261,0,4920261,2021.csv,2021,0.0,1.0
4676,Kral Sakir Korsanlar Diyari,4919713,0,4919713,2019.csv,2019,0.0,1.0
4677,The Dragon Pearl,4919550,0,4919550,2011.csv,2011,0.0,1.0
4678,A Home with a View,4919529,0,4919529,2019.csv,2019,0.0,1.0
4679,Judge!,4919163,0,4919163,2014.csv,2014,0.0,1.0
4680,The Importance of Tying Your Own Shoes,4918176,0,4918176,2011.csv,2011,0.0,1.0
4681,Wyjazd integracyjny,4916011,0,4916011,2011.csv,2011,0.0,1.0
4682,[REC] 4: Apocalypse,4915757,837,4914920,2014.csv,2014,0.00017026879074779326,0.9998297312092522
4683,Paris à tout prix,4914774,0,4914774,2013.csv,2013,0.0,1.0
4684,Sword of Desperation,4912296,0,4912296,2010.csv,2010,0.0,1.0
4685,Ushijima the Loan Shark 2,4910107,0,4910107,2014.csv,2014,0.0,1.0
4686,Wkreceni,4905387,0,4905387,2014.csv,2014,0.0,1.0
4687,The Spy,4903665,0,4903665,2012.csv,2012,0.0,1.0
4688,Love & Slaps,4901585,0,4901585,2010.csv,2010,0.0,1.0
4689,Conspirators,4901432,0,4901432,2013.csv,2013,0.0,1.0
4690,Magnificent Presence,4897074,0,4897074,2012.csv,2012,0.0,1.0
4691,Easy Money II: Hard to Kill,4890512,0,4890512,2012.csv,2012,0.0,1.0
4692,T-Guardians,4889828,0,4889828,2017.csv,2017,0.0,1.0
4693,Alemão: Both Sides of the Operation,4888783,0,4888783,2014.csv,2014,0.0,1.0
4694,Kamen Rider Build: Be the One,4888000,0,4888000,2018.csv,2018,0.0,1.0
4695,Panga,4886124,582720,4303404,2020.csv,2020,0.11926017432222351,0.8807398256777765
4696,Return to the Wolves,4886088,0,4886088,2017.csv,2017,0.0,1.0
4697,"Man, Chicks Are Just Different",4883118,0,4883118,2011.csv,2011,0.0,1.0
4698,Pretty Cure!: Kiseki no Henshin! Cure Mofurun!,4881491,0,4881491,2016.csv,2016,0.0,1.0
4699,I Got Life!,4879696,0,4879696,2017.csv,2017,0.0,1.0
4700,Se son rose,4878325,0,4878325,2018.csv,2018,0.0,1.0
4701,Suicide Room,4878284,0,4878284,2011.csv,2011,0.0,1.0
4702,Cherry Returns,4878197,0,4878197,2016.csv,2016,0.0,1.0
4703,Kiki's Delivery Service 2013 Re-release,4877850,0,4877850,2013.csv,2013,0.0,1.0
4704,Samson,4873825,4719928,153897,2018.csv,2018,0.9684237739352561,0.03157622606474381
4705,Hindsight,4872490,0,4872490,2011.csv,2011,0.0,1.0
4706,The Young Karl Marx,4870373,125659,4744714,2017.csv,2017,0.02580069329392225,0.9741993067060778
4707,The Space Between the Lines,4869079,0,4869079,2019.csv,2019,0.0,1.0
4708,Midnight Beating,4866623,0,4866623,2010.csv,2010,0.0,1.0
4709,Çanakkale 1915,4865992,0,4865992,2012.csv,2012,0.0,1.0
4710,Don't Click,4864262,0,4864262,2012.csv,2012,0.0,1.0
4711,Raja Huli,4858064,0,4858064,2013.csv,2013,0.0,1.0
4712,Solanin,4856427,0,4856427,2010.csv,2010,0.0,1.0
4713,Commando 3,4854910,0,4854910,2019.csv,2019,0.0,1.0
4714,The Tales for Old and Young,4853143,0,4853143,2020.csv,2020,0.0,1.0
4715,Streltsov,4850073,0,4850073,2020.csv,2020,0.0,1.0
4716,Back To The Future Day,4850000,1650000,3200000,2015.csv,2015,0.3402061855670103,0.6597938144329897
4717,Pettersson und Findus 2 - Das schönste Weihnachten überhaupt,4849985,0,4849985,2016.csv,2016,0.0,1.0
4718,Blood Father,4845117,0,4845117,2016.csv,2016,0.0,1.0
4719,Steins Gate the Movie: Load Region of Déjà vu,4843719,0,4843719,2013.csv,2013,0.0,1.0
4720,90 Minutes in Heaven,4842699,4842699,0,2015.csv,2015,1.0,0.0
4721,RamLeela,4840059,2738863,2101196,2013.csv,2013,0.565873887074517,0.4341261129254829
4722,Winterkartoffelknödel,4840034,0,4840034,2014.csv,2014,0.0,1.0
4723,Detetives do Prédio Azul: O Filme,4836164,0,4836164,2017.csv,2017,0.0,1.0
4724,Sous le même toit,4830314,0,4830314,2017.csv,2017,0.0,1.0
4725,Amici miei - Come tutto ebbe inizio,4828128,0,4828128,2011.csv,2011,0.0,1.0
4726,Quackerz,4828042,0,4828042,2016.csv,2016,0.0,1.0
4727,Jimmy's Hall,4825184,560592,4264592,2014.csv,2014,0.11618043995835185,0.8838195600416482
4728,Predestination,4824499,68372,4756127,2014.csv,2014,0.014171834215324742,0.9858281657846752
4729,Capital,4822849,101700,4721149,2012.csv,2012,0.021087120911311964,0.9789128790886881
4730,Felix Manalo,4822493,0,4822493,2015.csv,2015,0.0,1.0
4731,Nomadland,4820723,2143000,2677723,2021.csv,2021,0.4445391282593918,0.5554608717406082
4732,Windstorm 4: Ari's Arrival,4818297,0,4818297,2019.csv,2019,0.0,1.0
4733,Mistresses,4815349,0,4815349,2019.csv,2019,0.0,1.0
4734,Mazinger Z: INFINITY,4812371,220682,4591689,2017.csv,2017,0.04585722921196225,0.9541427707880378
4735,The SpongeBob Movie: Sponge on the Run,4810790,4810790,0,2020.csv,2020,1.0,0.0
4736,Trash,4809022,17484,4791538,2014.csv,2014,0.00363566646191263,0.9963643335380874
4737,Robot & Frank,4806423,3325038,1481385,2012.csv,2012,0.6917905477732609,0.3082094522267391
4738,Mama Weed,4803554,0,4803554,2020.csv,2020,0.0,1.0
4739,The Happy Housewife,4800327,0,4800327,2010.csv,2010,0.0,1.0
4740,Get Santa,4798222,0,4798222,2014.csv,2014,0.0,1.0
4741,The Olsen Gang Gets Polished,4794857,0,4794857,2010.csv,2010,0.0,1.0
4742,Burke and Hare,4791599,4833,4786766,2010.csv,2010,0.0010086403307121485,0.9989913596692879
4743,Lapland Odyssey 2,4791063,0,4791063,2015.csv,2015,0.0,1.0
4744,Love You for Loving Me,4790000,0,4790000,2013.csv,2013,0.0,1.0
4745,The Vets,4788826,0,4788826,2020.csv,2020,0.0,1.0
4746,Korporativ,4785667,0,4785667,2014.csv,2014,0.0,1.0
4747,Second Virginity,4785334,0,4785334,2011.csv,2011,0.0,1.0
4748,Far til fire - tilbage til naturen,4781708,0,4781708,2011.csv,2011,0.0,1.0
4749,The Broken Hearts Gallery,4781389,4067442,713947,2020.csv,2020,0.8506820925885763,0.14931790741142376
4750,Gladiator 20th Anniversary,4780585,0,4780585,2020.csv,2020,0.0,1.0
4751,Dragon Trap,4780084,0,4780084,2010.csv,2010,0.0,1.0
4752,A Royal Night Out,4779170,228136,4551034,2015.csv,2015,0.04773548545040247,0.9522645145495975
4753,Nuts,4778869,0,4778869,2018.csv,2018,0.0,1.0
4754,Martha Marcy May Marlene,4778439,2990625,1787814,2011.csv,2011,0.6258581515846493,0.3741418484153507
4755,Ushijima the Loan Shark 3,4773629,0,4773629,2016.csv,2016,0.0,1.0
4756,My Life in Orange,4771308,0,4771308,2011.csv,2011,0.0,1.0
4757,Weddings and Other Disasters,4769415,0,4769415,2010.csv,2010,0.0,1.0
4758,Men & Chicken,4765472,30207,4735265,2015.csv,2015,0.00633872153692226,0.9936612784630777
4759,An Unexpected Love,4763928,0,4763928,2018.csv,2018,0.0,1.0
4760,Lapland Odyssey,4762640,0,4762640,2010.csv,2010,0.0,1.0
4761,Muzhchina s garantiey,4761155,0,4761155,2012.csv,2012,0.0,1.0
4762,Black Snow,4758401,0,4758401,2017.csv,2017,0.0,1.0
4763,The Popcorn Chronicles,4757098,0,4757098,2014.csv,2014,0.0,1.0
4764,"Gulyay, Vasya!",4756578,0,4756578,2017.csv,2017,0.0,1.0
4765,Babovresky,4756577,0,4756577,2013.csv,2013,0.0,1.0
4766,The Warriors,4754904,0,4754904,2016.csv,2016,0.0,1.0
4767,Intruder,4751103,0,4751103,2020.csv,2020,0.0,1.0
4768,In the Game,4742293,0,4742293,2018.csv,2018,0.0,1.0
4769,Masha e Orso: Amici per sempre,4738018,0,4738018,2015.csv,2015,0.0,1.0
4770,Her Blue Sky,4736031,0,4736031,2019.csv,2019,0.0,1.0
4771,The Double,4729855,137921,4591934,2011.csv,2011,0.02915966768537302,0.970840332314627
4772,Clouds of Sils Maria,4728401,1851517,2876884,2014.csv,2014,0.3915735996164454,0.6084264003835546
4773,Joséphine,4727775,0,4727775,2013.csv,2013,0.0,1.0
4774,Walking on Sunshine,4721182,0,4721182,2013.csv,2013,0.0,1.0
4775,Sweet Bean,4720010,124800,4595210,2015.csv,2015,0.026440621947834857,0.9735593780521652
4776,Young Style,4720000,0,4720000,2013.csv,2013,0.0,1.0
4777,Adventure of the King,4718965,0,4718965,2010.csv,2010,0.0,1.0
4778,Kamen Rider Ichigou,4717643,0,4717643,2016.csv,2016,0.0,1.0
4779,Safety First,4717558,0,4717558,2015.csv,2015,0.0,1.0
4780,... E fuori nevica!,4716824,0,4716824,2014.csv,2014,0.0,1.0
4781,Café. Waiting. Love,4712992,0,4712992,2014.csv,2014,0.0,1.0
4782,I'm Gilda,4711955,0,4711955,2016.csv,2016,0.0,1.0
4783,Peppa Pig: My First Cinema Experience,4711491,0,4711491,2017.csv,2017,0.0,1.0
4784,Girl in Progress,4709246,2609412,2099834,2012.csv,2012,0.5541039903203188,0.4458960096796812
4785,Monster Strike the Movie,4706057,0,4706057,2016.csv,2016,0.0,1.0
4786,The Adulteen,4705786,0,4705786,2013.csv,2013,0.0,1.0
4787,"Jeff, Who Lives at Home",4704757,4269426,435331,2012.csv,2012,0.9074700351155225,0.09252996488447757
4788,Under the Open Sky,4702781,0,4702781,2021.csv,2021,0.0,1.0
4789,A Certain Magical Index: The Movie - The Miracle of Endymion,4701051,0,4701051,2013.csv,2013,0.0,1.0
4790,The Galaxy on the Earth,4700000,0,4700000,2014.csv,2014,0.0,1.0
4791,Unlocked,4699125,0,4699125,2017.csv,2017,0.0,1.0
4792,Menteur,4697364,4697364,0,2019.csv,2019,1.0,0.0
4793,Flower and Sword,4696006,0,4696006,2017.csv,2017,0.0,1.0
4794,Jay and Silent Bob Reboot,4691248,4589490,101758,2019.csv,2019,0.9783089702356388,0.02169102976436121
4795,Ya Sonra?,4686857,0,4686857,2011.csv,2011,0.0,1.0
4796,Keith Lemon: The Film,4682943,0,4682943,2012.csv,2012,0.0,1.0
4797,The Runaways,4681651,3573673,1107978,2010.csv,2010,0.7633360538835552,0.2366639461164448
4798,K3 Dierenhotel,4679370,0,4679370,2014.csv,2014,0.0,1.0
4799,Delete My Love,4678632,0,4678632,2014.csv,2014,0.0,1.0
4800,100% Wolf,4678299,512805,4165494,2020.csv,2020,0.10961355826123982,0.8903864417387601
4801,Sweetheart,4678042,0,4678042,2019.csv,2019,0.0,1.0
4802,The Winner,4672881,0,4672881,2015.csv,2015,0.0,1.0
4803,Warriors of the Rainbow: Seediq Bale I,4670432,136166,4534266,2011.csv,2011,0.029154904728299225,0.9708450952717008
4804,Tous les soleils,4669149,0,4669149,2011.csv,2011,0.0,1.0
4805,Top Cat Begins,4668442,0,4668442,2015.csv,2015,0.0,1.0
4806,Where to Invade Next,4664756,3827261,837495,2016.csv,2016,0.8204632782507809,0.17953672174921903
4807,A Simple Life,4663094,191826,4471268,2012.csv,2012,0.041137064790029966,0.95886293520997
4808,The Ladybug,4662924,0,4662924,2018.csv,2018,0.0,1.0
4809,Little Ghostly Adventures of Tofu Boy,4658686,0,4658686,2011.csv,2011,0.0,1.0
4810,Joking Jazz 4G,4655813,0,4655813,2016.csv,2016,0.0,1.0
4811,Granny Nanny,4653879,432,4653447,2020.csv,2020,9.282579113036674e-05,0.9999071742088697
4812,Generation P,4653071,0,4653071,2011.csv,2011,0.0,1.0
4813,New Biz in the Hood,4652622,0,4652622,2019.csv,2019,0.0,1.0
4814,Tubelight,4650456,930058,3720398,2017.csv,2017,0.19999286091514468,0.8000071390848553
4815,7 Emotions,4650199,0,4650199,2018.csv,2018,0.0,1.0
4816,Crying Man,4646116,0,4646116,2014.csv,2014,0.0,1.0
4817,Gemma Bovery,4644525,191533,4452992,2014.csv,2014,0.04123844741927323,0.9587615525807268
4818,Everybody Wants Some!!,4644472,3400278,1244194,2016.csv,2016,0.7321129290907556,0.26788707090924435
4819,Kamen Rider Super Den-O Trilogy: Episode Yellow - Treasure de End Pirates,4644007,0,4644007,2010.csv,2010,0.0,1.0
4820,"Lock Me Up, Tie Him Down",4640721,0,4640721,2014.csv,2014,0.0,1.0
4821,The Last Black Man in San Francisco,4637830,4515719,122111,2019.csv,2019,0.9736706606322353,0.026329339367764666
4822,Housefull 4,4634173,2109160,2525013,2019.csv,2019,0.4551319081096023,0.5448680918903978
4823,Attack the Gas Station! 2,4634087,0,4634087,2010.csv,2010,0.0,1.0
4824,Dear White People,4633961,4404154,229807,2014.csv,2014,0.9504080850054629,0.04959191499453707
4825,Killer Joe,4633668,1987762,2645906,2012.csv,2012,0.428982395803929,0.5710176041960711
4826,Goyangyi,4631716,0,4631716,2011.csv,2011,0.0,1.0
4827,Hamlet 2018 Re-release,4630718,235229,4395489,2018.csv,2018,0.050797522112121705,0.9492024778878783
4828,Da hua tian xian,4630000,0,4630000,2014.csv,2014,0.0,1.0
4829,Basilicata Coast to Coast,4628041,0,4628041,2010.csv,2010,0.0,1.0
4830,Atlas Shrugged: Part I,4627375,4627375,0,2011.csv,2011,1.0,0.0
4831,Happily Mixed Up,4626678,0,4626678,2014.csv,2014,0.0,1.0
4832,Heneral Luna,4625639,206040,4419599,2015.csv,2015,0.044543035027160574,0.9554569649728394
4833,Bad Samaritan,4623836,3435047,1188789,2018.csv,2018,0.742899834682718,0.257100165317282
4834,Buddy Cops,4622802,0,4622802,2016.csv,2016,0.0,1.0
4835,With Love... from the Age of Reason,4622492,0,4622492,2010.csv,2010,0.0,1.0
4836,Una famiglia perfetta,4621441,0,4621441,2012.csv,2012,0.0,1.0
4837,Paranormal Xperience 3D,4620995,0,4620995,2011.csv,2011,0.0,1.0
4838,The Shiny Shrimps,4619077,0,4619077,2019.csv,2019,0.0,1.0
4839,Brotherhood,4613846,0,4613846,2016.csv,2016,0.0,1.0
4840,Weekend,4609934,0,4609934,2011.csv,2011,0.0,1.0
4841,A Hidden Life,4607564,1730597,2876967,2019.csv,2019,0.37559912352818103,0.624400876471819
4842,Whitney,4605123,3026351,1578772,2018.csv,2018,0.6571705033720054,0.3428294966279945
4843,Soreike! Anpanman: Yomigaere Bananajima,4604003,0,4604003,2012.csv,2012,0.0,1.0
4844,Forgotten Christmas,4599483,0,4599483,2019.csv,2019,0.0,1.0
4845,The Guilty,4598051,207140,4390911,2018.csv,2018,0.04504952206924195,0.954950477930758
4846,The Book of Henry,4596705,4504974,91731,2017.csv,2017,0.9800441838229775,0.019955816177022453
4847,Into the White Night,4593914,0,4593914,2011.csv,2011,0.0,1.0
4848,La nostra vita,4587535,0,4587535,2010.csv,2010,0.0,1.0
4849,For the Emperor,4583000,0,4583000,2014.csv,2014,0.0,1.0
4850,Sonny Boy,4581706,0,4581706,2011.csv,2011,0.0,1.0
4851,Labyrinth of Lies,4574756,794452,3780304,2014.csv,2014,0.17365997224770022,0.8263400277522998
4852,Moskova'nin Sifresi Temel 2012 Re-release,4571780,0,4571780,2012.csv,2012,0.0,1.0
4853,Find a Boyfriend for My Wife... PLEASE!,4570757,1741889,2828868,2016.csv,2016,0.38109420387038734,0.6189057961296127
4854,Fortress of War,4569371,0,4569371,2010.csv,2010,0.0,1.0
4855,Devil's Kickers,4569228,0,4569228,2010.csv,2010,0.0,1.0
4856,Who Is Undercover,4565085,0,4565085,2014.csv,2014,0.0,1.0
4857,Ma tu di che segno 6?,4562701,0,4562701,2014.csv,2014,0.0,1.0
4858,Kikoriki. Deja Vu,4562667,0,4562667,2018.csv,2018,0.0,1.0
4859,Little Miss Dolittle,4558127,0,4558127,2018.csv,2018,0.0,1.0
4860,The Beach Bum,4554416,3502600,1051816,2019.csv,2019,0.7690557911266779,0.23094420887332207
4861,The Iceman,4552970,1969193,2583777,2013.csv,2013,0.432507352343635,0.567492647656365
4862,Tea Pets,4552351,0,4552351,2017.csv,2017,0.0,1.0
4863,Natale a Londra - Dio salvi la Regina,4551751,0,4551751,2016.csv,2016,0.0,1.0
4864,Military Wives,4549863,0,4549863,2020.csv,2020,0.0,1.0
4865,Woman at War,4542553,847495,3695058,2018.csv,2018,0.1865679938131707,0.8134320061868293
4866,Box!,4540767,0,4540767,2010.csv,2010,0.0,1.0
4867,The Last White Witch,4540085,0,4540085,2019.csv,2019,0.0,1.0
4868,A Spot of Bother,4539618,0,4539618,2010.csv,2010,0.0,1.0
4869,Missing You,4538719,0,4538719,2016.csv,2016,0.0,1.0
4870,Radiostars,4533793,0,4533793,2012.csv,2012,0.0,1.0
4871,Okuotoko,4533658,0,4533658,2018.csv,2018,0.0,1.0
4872,"Les Municipaux, ces héros",4531635,0,4531635,2018.csv,2018,0.0,1.0
4873,Colossal,4531320,3029287,1502033,2017.csv,2017,0.6685219759363717,0.33147802406362825
4874,Os Parças 2,4530412,0,4530412,2019.csv,2019,0.0,1.0
4875,Cezanne et Moi,4529583,257597,4271986,2016.csv,2016,0.05686991495685144,0.9431300850431485
4876,Metal Brothers,4527912,0,4527912,2012.csv,2012,0.0,1.0
4877,The Distinguished Citizen,4525656,0,4525656,2016.csv,2016,0.0,1.0
4878,The Festival,4523842,0,4523842,2018.csv,2018,0.0,1.0
4879,The Ash Lad: In the Hall of the Mountain King,4522950,0,4522950,2017.csv,2017,0.0,1.0
4880,Anniversary,4522911,0,4522911,2015.csv,2015,0.0,1.0
4881,Italiano medio,4518908,0,4518908,2015.csv,2015,0.0,1.0
4882,Your Eyes,4517524,0,4517524,2017.csv,2017,0.0,1.0
4883,Mobile Suit Gundam Unicorn 7,4511461,0,4511461,2014.csv,2014,0.0,1.0
4884,"Juliet, Naked",4511157,3444895,1066262,2018.csv,2018,0.7636389068258985,0.23636109317410145
4885,Maps to the Stars,4510934,350741,4160193,2014.csv,2014,0.07775352066778188,0.9222464793322181
4886,My Summer in Provence,4510590,0,4510590,2014.csv,2014,0.0,1.0
4887,Simon & the Oaks,4505573,150664,4354909,2011.csv,2011,0.03343947595566646,0.9665605240443336
4888,Mees Kees op de planken,4495549,0,4495549,2014.csv,2014,0.0,1.0
4889,Jawaani Jaaneman,4495290,0,4495290,2020.csv,2020,0.0,1.0
4890,The Dawns Here Are Quiet...,4495190,0,4495190,2015.csv,2015,0.0,1.0
4891,Happiness Charge PreCure!,4494355,0,4494355,2014.csv,2014,0.0,1.0
4892,Max,4494114,0,4494114,2013.csv,2013,0.0,1.0
4893,Barfi!,4490134,2804874,1685260,2012.csv,2012,0.6246748983437911,0.3753251016562089
4894,Bandage,4489883,0,4489883,2010.csv,2010,0.0,1.0
4895,F.A.L.T.U,4485014,0,4485014,2011.csv,2011,0.0,1.0
4896,Rundskop,4483147,151840,4331307,2011.csv,2011,0.03386906563625953,0.9661309343637404
4897,Donnant donnant,4478102,0,4478102,2010.csv,2010,0.0,1.0
4898,The Wall,4476705,1803064,2673641,2017.csv,2017,0.4027658735610231,0.5972341264389769
4899,Demonic,4476578,0,4476578,2015.csv,2015,0.0,1.0
4900,Close to the Horizon,4476218,0,4476218,2019.csv,2019,0.0,1.0
4901,West Is West,4473620,0,4473620,2011.csv,2011,0.0,1.0
4902,The Haunted House: The Secret of the Cave,4471732,0,4471732,2018.csv,2018,0.0,1.0
4903,Colombia magia salvaje,4471217,0,4471217,2015.csv,2015,0.0,1.0
4904,Entre amis,4469267,0,4469267,2015.csv,2015,0.0,1.0
4905,Anpanman: Shine! Kurun & The Star of Life,4467225,0,4467225,2018.csv,2018,0.0,1.0
4906,Photo de famille,4462678,0,4462678,2018.csv,2018,0.0,1.0
4907,Batman: The Killing Joke,4462034,3775000,687034,2016.csv,2016,0.8460267223423219,0.1539732776576781
4908,Mom or Dad?,4461317,0,4461317,2017.csv,2017,0.0,1.0
4909,The Geographer Drank His Globe Away,4459303,0,4459303,2013.csv,2013,0.0,1.0
4910,Flypaper,4453634,5043,4448591,2011.csv,2011,0.0011323337301628288,0.9988676662698371
4911,"Daddy You, Daughter Me",4453538,0,4453538,2017.csv,2017,0.0,1.0
4912,The Rewrite,4453524,0,4453524,2014.csv,2014,0.0,1.0
4913,The Phantom of the Opera at the Royal Albert Hall,4451482,0,4451482,2011.csv,2011,0.0,1.0
4914,Hello World,4449860,0,4449860,2019.csv,2019,0.0,1.0
4915,Buck,4448728,4038912,409816,2011.csv,2011,0.9078801850776221,0.09211981492237781
4916,In Harm's Way,4447734,0,4447734,2017.csv,2017,0.0,1.0
4917,Mental,4446852,17669,4429183,2012.csv,2012,0.003973372624049553,0.9960266273759505
4918,I Love Hong Kong 2012,4443990,0,4443990,2012.csv,2012,0.0,1.0
4919,I Am a King,4441857,0,4441857,2012.csv,2012,0.0,1.0
4920,King Naresuan 4,4441109,0,4441109,2011.csv,2011,0.0,1.0
4921,Omar Killed Me,4439826,0,4439826,2011.csv,2011,0.0,1.0
4922,Leviathan,4439481,1092800,3346681,2014.csv,2014,0.24615489963804327,0.7538451003619567
4923,The Games Maker,4437634,0,4437634,2014.csv,2014,0.0,1.0
4924,Tokumei Sentai Go-Busters vs. Kaizoku Sentai Gokaiger: The Movie,4435269,0,4435269,2013.csv,2013,0.0,1.0
4925,Ikimizin Yerine,4434937,0,4434937,2016.csv,2016,0.0,1.0
4926,Fist & Faith,4433919,0,4433919,2017.csv,2017,0.0,1.0
4927,Pained,4433282,0,4433282,2011.csv,2011,0.0,1.0
4928,Detetives do Prédio Azul 2: O Mistério Italiano,4432618,0,4432618,2018.csv,2018,0.0,1.0
4929,Le marquis,4431953,0,4431953,2011.csv,2011,0.0,1.0
4930,Kyaa Kool Hain Hum 3,4429709,0,4429709,2016.csv,2016,0.0,1.0
4931,Forever Love,4428450,0,4428450,2015.csv,2015,0.0,1.0
4932,Swift,4428275,0,4428275,2019.csv,2019,0.0,1.0
4933,Sharm el Sheikh - Un'estate indimenticabile,4427419,0,4427419,2010.csv,2010,0.0,1.0
4934,Samsara,4426444,2672413,1754031,2012.csv,2012,0.6037381247791681,0.3962618752208319
4935,Safety Not Guaranteed,4424699,4010957,413742,2012.csv,2012,0.906492622436012,0.09350737756398797
4936,Go Lala Go 2 2015 Re-release,4423291,0,4423291,2015.csv,2015,0.0,1.0
4937,Kuan Mun Ho,4419338,0,4419338,2010.csv,2010,0.0,1.0
4938,Frits en Freddy,4419099,0,4419099,2010.csv,2010,0.0,1.0
4939,Don't Think Twice,4417667,4417667,0,2016.csv,2016,1.0,0.0
4940,The Man with the Iron Heart,4412639,0,4412639,2017.csv,2017,0.0,1.0
4941,The Commune,4410339,38737,4371602,2016.csv,2016,0.008783225053675013,0.991216774946325
4942,The Secret of China,4408165,0,4408165,2019.csv,2019,0.0,1.0
4943,Thérèse,4408087,101944,4306143,2012.csv,2012,0.02312658529652432,0.9768734147034757
4944,Belli di papà,4405964,0,4405964,2015.csv,2015,0.0,1.0
4945,Not Quite Dead Yet,4405016,0,4405016,2020.csv,2020,0.0,1.0
4946,No Filter,4402895,0,4402895,2016.csv,2016,0.0,1.0
4947,The African Doctor,4401654,0,4401654,2016.csv,2016,0.0,1.0
4948,The Eagle Huntress,4400140,3169351,1230789,2016.csv,2016,0.7202841273232216,0.27971587267677844
4949,360,4396975,100343,4296632,2012.csv,2012,0.02282091665292616,0.9771790833470738
4950,Jesters: The Game Changers,4394324,0,4394324,2019.csv,2019,0.0,1.0
4951,Hedefim Sensin,4394284,0,4394284,2018.csv,2018,0.0,1.0
4952,Angel of Evil,4389985,0,4389985,2011.csv,2011,0.0,1.0
4953,Kabali,4388789,3903095,485694,2016.csv,2016,0.8893330255794936,0.11066697442050644
4954,White Elephant,4387907,8884,4379023,2012.csv,2012,0.0020246554906473632,0.9979753445093527
4955,No Game No Life: Zero,4386487,0,4386487,2017.csv,2017,0.0,1.0
4956,Gangs of Wasseypur,4384494,0,4384494,2012.csv,2012,0.0,1.0
4957,Wolf Creek 2,4383978,0,4383978,2014.csv,2014,0.0,1.0
4958,Clown,4381603,55007,4326596,2014.csv,2014,0.012554081234653163,0.9874459187653468
4959,Bhoot: Part One - The Haunted Ship,4377328,0,4377328,2020.csv,2020,0.0,1.0
4960,Brian Banks,4376819,4376819,0,2019.csv,2019,1.0,0.0
4961,Super Bobrovs,4376775,0,4376775,2016.csv,2016,0.0,1.0
4962,Terra Willy,4376635,0,4376635,2019.csv,2019,0.0,1.0
4963,Seven Days in Utopia,4373074,4373074,0,2011.csv,2011,1.0,0.0
4964,There Be Dragons,4372642,1069334,3303308,2011.csv,2011,0.24455100600506513,0.7554489939949349
4965,Bring Me Home,4372290,0,4372290,2019.csv,2019,0.0,1.0
4966,Mark Felt: The Man Who Brought Down the White House,4372130,768946,3603184,2017.csv,2017,0.17587445935962562,0.8241255406403744
4967,Agamenon: The Film,4372011,0,4372011,2012.csv,2012,0.0,1.0
4968,Demolition,4366460,1978592,2387868,2016.csv,2016,0.4531341177979416,0.5468658822020585
4969,Werner - Eiskalt!,4365667,0,4365667,2011.csv,2011,0.0,1.0
4970,Ironiya lyubvi,4364929,0,4364929,2010.csv,2010,0.0,1.0
4971,King of Devil's Island,4360391,7615,4352776,2010.csv,2010,0.0017464030175275566,0.9982535969824724
4972,The Golden Holiday,4356489,0,4356489,2020.csv,2020,0.0,1.0
4973,Mr. Zoo: The Missing VIP,4354691,0,4354691,2020.csv,2020,0.0,1.0
4974,"Aurelia, La Película",4352104,0,4352104,2011.csv,2011,0.0,1.0
4975,The House at the End of Time,4350990,0,4350990,2013.csv,2013,0.0,1.0
4976,Rainbow Days,4349271,0,4349271,2018.csv,2018,0.0,1.0
4977,Kyaa Kool Hai Hum 3,4348084,0,4348084,2016.csv,2016,0.0,1.0
4978,The Wretched,4344913,1814193,2530720,2020.csv,2020,0.4175441487551074,0.5824558512448926
4979,Blinky Bill the Movie,4344536,0,4344536,2015.csv,2015,0.0,1.0
4980,The Last Days,4343816,0,4343816,2013.csv,2013,0.0,1.0
4981,The Assault,4342738,0,4342738,2011.csv,2011,0.0,1.0
4982,Kiyoku yawaku,4339844,0,4339844,2013.csv,2013,0.0,1.0
4983,My Teacher,4333105,0,4333105,2017.csv,2017,0.0,1.0
4984,Delete History,4330672,0,4330672,2020.csv,2020,0.0,1.0
4985,Storm Boy,4326645,71760,4254885,2018.csv,2018,0.016585599234510806,0.9834144007654892
4986,Space Chimps 2: Zartog Strikes Back,4324969,0,4324969,2010.csv,2010,0.0,1.0
4987,Standing Tall,4323120,26144,4296976,2015.csv,2015,0.006047484224356484,0.9939525157756435
4988,KL Gangster,4321809,0,4321809,2011.csv,2011,0.0,1.0
4989,Please Give,4313829,4033574,280255,2010.csv,2010,0.9350333543587379,0.06496664564126209
4990,Rams,4306844,0,4306844,2020.csv,2020,0.0,1.0
4991,Tezz,4305016,229931,4075085,2012.csv,2012,0.05341002216948787,0.9465899778305121
4992,Place publique,4303454,0,4303454,2018.csv,2018,0.0,1.0
4993,Whisper of Silent Body,4303111,0,4303111,2019.csv,2019,0.0,1.0
4994,What If...,4301754,0,4301754,2012.csv,2012,0.0,1.0
4995,Disco Polo,4301648,0,4301648,2015.csv,2015,0.0,1.0
4996,The Relatives,4300000,0,4300000,2021.csv,2021,0.0,1.0
4997,The Rental,4296804,1637548,2659256,2020.csv,2020,0.3811083772962416,0.6188916227037584
4998,Ultraman Zero: The Revenge of Belial,4295855,0,4295855,2010.csv,2010,0.0,1.0
4999,The Grand Seduction,4292517,3430018,862499,2014.csv,2014,0.7990691708384614,0.20093082916153857
5000,National Theatre Live: Hamlet,4291981,0,4291981,2011.csv,2011,0.0,1.0
5001,Mood of the Day,4289474,0,4289474,2016.csv,2016,0.0,1.0
5002,High-Rise,4286576,346472,3940104,2016.csv,2016,0.08082721500796906,0.9191727849920309
5003,The Other Side of Hope,4282973,183943,4099030,2017.csv,2017,0.042947503988467826,0.9570524960115322
5004,Romeo + Juliet 2018 Re-release,4280231,0,4280231,2018.csv,2018,0.0,1.0
5005,Gaston Lagaffe,4277870,0,4277870,2018.csv,2018,0.0,1.0
5006,No Escape,4277089,167962,4109127,2020.csv,2020,0.03927016716275953,0.9607298328372404
5007,Deo pa-i-beu,4276330,0,4276330,2013.csv,2013,0.0,1.0
5008,Yang Shan Zhou,4274238,0,4274238,2011.csv,2011,0.0,1.0
5009,Stone,4273258,0,4273258,2012.csv,2012,0.0,1.0
5010,Alles ist Liebe,4272104,0,4272104,2014.csv,2014,0.0,1.0
5011,Amis Publics N°1,4271449,0,4271449,2016.csv,2016,0.0,1.0
5012,Seer Movie 7: Crazy Intelligence,4271262,0,4271262,2019.csv,2019,0.0,1.0
5013,El paseo 4,4270311,0,4270311,2016.csv,2016,0.0,1.0
5014,Hartenstraat,4268955,0,4268955,2014.csv,2014,0.0,1.0
5015,Bright Days Ahead,4268717,0,4268717,2013.csv,2013,0.0,1.0
5016,Kikoriki. Legend of the Golden Dragon,4267406,0,4267406,2016.csv,2016,0.0,1.0
5017,Get Well Soon,4264593,0,4264593,2014.csv,2014,0.0,1.0
5018,Vypusknoy,4262900,0,4262900,2014.csv,2014,0.0,1.0
5019,13rd Sister: Three Deadly Days,4257126,0,4257126,2020.csv,2020,0.0,1.0
5020,Kamen Rider Super Den-O Trilogy: Episode Blue - The Dispatched Imagin is Newtral,4255461,0,4255461,2010.csv,2010,0.0,1.0
5021,Linda Ronstadt: The Sound of My Voice,4252657,4252657,0,2019.csv,2019,1.0,0.0
5022,Hot Dog,4252581,0,4252581,2018.csv,2018,0.0,1.0
5023,Flowers,4250257,0,4250257,2010.csv,2010,0.0,1.0
5024,A Small September Affair,4245887,0,4245887,2014.csv,2014,0.0,1.0
5025,Monga,4244379,0,4244379,2010.csv,2010,0.0,1.0
5026,I'm Rich,4243953,0,4243953,2016.csv,2016,0.0,1.0
5027,"Don't Worry, He Won't Get Far on Foot",4241656,1441705,2799951,2018.csv,2018,0.3398920138738266,0.6601079861261734
5028,The Fastest,4241561,0,4241561,2017.csv,2017,0.0,1.0
5029,Die Superbullen - Sie kennen keine Gnade,4240201,0,4240201,2011.csv,2011,0.0,1.0
5030,Night of Adventure,4240000,0,4240000,2014.csv,2014,0.0,1.0
5031,Among Wolves,4237021,0,4237021,2010.csv,2010,0.0,1.0
5032,My Straight Son,4231351,0,4231351,2014.csv,2014,0.0,1.0
5033,The Mercy,4230143,0,4230143,2018.csv,2018,0.0,1.0
5034,Il vegetale,4229602,0,4229602,2018.csv,2018,0.0,1.0
5035,Branded,4227984,353513,3874471,2012.csv,2012,0.08361266267800446,0.9163873373219955
5036,61 Days,4227648,0,4227648,2016.csv,2016,0.0,1.0
5037,The Empty Man,4225540,2992948,1232592,2020.csv,2020,0.7082995309475238,0.29170046905247615
5038,Kamen Rider Super Den-O Trilogy: Episode Red - Zero's Star Twinkle,4224455,0,4224455,2010.csv,2010,0.0,1.0
5039,Ostrov vezeniya,4222736,0,4222736,2013.csv,2013,0.0,1.0
5040,The Hunt,4221961,0,4221961,2016.csv,2016,0.0,1.0
5041,Dabangg 2,4216988,2519190,1697798,2012.csv,2012,0.5973908391487004,0.40260916085129955
5042,Pink and Gray,4215944,0,4215944,2016.csv,2016,0.0,1.0
5043,My Gangster Girlfriend,4214668,0,4214668,2010.csv,2010,0.0,1.0
5044,Go! Princess Pretty Cure the Movie Go! Go!! Gorgeous Triple Feature,4214364,0,4214364,2015.csv,2015,0.0,1.0
5045,Happy Heroes 2 Qiyuan Planet Wars,4210000,0,4210000,2014.csv,2014,0.0,1.0
5046,A Perfect Man,4208906,0,4208906,2015.csv,2015,0.0,1.0
5047,The Rabbi's Cat,4208573,23392,4185181,2011.csv,2011,0.005558178508487319,0.9944418214915127
5048,Lafangey Parindey,4208009,0,4208009,2010.csv,2010,0.0,1.0
5049,Peppa Pig: Festival of Fun,4207779,0,4207779,2019.csv,2019,0.0,1.0
5050,Diplomacy,4207242,230880,3976362,2014.csv,2014,0.05487680528003856,0.9451231947199614
5051,Colosio,4206714,0,4206714,2012.csv,2012,0.0,1.0
5052,The Candidate,4206101,0,4206101,2018.csv,2018,0.0,1.0
5053,The Dandelions,4202633,0,4202633,2012.csv,2012,0.0,1.0
5054,Family United,4202521,0,4202521,2013.csv,2013,0.0,1.0
5055,Tokyo Night,4202408,0,4202408,2011.csv,2011,0.0,1.0
5056,Rosalie Blum,4199529,0,4199529,2016.csv,2016,0.0,1.0
5057,Bamse and the Thief City,4195153,0,4195153,2014.csv,2014,0.0,1.0
5058,Let the Sunshine In,4192590,892421,3300169,2017.csv,2017,0.2128567305651161,0.7871432694348839
5059,"White as Milk, Red as Blood",4191786,0,4191786,2013.csv,2013,0.0,1.0
5060,Sheep & Wolves,4190750,0,4190750,2016.csv,2016,0.0,1.0
5061,Song of the Sea,4190670,857522,3333148,2014.csv,2014,0.20462646784404404,0.795373532155956
5062,Pak Van Mijn Hart,4188209,0,4188209,2014.csv,2014,0.0,1.0
5063,Tanu Weds Manu Returns,4180081,3043479,1136602,2015.csv,2015,0.7280909149846618,0.2719090850153382
5064,Better and Better,4180000,0,4180000,2013.csv,2013,0.0,1.0
5065,Girl,4178992,0,4178992,2018.csv,2018,0.0,1.0
5066,Nitro Circus: The Movie,4174269,3377618,796651,2012.csv,2012,0.8091519736749117,0.1908480263250883
5067,Krrish 3,4170204,2191534,1978670,2013.csv,2013,0.5255220128319862,0.47447798716801387
5068,The Guardians,4167608,177331,3990277,2017.csv,2017,0.04254982714305184,0.9574501728569481
5069,At War with Love,4165279,0,4165279,2016.csv,2016,0.0,1.0
5070,The Secret of Arkandias,4164315,0,4164315,2014.csv,2014,0.0,1.0
5071,Sudkate Salateped,4164003,0,4164003,2010.csv,2010,0.0,1.0
5072,Superintelligence,4160040,0,4160040,2020.csv,2020,0.0,1.0
5073,A Quiet Passion,4159246,1865396,2293850,2016.csv,2016,0.44849378949934676,0.5515062105006533
5074,Boogie,4156995,4156995,0,2021.csv,2021,1.0,0.0
5075,The Legendary Giulia and Other Miracles,4156499,0,4156499,2015.csv,2015,0.0,1.0
5076,Romantik Komedi,4155173,0,4155173,2010.csv,2010,0.0,1.0
5077,Imogène McCarthery,4151851,0,4151851,2010.csv,2010,0.0,1.0
5078,The Whistler,4149016,0,4149016,2010.csv,2010,0.0,1.0
5079,Their Lucky Stars,4148577,0,4148577,2019.csv,2019,0.0,1.0
5080,Zot van A.,4145696,0,4145696,2010.csv,2010,0.0,1.0
5081,Savage,4140502,74491,4066011,2019.csv,2019,0.01799081367428394,0.9820091863257161
5082,Lady J,4139139,0,4139139,2018.csv,2018,0.0,1.0
5083,Polis Evo,4138582,0,4138582,2015.csv,2015,0.0,1.0
5084,The Last Princess,4135255,29259,4105996,2016.csv,2016,0.007075500785320373,0.9929244992146796
5085,Peach Girl,4134365,0,4134365,2017.csv,2017,0.0,1.0
5086,Send Me to the Clouds,4132253,0,4132253,2019.csv,2019,0.0,1.0
5087,The Inerasable,4131434,0,4131434,2016.csv,2016,0.0,1.0
5088,Ghost Stories,4131358,148747,3982611,2018.csv,2018,0.03600438403062625,0.9639956159693738
5089,Nativity Rocks!,4129456,0,4129456,2018.csv,2018,0.0,1.0
5090,Apartment 143,4126744,383,4126361,2012.csv,2012,9.280924622414184e-05,0.9999071907537759
5091,Arctic 2019 Re-release,4124015,2410795,1713220,2019.csv,2019,0.5845747408775186,0.41542525912248135
5092,Another Round,4123838,0,4123838,2020.csv,2020,0.0,1.0
5093,The Fallen Angel,4122770,0,4122770,2010.csv,2010,0.0,1.0
5094,Ishqiya,4122090,0,4122090,2010.csv,2010,0.0,1.0
5095,Carancho,4120012,85526,4034486,2010.csv,2010,0.02075867740191048,0.9792413225980895
5096,Po cem muzi touzí,4115156,0,4115156,2018.csv,2018,0.0,1.0
5097,No Kids,4114621,0,4114621,2015.csv,2015,0.0,1.0
5098,Selfie,4112881,0,4112881,2018.csv,2018,0.0,1.0
5099,Thappad,4112382,0,4112382,2020.csv,2020,0.0,1.0
5100,Çakallarla Dans 4,4111121,0,4111121,2016.csv,2016,0.0,1.0
5101,The Fall of the American Empire,4110928,2178460,1932468,2018.csv,2018,0.5299192785667859,0.4700807214332141
5102,Naam Hai Akira,4108063,219401,3888662,2016.csv,2016,0.05340740879582421,0.9465925912041758
5103,The Sense of Wonder,4108042,0,4108042,2015.csv,2015,0.0,1.0
5104,The Harry Hill Movie,4107208,0,4107208,2013.csv,2013,0.0,1.0
5105,Intention,4107019,0,4107019,2018.csv,2018,0.0,1.0
5106,The Hero,4101699,4077333,24366,2017.csv,2017,0.9940595348415376,0.005940465158462384
5107,Bajo el mismo techo,4101147,0,4101147,2019.csv,2019,0.0,1.0
5108,I Love Karditsa,4100754,0,4100754,2010.csv,2010,0.0,1.0
5109,"Yes, I Do",4100000,0,4100000,2020.csv,2020,0.0,1.0
5110,Force Majeure,4094339,1359497,2734842,2014.csv,2014,0.3320430965779824,0.6679569034220175
5111,Beata ignoranza,4094269,0,4094269,2017.csv,2017,0.0,1.0
5112,Pièce montée,4090851,0,4090851,2010.csv,2010,0.0,1.0
5113,Solo,4090423,0,4090423,2017.csv,2017,0.0,1.0
5114,Het vonnis,4090360,0,4090360,2013.csv,2013,0.0,1.0
5115,Rare Exports,4087363,236347,3851016,2010.csv,2010,0.057823834095479164,0.9421761659045208
5116,The Girl with All the Gifts,4086096,0,4086096,2016.csv,2016,0.0,1.0
5117,8 luchshikh svidaniy,4085476,0,4085476,2016.csv,2016,0.0,1.0
5118,2001: A Space Odyssey 2018 Re-release,4084582,3236321,848261,2018.csv,2018,0.7923261180703436,0.20767388192965644
5119,Tere Naal Love Ho Gaya,4083976,177743,3906233,2012.csv,2012,0.043522048121732354,0.9564779518782677
5120,Journalist,4083046,0,4083046,2015.csv,2015,0.0,1.0
5121,Soreike! Anpanman: Sukue! Kokorin to kiseki no hoshi,4080957,0,4080957,2011.csv,2011,0.0,1.0
5122,Mandira Filozofu,4080294,0,4080294,2014.csv,2014,0.0,1.0
5123,American Animals,4080073,2856954,1223119,2018.csv,2018,0.700221295060162,0.2997787049398381
5124,Katti Batti,4079135,364932,3714203,2015.csv,2015,0.08946308469810389,0.9105369153018961
5125,Plan Man,4072622,0,4072622,2014.csv,2014,0.0,1.0
5126,Marseille,4065486,0,4065486,2016.csv,2016,0.0,1.0
5127,The Resistance Banker,4061737,0,4061737,2018.csv,2018,0.0,1.0
5128,Le coeur des hommes 3,4060827,0,4060827,2013.csv,2013,0.0,1.0
5129,Begum Jaan,4060734,0,4060734,2017.csv,2017,0.0,1.0
5130,From Prada to Nada,4058694,3033623,1025071,2011.csv,2011,0.7474382153471043,0.25256178465289575
5131,Dreams for Sale,4058247,0,4058247,2012.csv,2012,0.0,1.0
5132,Two Days in New York,4058113,633210,3424903,2012.csv,2012,0.15603557614093053,0.8439644238590694
5133,Venise n'est pas en Italie,4053996,0,4053996,2019.csv,2019,0.0,1.0
5134,Infidel,4051990,4051990,0,2020.csv,2020,1.0,0.0
5135,The Killer Inside Me,4050140,217277,3832863,2010.csv,2010,0.053646787518456154,0.9463532124815438
5136,Film Stars Don't Die in Liverpool,4047917,1026124,3021793,2017.csv,2017,0.2534943280704619,0.7465056719295381
5137,Stuck with You!,4047743,0,4047743,2015.csv,2015,0.0,1.0
5138,Love in the Buff,4045381,256451,3788930,2012.csv,2012,0.06339353450268342,0.9366064654973165
5139,Tensou Sentai Goseiger vs. Shinkenger: Epic on Ginmaku,4042627,0,4042627,2011.csv,2011,0.0,1.0
5140,Matrimonio al Sud,4041949,0,4041949,2015.csv,2015,0.0,1.0
5141,Bye Bye Morons,4041591,0,4041591,2020.csv,2020,0.0,1.0
5142,My Dog Stupid,4040319,0,4040319,2019.csv,2019,0.0,1.0
5143,Overheard 2,4040142,0,4040142,2011.csv,2011,0.0,1.0
5144,Junglee,4033587,295784,3737803,2019.csv,2019,0.07333026410487738,0.9266697358951226
5145,Faccio un salto all'Avana,4032630,0,4032630,2011.csv,2011,0.0,1.0
5146,Vulgaria,4028543,59059,3969484,2012.csv,2012,0.014660138913746235,0.9853398610862537
5147,25 lat niewinnosci. Sprawa Tomka Komendy,4027477,0,4027477,2020.csv,2020,0.0,1.0
5148,A Better Life,4024643,0,4024643,2011.csv,2011,0.0,1.0
5149,Les meilleurs amis du monde,4023499,0,4023499,2010.csv,2010,0.0,1.0
5150,Winter Sleep,4018705,0,4018705,2014.csv,2014,0.0,1.0
5151,Jeepers Creepers III,4017852,2335162,1682690,2017.csv,2017,0.5811966194872284,0.4188033805127715
5152,Magic Silver II,4017761,0,4017761,2011.csv,2011,0.0,1.0
5153,Yao,4017253,0,4017253,2019.csv,2019,0.0,1.0
5154,Put Grandma in the Freezer,4014383,0,4014383,2018.csv,2018,0.0,1.0
5155,Didi's Dream,4013033,0,4013033,2017.csv,2017,0.0,1.0
5156,Heart is... 2,4011423,0,4011423,2010.csv,2010,0.0,1.0
5157,Sanada 10 Braves,4010847,0,4010847,2016.csv,2016,0.0,1.0
5158,Sour Apples,4009596,0,4009596,2016.csv,2016,0.0,1.0
5159,A Perfect Day,4009440,14044,3995396,2015.csv,2015,0.0035027335488247734,0.9964972664511752
5160,I Feel Good,4008558,0,4008558,2018.csv,2018,0.0,1.0
5161,Randka w ciemno,4007842,0,4007842,2010.csv,2010,0.0,1.0
5162,Die Kirche bleibt im Dorf,4007192,0,4007192,2012.csv,2012,0.0,1.0
5163,Penguin Highway,4006647,104567,3902080,2018.csv,2018,0.026098381015347744,0.9739016189846522
5164,Ride Your Wave,4006347,332432,3673915,2019.csv,2019,0.08297633729679431,0.9170236627032057
5165,Three Little Pigs 2,4001201,0,4001201,2017.csv,2017,0.0,1.0
5166,Podarok s kharakterom,3998673,0,3998673,2014.csv,2014,0.0,1.0
5167,Faces Places,3996577,953717,3042860,2017.csv,2017,0.23863346058389467,0.7613665394161053
5168,Regret!,3995340,0,3995340,2013.csv,2013,0.0,1.0
5169,Kamen Rider Super Movie War Genesis: Kamen Rider vs. Kamen Rider Ghost & Drive,3994806,0,3994806,2015.csv,2015,0.0,1.0
5170,Lo contrario al amor,3993705,0,3993705,2011.csv,2011,0.0,1.0
5171,Confucius,3990786,0,3990786,2010.csv,2010,0.0,1.0
5172,Bolshoy,3990117,0,3990117,2017.csv,2017,0.0,1.0
5173,Asphalt Burning,3989896,0,3989896,2020.csv,2020,0.0,1.0
5174,Sleight,3989705,3986245,3460,2017.csv,2017,0.999132767961541,0.0008672320384589838
5175,D'après une histoire vraie,3988331,0,3988331,2017.csv,2017,0.0,1.0
5176,Mr. Osomatsu the Movie,3987805,0,3987805,2019.csv,2019,0.0,1.0
5177,Wonderland,3987780,0,3987780,2016.csv,2016,0.0,1.0
5178,Goodbye Berlin,3987502,0,3987502,2016.csv,2016,0.0,1.0
5179,The Invisible Woman,3986888,1234254,2752634,2013.csv,2013,0.3095782976597286,0.6904217023402714
5180,All Three of Us,3985169,0,3985169,2015.csv,2015,0.0,1.0
5181,Documentary of AKB48: Show Must Go On,3984152,0,3984152,2012.csv,2012,0.0,1.0
5182,The Nile Hilton Incident,3979536,81089,3898447,2017.csv,2017,0.02037649615432553,0.9796235038456744
5183,Dik Trom,3976432,0,3976432,2010.csv,2010,0.0,1.0
5184,Box Office 3D: The Filmest of Films,3974349,0,3974349,2011.csv,2011,0.0,1.0
5185,Kung Fu Hustle 2015 Re-release,3970000,0,3970000,2015.csv,2015,0.0,1.0
5186,Ip Man: The Final Fight,3967001,37884,3929117,2013.csv,2013,0.009549783324985298,0.9904502166750146
5187,Verliefd op Cuba,3966812,0,3966812,2019.csv,2019,0.0,1.0
5188,Sniadanie do lózka,3965979,0,3965979,2010.csv,2010,0.0,1.0
5189,A Woman as a Friend,3965494,0,3965494,2014.csv,2014,0.0,1.0
5190,Before I Wake,3965086,0,3965086,2016.csv,2016,0.0,1.0
5191,Zhou Enlai Returned To Yanan,3963494,0,3963494,2019.csv,2019,0.0,1.0
5192,Soreike! Anpanman Mija To Maho No Lamp,3963396,0,3963396,2015.csv,2015,0.0,1.0
5193,The Wild Soccer Bunch 6,3963295,0,3963295,2016.csv,2016,0.0,1.0
5194,My Little Monster,3962689,0,3962689,2018.csv,2018,0.0,1.0
5195,A Loving Husband,3960502,0,3960502,2017.csv,2017,0.0,1.0
5196,Anything for a Pop Star,3960475,0,3960475,2018.csv,2018,0.0,1.0
5197,Gatchaman,3957641,0,3957641,2013.csv,2013,0.0,1.0
5198,Once Again,3957193,0,3957193,2017.csv,2017,0.0,1.0
5199,Lucifer,3956978,0,3956978,2019.csv,2019,0.0,1.0
5200,The Invisible Guardian,3955278,0,3955278,2017.csv,2017,0.0,1.0
5201,Hello Carbot the Movie: The Secret of Omphalos Island,3954836,0,3954836,2019.csv,2019,0.0,1.0
5202,Break Ke Baad,3954699,427628,3527071,2010.csv,2010,0.10813161760224987,0.8918683823977501
5203,Offroad,3952879,0,3952879,2012.csv,2012,0.0,1.0
5204,The Devil's Violinist,3952097,11294,3940803,2013.csv,2013,0.002857723380777344,0.9971422766192226
5205,Bully 2012 Re-release,3950244,3863446,86798,2012.csv,2012,0.978027180093179,0.021972819906820946
5206,The Zero Hour,3947360,0,3947360,2010.csv,2010,0.0,1.0
5207,Ma famille t'adore déjà,3947091,0,3947091,2016.csv,2016,0.0,1.0
5208,2:22,3945729,422,3945307,2017.csv,2017,0.00010695108559153454,0.9998930489144084
5209,Joint Custody,3945420,0,3945420,2017.csv,2017,0.0,1.0
5210,You Call It Passion,3939736,0,3939736,2015.csv,2015,0.0,1.0
5211,Happy Little Submarine: Space Pals,3935230,0,3935230,2019.csv,2019,0.0,1.0
5212,The Footballest,3934443,0,3934443,2018.csv,2018,0.0,1.0
5213,Snabba cash - Livet deluxe,3931915,0,3931915,2013.csv,2013,0.0,1.0
5214,Terminator 2: Judgment Day 2017 Re-release,3931111,1037809,2893302,2017.csv,2017,0.2639989051441183,0.7360010948558817
5215,Grand Blue,3930159,0,3930159,2020.csv,2020,0.0,1.0
5216,A Happy Event,3929796,0,3929796,2011.csv,2011,0.0,1.0
5217,Ushijima the Loan Shark,3928891,0,3928891,2012.csv,2012,0.0,1.0
5218,Buona giornata,3927883,0,3927883,2012.csv,2012,0.0,1.0
5219,Welcome to the Punch,3926386,9747,3916639,2013.csv,2013,0.002482435501756577,0.9975175644982435
5220,Loveless,3925992,566356,3359636,2017.csv,2017,0.1442580626756244,0.8557419373243756
5221,7 Khoon Maaf,3924850,270207,3654643,2011.csv,2011,0.06884517879664191,0.9311548212033581
5222,Indignation,3924527,3401155,523372,2016.csv,2016,0.86664074422217,0.13335925577783003
5223,Knerten i knipe,3918260,0,3918260,2011.csv,2011,0.0,1.0
5224,Innocent Curse,3918114,0,3918114,2017.csv,2017,0.0,1.0
5225,Soreike! Anpanman: Omocha no hoshi no Nanda to Runda,3915932,0,3915932,2016.csv,2016,0.0,1.0
5226,A Private War,3915207,1633208,2281999,2018.csv,2018,0.4171447384518877,0.5828552615481123
5227,Granny's Funeral,3915063,0,3915063,2012.csv,2012,0.0,1.0
5228,The Seven Deadly Sins: Prisoners of the Sky,3914227,0,3914227,2018.csv,2018,0.0,1.0
5229,Chiamatemi Francesco - Il Papa della gente,3911568,0,3911568,2015.csv,2015,0.0,1.0
5230,Earthquake,3910254,0,3910254,2016.csv,2016,0.0,1.0
5231,The To Do List,3909596,3491669,417927,2013.csv,2013,0.8931022540436403,0.10689774595635969
5232,Reintsurî no kuni,3907507,0,3907507,2015.csv,2015,0.0,1.0
5233,The Starving Games,3906308,0,3906308,2013.csv,2013,0.0,1.0
5234,Taxi,3906227,321642,3584585,2015.csv,2015,0.08234083682284721,0.9176591631771528
5235,Hello Carbot The Movie: Save The Moon,3906109,0,3906109,2019.csv,2019,0.0,1.0
5236,Cats & Dogs 3: Paws Unite,3903149,0,3903149,2020.csv,2020,0.0,1.0
5237,La Leyenda de la Llorona,3898653,0,3898653,2011.csv,2011,0.0,1.0
5238,Swallows and Amazons,3898580,0,3898580,2016.csv,2016,0.0,1.0
5239,Nesokrushymiy,3898030,0,3898030,2018.csv,2018,0.0,1.0
5240,Colourful,3897204,0,3897204,2010.csv,2010,0.0,1.0
5241,Agent Ranjid rettet die Welt,3891097,0,3891097,2012.csv,2012,0.0,1.0
5242,Enthiran,3889511,0,3889511,2010.csv,2010,0.0,1.0
5243,The Wall,3889260,38674,3850586,2012.csv,2012,0.009943793935093051,0.990056206064907
5244,The Ultimate Accessory,3888548,0,3888548,2013.csv,2013,0.0,1.0
5245,Beaux-parents,3887946,0,3887946,2019.csv,2019,0.0,1.0
5246,Solomon's Perjury 2,3885772,0,3885772,2015.csv,2015,0.0,1.0
5247,Rules Don't Apply,3885342,3652206,233136,2016.csv,2016,0.9399960157947486,0.06000398420525143
5248,Neruda,3884746,939101,2945645,2016.csv,2016,0.2417406440472556,0.7582593559527444
5249,Fashion King,3883195,0,3883195,2014.csv,2014,0.0,1.0
5250,The Perfect Game,3878993,1037071,2841922,2010.csv,2010,0.26735572866463025,0.7326442713353698
5251,"The Night Is Short, Walk on Girl",3878208,406490,3471718,2017.csv,2017,0.10481387279898345,0.8951861272010165
5252,Blind Date,3877000,0,3877000,2015.csv,2015,0.0,1.0
5253,Django,3876874,56556,3820318,2017.csv,2017,0.014588041808941946,0.9854119581910581
5254,Horns,3875442,173948,3701494,2014.csv,2014,0.044884686701542685,0.9551153132984573
5255,Submarine,3875173,467602,3407571,2011.csv,2011,0.1206660967136177,0.8793339032863823
5256,Sophie's Misfortunes,3874946,0,3874946,2016.csv,2016,0.0,1.0
5257,Geuk-Jang-Pan Hel-Lo-Ka-Bot: Om-Pa-Ro-Seu Seom-Ui Bi-Mil,3872562,0,3872562,2019.csv,2019,0.0,1.0
5258,Dreambuilders,3869485,0,3869485,2020.csv,2020,0.0,1.0
5259,Kolpaçino: Bomba,3866902,0,3866902,2011.csv,2011,0.0,1.0
5260,Papa,3865151,0,3865151,2012.csv,2012,0.0,1.0
5261,First Reformed,3862498,3448256,414242,2018.csv,2018,0.8927528247263817,0.10724717527361827
5262,Bro's Before Ho's,3860405,0,3860405,2013.csv,2013,0.0,1.0
5263,212 Warrior,3859763,0,3859763,2018.csv,2018,0.0,1.0
5264,Niyazi Gül Dörtnala,3858492,0,3858492,2015.csv,2015,0.0,1.0
5265,The Child's Eye,3858231,0,3858231,2010.csv,2010,0.0,1.0
5266,Pokémon the Movie: Volcanion and the Mechanical Marvel 2017 Re-release,3857383,0,3857383,2017.csv,2017,0.0,1.0
5267,Kasablanka,3856353,0,3856353,2019.csv,2019,0.0,1.0
5268,Dabbe 5: Curse of the Jinn,3853240,0,3853240,2014.csv,2014,0.0,1.0
5269,Monsieur Papa,3852016,0,3852016,2011.csv,2011,0.0,1.0
5270,Let'S Go! Anpanman: Sparkle! Princess Vanilla of the Land of Ice Cream,3849126,0,3849126,2019.csv,2019,0.0,1.0
5271,"Lula, the Son of Brazil",3849080,0,3849080,2010.csv,2010,0.0,1.0
5272,Where's the Dragon?,3847928,0,3847928,2015.csv,2015,0.0,1.0
5273,A.C.A.B. - All Cops Are Bastards,3847381,0,3847381,2012.csv,2012,0.0,1.0
5274,Bloody Milk,3845589,0,3845589,2017.csv,2017,0.0,1.0
5275,Frozen,3843774,246176,3597598,2010.csv,2010,0.06404538872472731,0.9359546112752727
5276,Marley,3842919,1413480,2429439,2012.csv,2012,0.36781415377217164,0.6321858462278284
5277,Love at First Child,3840883,0,3840883,2015.csv,2015,0.0,1.0
5278,A Long Story,3839316,0,3839316,2012.csv,2012,0.0,1.0
5279,Wendy 2 - Freundschaft für immer,3837990,0,3837990,2018.csv,2018,0.0,1.0
5280,Horrible Histories: The Movie - Rotten Romans,3837593,0,3837593,2019.csv,2019,0.0,1.0
5281,The Journalist,3836428,0,3836428,2019.csv,2019,0.0,1.0
5282,Thriller Restaurant the Movie,3835087,0,3835087,2010.csv,2010,0.0,1.0
5283,The Top Secret: Murder in Mind,3833651,0,3833651,2016.csv,2016,0.0,1.0
5284,What a Wonderful Family!,3831089,0,3831089,2017.csv,2017,0.0,1.0
5285,The Magician,3829088,0,3829088,2015.csv,2015,0.0,1.0
5286,The Worst Week of My Life,3825937,0,3825937,2010.csv,2010,0.0,1.0
5287,Persian Lessons,3825279,0,3825279,2020.csv,2020,0.0,1.0
5288,To Save a Life,3824868,3777210,47658,2010.csv,2010,0.9875399621634001,0.012460037836599852
5289,The Blood of Wolves,3823511,0,3823511,2018.csv,2018,0.0,1.0
5290,By Quantum Physics: A Nightlife Venture,3823284,0,3823284,2019.csv,2019,0.0,1.0
5291,Elles,3822241,157508,3664733,2012.csv,2012,0.04120828592440927,0.9587917140755907
5292,The Laws of the Universe Part 0,3821361,0,3821361,2015.csv,2015,0.0,1.0
5293,The Other Son,3820405,1285918,2534487,2012.csv,2012,0.3365920628833854,0.6634079371166146
5294,Monster,3820199,0,3820199,2014.csv,2014,0.0,1.0
5295,The Homesman,3819421,2429989,1389432,2014.csv,2014,0.6362192070473509,0.3637807929526491
5296,Rock It!,3816531,0,3816531,2010.csv,2010,0.0,1.0
5297,Brad's Status,3816527,2133158,1683369,2017.csv,2017,0.558926479493005,0.441073520506995
5298,Sweet 20,3810429,71775,3738654,2015.csv,2015,0.01883646172123926,0.9811635382787607
5299,Happy Killers,3807894,0,3807894,2010.csv,2010,0.0,1.0
5300,Protéger & servir,3807808,0,3807808,2010.csv,2010,0.0,1.0
5301,Asahinagu,3807061,0,3807061,2017.csv,2017,0.0,1.0
5302,The Seventh Dwarf 2018 Re-release,3806937,0,3806937,2018.csv,2018,0.0,1.0
5303,Correspondence,3806269,0,3806269,2016.csv,2016,0.0,1.0
5304,Everybody's Fine,3805627,0,3805627,2016.csv,2016,0.0,1.0
5305,Real,3801975,0,3801975,2013.csv,2013,0.0,1.0
5306,La vita facile,3801152,0,3801152,2011.csv,2011,0.0,1.0
5307,Two by Two: Overboard!,3800114,0,3800114,2020.csv,2020,0.0,1.0
5308,Miracle Girls: Neva-da Stop Dreaming,3796198,0,3796198,2010.csv,2010,0.0,1.0
5309,A Gun in Each Hand,3795398,0,3795398,2012.csv,2012,0.0,1.0
5310,Bad Daddy,3791880,0,3791880,2018.csv,2018,0.0,1.0
5311,Custody,3790303,83882,3706421,2018.csv,2018,0.022130684538940553,0.9778693154610595
5312,Jeom-Bak-I Han-Ban-Do-Ui Gong-Ryong 2: Sae-Ro-Un Nak-Won,3790188,0,3790188,2018.csv,2018,0.0,1.0
5313,14 Blades,3787100,0,3787100,2010.csv,2010,0.0,1.0
5314,Small World,3786465,0,3786465,2010.csv,2010,0.0,1.0
5315,Soreike! Anpanman: Tobase! Kibou no hankachi,3786430,0,3786430,2013.csv,2013,0.0,1.0
5316,The Paperboy,3783865,693286,3090579,2012.csv,2012,0.18322165299237683,0.8167783470076232
5317,Amici come noi,3783006,0,3783006,2014.csv,2014,0.0,1.0
5318,Citizenfour,3780692,2800870,979822,2014.csv,2014,0.7408352756585302,0.25916472434146975
5319,"Yakari, a Spectacular Journey",3774523,0,3774523,2020.csv,2020,0.0,1.0
5320,Black Bread,3770657,0,3770657,2010.csv,2010,0.0,1.0
5321,Non c'è più religione,3770594,0,3770594,2016.csv,2016,0.0,1.0
5322,Merci patron!,3770006,0,3770006,2016.csv,2016,0.0,1.0
5323,Kuiba: the Dragon Spirit Iii,3770000,0,3770000,2014.csv,2014,0.0,1.0
5324,Mysterious Face,3770000,0,3770000,2013.csv,2013,0.0,1.0
5325,Green Room,3769214,3220371,548843,2016.csv,2016,0.8543879440116693,0.1456120559883307
5326,The Full House,3769078,0,3769078,2018.csv,2018,0.0,1.0
5327,Nokas,3768106,0,3768106,2010.csv,2010,0.0,1.0
5328,Sint,3763462,0,3763462,2010.csv,2010,0.0,1.0
5329,"Saraba seishun, saredo seishun",3762474,0,3762474,2018.csv,2018,0.0,1.0
5330,Black Sea,3758103,1171559,2586544,2014.csv,2014,0.3117421209583665,0.6882578790416335
5331,L.DK,3758081,0,3758081,2014.csv,2014,0.0,1.0
5332,Christmas Rose,3754094,0,3754094,2013.csv,2013,0.0,1.0
5333,Min søsters børn og guldgraverne,3746770,0,3746770,2012.csv,2012,0.0,1.0
5334,The Quiz Show Scandal,3746294,0,3746294,2010.csv,2010,0.0,1.0
5335,The Big Wish,3745033,0,3745033,2019.csv,2019,0.0,1.0
5336,Love Without Words,3741863,0,3741863,2017.csv,2017,0.0,1.0
5337,Norske byggeklosser,3741780,0,3741780,2018.csv,2018,0.0,1.0
5338,The Trip,3741198,2030962,1710236,2011.csv,2011,0.542864077228738,0.457135922771262
5339,Take Shelter,3741098,1730296,2010802,2011.csv,2011,0.46251020422346595,0.5374897957765341
5340,Mermaid: The Lake of the Dead,3741098,0,3741098,2018.csv,2018,0.0,1.0
5341,The Unbearable Lightness of Inspector Fan,3740092,0,3740092,2015.csv,2015,0.0,1.0
5342,Bloody Doll,3740000,0,3740000,2014.csv,2014,0.0,1.0
5343,Love Me Love My Dog,3740000,0,3740000,2015.csv,2015,0.0,1.0
5344,The Connection,3739582,0,3739582,2018.csv,2018,0.0,1.0
5345,Utøya: July 22,3738618,0,3738618,2018.csv,2018,0.0,1.0
5346,Throne of Elves,3736946,0,3736946,2016.csv,2016,0.0,1.0
5347,Mea culpa,3736775,0,3736775,2014.csv,2014,0.0,1.0
5348,Like Crazy,3731489,3395391,336098,2011.csv,2011,0.9099292534427945,0.09007074655720544
5349,Love Speaks,3730000,0,3730000,2013.csv,2013,0.0,1.0
5350,Bleach,3729856,0,3729856,2018.csv,2018,0.0,1.0
5351,Ragnarok,3721345,1369,3719976,2013.csv,2013,0.00036787774312782074,0.9996321222568721
5352,Free Fire,3719383,1799312,1920071,2017.csv,2017,0.4837662590811433,0.5162337409188567
5353,Summertime,3719031,35322,3683709,2015.csv,2015,0.009497635271123043,0.990502364728877
5354,Curse of the Deserted,3718710,0,3718710,2010.csv,2010,0.0,1.0
5355,Night of 7 Years,3716820,24281,3692539,2018.csv,2018,0.006532734972368853,0.9934672650276312
5356,Le père Noël,3716603,0,3716603,2014.csv,2014,0.0,1.0
5357,André Rieu - 70 Years Young,3714938,0,3714938,2020.csv,2020,0.0,1.0
5358,Raven the Little Rascal,3713259,0,3713259,2012.csv,2012,0.0,1.0
5359,You Don't Choose Your Family,3713255,0,3713255,2011.csv,2011,0.0,1.0
5360,The Minister,3710016,0,3710016,2011.csv,2011,0.0,1.0
5361,The Last King,3705618,8905,3696713,2016.csv,2016,0.0024031079296354886,0.9975968920703645
5362,ÜnOfficially Yours,3704457,0,3704457,2012.csv,2012,0.0,1.0
5363,In Your Hands,3703867,0,3703867,2018.csv,2018,0.0,1.0
5364,Rokjesdag,3703315,0,3703315,2016.csv,2016,0.0,1.0
5365,A Fantastic Woman,3702353,2020988,1681365,2017.csv,2017,0.5458658318102029,0.4541341681897971
5366,Spare Parts,3701281,3618912,82369,2015.csv,2015,0.9777458128685718,0.02225418713142828
5367,È nata una star?,3695736,0,3695736,2012.csv,2012,0.0,1.0
5368,Villain and Widow,3692494,0,3692494,2010.csv,2010,0.0,1.0
5369,Igualita a mi,3692332,0,3692332,2010.csv,2010,0.0,1.0
5370,Figli,3691574,0,3691574,2020.csv,2020,0.0,1.0
5371,Cockpit,3689436,0,3689436,2012.csv,2012,0.0,1.0
5372,Marafon zhelaniy,3688995,0,3688995,2020.csv,2020,0.0,1.0
5373,Mortadelo and Filemon: Mission Implausible,3688222,0,3688222,2014.csv,2014,0.0,1.0
5374,Bar Sport,3687123,0,3687123,2011.csv,2011,0.0,1.0
5375,Yusuf Yusuf,3685671,0,3685671,2014.csv,2014,0.0,1.0
5376,Stones for the Rampart,3683978,0,3683978,2014.csv,2014,0.0,1.0
5377,Lassie Come Home,3683655,0,3683655,2020.csv,2020,0.0,1.0
5378,Western Stars,3681681,1581681,2100000,2019.csv,2019,0.4296083772602787,0.5703916227397213
5379,Top End Wedding,3681669,0,3681669,2019.csv,2019,0.0,1.0
5380,Bowling,3681038,0,3681038,2012.csv,2012,0.0,1.0
5381,Zatoichi: The Last,3680822,0,3680822,2010.csv,2010,0.0,1.0
5382,Hold Up!,3680776,0,3680776,2012.csv,2012,0.0,1.0
5383,1911,3680151,135739,3544412,2011.csv,2011,0.03688408437588566,0.9631159156241144
5384,Gosnell: The Trial of America's Biggest Serial Killer,3679893,3679893,0,2018.csv,2018,1.0,0.0
5385,5 Flights Up,3679847,1020921,2658926,2015.csv,2015,0.2774357194742064,0.7225642805257936
5386,O chyom molchat devushki,3678530,0,3678530,2013.csv,2013,0.0,1.0
5387,The Travelling Cat Chronicles,3669392,0,3669392,2018.csv,2018,0.0,1.0
5388,Perfect Couple,3667477,0,3667477,2017.csv,2017,0.0,1.0
5389,Yellow Elephant,3666854,0,3666854,2013.csv,2013,0.0,1.0
5390,Rafadan Tayfa Dehliz Macerasi,3666556,0,3666556,2018.csv,2018,0.0,1.0
5391,Prince,3666529,0,3666529,2010.csv,2010,0.0,1.0
5392,Peppa Pig: Vacanze Al Sole E Altre Storie,3666386,0,3666386,2014.csv,2014,0.0,1.0
5393,Reunion 2: The Bachelor Party,3664336,0,3664336,2016.csv,2016,0.0,1.0
5394,Love Crime,3663918,539792,3124126,2010.csv,2010,0.1473264412576919,0.8526735587423081
5395,The Bar,3662671,0,3662671,2017.csv,2017,0.0,1.0
5396,Hound: Cold Blooded,3660871,0,3660871,2017.csv,2017,0.0,1.0
5397,Jump Ashin!,3658542,0,3658542,2011.csv,2011,0.0,1.0
5398,Beur sur la ville,3657995,0,3657995,2011.csv,2011,0.0,1.0
5399,Only You,3655907,0,3655907,2014.csv,2014,0.0,1.0
5400,Les déguns,3652697,0,3652697,2018.csv,2018,0.0,1.0
5401,Number One Fan,3650598,15549,3635049,2014.csv,2014,0.004259302174602627,0.9957406978253974
5402,Non-Fiction,3649042,704919,2944123,2018.csv,2018,0.19317919607392844,0.8068208039260716
5403,A la mala,3646627,3629842,16785,2015.csv,2015,0.9953971162940438,0.0046028837059562165
5404,Life in Overtime,3646535,0,3646535,2018.csv,2018,0.0,1.0
5405,13,3645312,0,3645312,2010.csv,2010,0.0,1.0
5406,The Professor,3645308,0,3645308,2019.csv,2019,0.0,1.0
5407,You Can't Save Yourself Alone,3645305,0,3645305,2015.csv,2015,0.0,1.0
5408,Made in Italy,3643531,0,3643531,2018.csv,2018,0.0,1.0
5409,Celeste & Jesse Forever,3640975,3094813,546162,2012.csv,2012,0.84999567423561,0.15000432576439005
5410,Listen to the Universe,3640915,0,3640915,2019.csv,2019,0.0,1.0
5411,Run,3639891,0,3639891,2020.csv,2020,0.0,1.0
5412,Survivor,3638976,0,3638976,2015.csv,2015,0.0,1.0
5413,Miss Saigon: 25th Anniversary,3638145,0,3638145,2016.csv,2016,0.0,1.0
5414,The German Doctor,3635718,418392,3217326,2013.csv,2013,0.11507823214011648,0.8849217678598835
5415,Find Your Voice,3634579,0,3634579,2020.csv,2020,0.0,1.0
5416,Legend of the Moles: The Treasure of Scylla,3633141,0,3633141,2012.csv,2012,0.0,1.0
5417,Tim Maia,3631742,0,3631742,2014.csv,2014,0.0,1.0
5418,Teen's Confessions,3630598,0,3630598,2014.csv,2014,0.0,1.0
5419,Tout schuss,3630580,0,3630580,2016.csv,2016,0.0,1.0
5420,Comme les cinq doigts de la main,3630481,0,3630481,2010.csv,2010,0.0,1.0
5421,Karthik Calling Karthik,3627172,286409,3340763,2010.csv,2010,0.078962067417812,0.921037932582188
5422,Crooked House,3625952,0,3625952,2017.csv,2017,0.0,1.0
5423,The Love Affair,3624953,0,3624953,2015.csv,2015,0.0,1.0
5424,Le gendre de ma vie,3623355,0,3623355,2018.csv,2018,0.0,1.0
5425,Colonia,3621046,15709,3605337,2016.csv,2016,0.004338249224119219,0.9956617507758808
5426,Obratnaya svyaz,3620042,0,3620042,2020.csv,2020,0.0,1.0
5427,Grave Encounters,3613222,0,3613222,2011.csv,2011,0.0,1.0
5428,Um Suburbano Sortudo,3610588,0,3610588,2016.csv,2016,0.0,1.0
5429,Fate/Grand Order the Sacred Round Table Realm: Camelot,3607899,0,3607899,2020.csv,2020,0.0,1.0
5430,Wedding Unplanned,3606673,0,3606673,2017.csv,2017,0.0,1.0
5431,The Last Circus,3604598,40548,3564050,2010.csv,2010,0.011248965904103592,0.9887510340958964
5432,¡De panzazo!,3603973,0,3603973,2012.csv,2012,0.0,1.0
5433,The Insult,3601603,1001305,2600298,2017.csv,2017,0.2780164832159458,0.7219835167840543
5434,Phoenix Forgotten,3600146,3600146,0,2017.csv,2017,1.0,0.0
5435,Cute & Dangerous,3597444,0,3597444,2015.csv,2015,0.0,1.0
5436,Enes Batur,3595901,0,3595901,2018.csv,2018,0.0,1.0
5437,Heart Blackened,3593480,37047,3556433,2017.csv,2017,0.010309504992375079,0.989690495007625
5438,Peppa Pig: The Golden Boots,3593395,0,3593395,2015.csv,2015,0.0,1.0
5439,Face Off: The Walking Guests,3592627,0,3592627,2019.csv,2019,0.0,1.0
5440,Badla,3590894,1861000,1729894,2019.csv,2019,0.5182553425414396,0.48174465745856043
5441,Indivisible,3589633,3511417,78216,2018.csv,2018,0.9782105858732634,0.02178941412673663
5442,Happy New Year,3587694,0,3587694,2019.csv,2019,0.0,1.0
5443,Bugs,3584722,0,3584722,2014.csv,2014,0.0,1.0
5444,Sunset in My Hometown,3584611,0,3584611,2018.csv,2018,0.0,1.0
5445,The Elfkins,3582825,0,3582825,2020.csv,2020,0.0,1.0
5446,Ghostbusters 30th Anniversary Release,3580343,3580343,0,2014.csv,2014,1.0,0.0
5447,King Naresuan 6,3579768,0,3579768,2015.csv,2015,0.0,1.0
5448,Er Conde Jones,3579383,0,3579383,2011.csv,2011,0.0,1.0
5449,Baby,3576269,0,3576269,2018.csv,2018,0.0,1.0
5450,Far Til Fire 8,3574841,0,3574841,2014.csv,2014,0.0,1.0
5451,Good Morning Show,3573355,0,3573355,2016.csv,2016,0.0,1.0
5452,Proceder,3572622,0,3572622,2019.csv,2019,0.0,1.0
5453,Sunshine Ahead,3571502,0,3571502,2010.csv,2010,0.0,1.0
5454,The Forest of Wool and Steel,3567409,0,3567409,2018.csv,2018,0.0,1.0
5455,Cheburashka,3565391,0,3565391,2010.csv,2010,0.0,1.0
5456,Mission Possible,3563279,0,3563279,2021.csv,2021,0.0,1.0
5457,The Apparition,3562793,28293,3534500,2018.csv,2018,0.007941241604550137,0.9920587583954499
5458,Fonzy,3561714,0,3561714,2013.csv,2013,0.0,1.0
5459,Io che amo solo te,3558171,0,3558171,2014.csv,2014,0.0,1.0
5460,VIPs,3554533,0,3554533,2011.csv,2011,0.0,1.0
5461,Enter the Warriors Gate,3554029,0,3554029,2016.csv,2016,0.0,1.0
5462,Román pro muze,3553389,0,3553389,2010.csv,2010,0.0,1.0
5463,My Masterpiece,3549197,0,3549197,2018.csv,2018,0.0,1.0
5464,The Human Trust,3547836,0,3547836,2013.csv,2013,0.0,1.0
5465,Kizumonogatari II: Fierce,3546960,0,3546960,2016.csv,2016,0.0,1.0
5466,Bacurau,3541476,58115,3483361,2019.csv,2019,0.016409824604204575,0.9835901753957954
5467,Overnight Republic,3540420,0,3540420,2017.csv,2017,0.0,1.0
5468,The Oscar Nominated Short Films 2019: Documentary,3538550,3531094,7456,2019.csv,2019,0.9978929222421613,0.0021070777578386627
5469,Granny's Got Talent,3535083,0,3535083,2015.csv,2015,0.0,1.0
5470,Catfish,3533711,3237343,296368,2010.csv,2010,0.9161312286149037,0.0838687713850963
5471,Ek Ladki Ko Dekha Toh Aisa Laga,3531837,1182636,2349201,2019.csv,2019,0.33485010774846063,0.6651498922515393
5472,La vraie vie des profs,3530139,0,3530139,2013.csv,2013,0.0,1.0
5473,Crimes of Passion,3530000,0,3530000,2013.csv,2013,0.0,1.0
5474,All You Need Is Love 2018 Re-release,3529607,0,3529607,2018.csv,2018,0.0,1.0
5475,Cornelis,3529380,0,3529380,2010.csv,2010,0.0,1.0
5476,Lapland Odyssey 3,3528478,0,3528478,2017.csv,2017,0.0,1.0
5477,Flea-picking Samurai,3524012,0,3524012,2018.csv,2018,0.0,1.0
5478,Things from Another World,3522561,0,3522561,2010.csv,2010,0.0,1.0
5479,"Wer's glaubt, wird selig",3521253,0,3521253,2012.csv,2012,0.0,1.0
5480,Tomorrow Will Be Fine,3520000,0,3520000,2021.csv,2021,0.0,1.0
5481,Wrong Turn,3519827,1064097,2455730,2021.csv,2021,0.302315142193068,0.697684857806932
5482,"Sex, Drugs & Taxation",3519632,0,3519632,2013.csv,2013,0.0,1.0
5483,Radioactive,3519221,0,3519221,2020.csv,2020,0.0,1.0
5484,The Riot Club,3517925,7734,3510191,2014.csv,2014,0.0021984550551816767,0.9978015449448183
5485,All at Once,3514780,0,3514780,2014.csv,2014,0.0,1.0
5486,The Oscar Nominated Short Films 2018: Live Action,3511123,3508777,2346,2018.csv,2018,0.9993318377054863,0.0006681622945137496
5487,Chou Super Hero Taisen: Kamen Rider vs. Super Sentai,3511088,0,3511088,2017.csv,2017,0.0,1.0
5488,Dersimiz: Atatürk,3509670,0,3509670,2010.csv,2010,0.0,1.0
5489,Primates of the Caribbean,3507928,0,3507928,2012.csv,2012,0.0,1.0
5490,Le lion,3507711,0,3507711,2020.csv,2020,0.0,1.0
5491,Ladrones,3504414,3063505,440909,2015.csv,2015,0.8741846711033571,0.12581532889664293
5492,Little Spirou,3503943,0,3503943,2017.csv,2017,0.0,1.0
5493,The Closed Circuit,3502373,0,3502373,2013.csv,2013,0.0,1.0
5494,Thanks for Sharing,3499442,1065881,2433561,2013.csv,2013,0.3045859882804173,0.6954140117195827
5495,Faustina: Love and Mercy,3498887,2243180,1255707,2019.csv,2019,0.6411124451861406,0.35888755481385937
5496,Parallel World Love Story,3495997,0,3495997,2019.csv,2019,0.0,1.0
5497,Maiden,3495241,3168978,326263,2019.csv,2019,0.9066550775754805,0.09334492242451951
5498,Wild Target,3494154,108589,3385565,2010.csv,2010,0.031077336602794266,0.9689226633972058
5499,Lost in Love,3493631,0,3493631,2019.csv,2019,0.0,1.0
5500,Racetime,3493043,1875283,1617760,2018.csv,2018,0.5368622716639904,0.4631377283360096
5501,Sams im Glück,3491035,0,3491035,2012.csv,2012,0.0,1.0
5502,Doris,3490279,0,3490279,2018.csv,2018,0.0,1.0
5503,The Heineken Kidnapping,3487309,0,3487309,2011.csv,2011,0.0,1.0
5504,18 Presents,3486375,0,3486375,2020.csv,2020,0.0,1.0
5505,Veronica Mars,3485383,3322127,163256,2014.csv,2014,0.9531598105574051,0.04684018944259497
5506,The Aeronauts,3485251,0,3485251,2019.csv,2019,0.0,1.0
5507,3,3484446,59954,3424492,2010.csv,2010,0.01720617854316009,0.9827938214568399
5508,Jack and the Cuckoo-Clock Heart,3484370,0,3484370,2014.csv,2014,0.0,1.0
5509,Hutong Housekeeper,3483825,0,3483825,2019.csv,2019,0.0,1.0
5510,Chasing Dream,3483793,0,3483793,2019.csv,2019,0.0,1.0
5511,The Sun Does Not Move,3483187,0,3483187,2021.csv,2021,0.0,1.0
5512,Ricky Rapper and the Nighthawk,3482563,0,3482563,2016.csv,2016,0.0,1.0
5513,On Tour,3482340,0,3482340,2010.csv,2010,0.0,1.0
5514,Copa de Elite,3479709,0,3479709,2014.csv,2014,0.0,1.0
5515,Kara Bela,3479667,0,3479667,2015.csv,2015,0.0,1.0
5516,Time and the Wind,3477093,0,3477093,2013.csv,2013,0.0,1.0
5517,F*ck de liefde,3475128,0,3475128,2019.csv,2019,0.0,1.0
5518,Pretty Cure Miracle Leap the Movie,3474150,0,3474150,2020.csv,2020,0.0,1.0
5519,Miles Ahead,3473958,2610896,863062,2016.csv,2016,0.7515623389804943,0.2484376610195057
5520,The Metropolitan Opera HD Live: Puccini: Tosca,3473616,2023749,1449867,2018.csv,2018,0.5826058493512236,0.4173941506487764
5521,La lutte des classes,3473226,0,3473226,2019.csv,2019,0.0,1.0
5522,Thomas & Friends: Sodor's Legend of the Lost Treasure,3472917,0,3472917,2015.csv,2015,0.0,1.0
5523,Aberdeen,3472469,0,3472469,2014.csv,2014,0.0,1.0
5524,Hors la loi,3470487,96933,3373554,2010.csv,2010,0.027930662180840903,0.972069337819159
5525,Sober Driver,3470484,0,3470484,2019.csv,2019,0.0,1.0
5526,Enemy,3468224,1008726,2459498,2014.csv,2014,0.2908479959771918,0.7091520040228082
5527,Looking for Hortense,3465020,0,3465020,2012.csv,2012,0.0,1.0
5528,Simple Simon,3462611,0,3462611,2010.csv,2010,0.0,1.0
5529,Precure the Movie: Dream Stars!,3457773,0,3457773,2017.csv,2017,0.0,1.0
5530,Retribution,3456773,0,3456773,2015.csv,2015,0.0,1.0
5531,Til Death Do Us Part,3455267,3455267,0,2017.csv,2017,1.0,0.0
5532,Fitoor,3454709,528799,2925910,2016.csv,2016,0.1530661482631388,0.8469338517368612
5533,The Room 2019 Re-release,3453912,0,3453912,2019.csv,2019,0.0,1.0
5534,Young Bruce Lee,3447642,0,3447642,2010.csv,2010,0.0,1.0
5535,All or Nothing,3446238,0,3446238,2017.csv,2017,0.0,1.0
5536,Brothers of the Wind,3444978,0,3444978,2015.csv,2015,0.0,1.0
5537,Les têtes de l'emploi,3444421,0,3444421,2016.csv,2016,0.0,1.0
5538,Summer of 85,3444001,0,3444001,2020.csv,2020,0.0,1.0
5539,The Vulture,3443414,0,3443414,2013.csv,2013,0.0,1.0
5540,Beneath Hill 60,3440939,0,3440939,2010.csv,2010,0.0,1.0
5541,I Can Quit Whenever I Want: Masterclass,3440826,0,3440826,2017.csv,2017,0.0,1.0
5542,Suave patria,3440624,0,3440624,2012.csv,2012,0.0,1.0
5543,Shot Caller,3440362,0,3440362,2017.csv,2017,0.0,1.0
5544,Words and Pictures,3438874,2171257,1267617,2014.csv,2014,0.63138602926423,0.3686139707357699
5545,A Gentleman,3438746,410055,3028691,2017.csv,2017,0.11924550402966663,0.8807544959703334
5546,Baciato dalla fortuna,3437400,0,3437400,2011.csv,2011,0.0,1.0
5547,Min søsters børn og guldgraverne 2015 Re-release,3437372,0,3437372,2015.csv,2015,0.0,1.0
5548,The Rider,3434963,2419031,1015932,2018.csv,2018,0.7042378622418931,0.29576213775810684
5549,He Named Me Malala,3433606,2668936,764670,2015.csv,2015,0.7772982689335934,0.22270173106640656
5550,Boule & Bill 2,3433585,0,3433585,2017.csv,2017,0.0,1.0
5551,Ek Paheli Leela,3431880,0,3431880,2015.csv,2015,0.0,1.0
5552,Borg vs. McEnroe,3430165,231346,3198819,2017.csv,2017,0.06744456899303677,0.9325554310069633
5553,Time to Love,3430000,0,3430000,2015.csv,2015,0.0,1.0
5554,Oddsville Christmas,3429915,0,3429915,2016.csv,2016,0.0,1.0
5555,Red Istanbul,3429587,0,3429587,2017.csv,2017,0.0,1.0
5556,Disconnect,3428048,1436900,1991148,2013.csv,2013,0.41915982506662686,0.5808401749333731
5557,Belyy tigr,3427641,0,3427641,2012.csv,2012,0.0,1.0
5558,Mourning Grave,3426917,0,3426917,2014.csv,2014,0.0,1.0
5559,Miss Conspirator,3426771,0,3426771,2012.csv,2012,0.0,1.0
5560,Families,3424810,0,3424810,2015.csv,2015,0.0,1.0
5561,Special Forces,3424648,10759,3413889,2011.csv,2011,0.0031416367463167017,0.9968583632536833
5562,Back on Track,3421313,0,3421313,2013.csv,2013,0.0,1.0
5563,Next Time I'll Aim for the Heart,3418213,815,3417398,2014.csv,2014,0.00023842867603627977,0.9997615713239637
5564,Rabbit School: Guardians of the Golden Egg,3416299,0,3416299,2017.csv,2017,0.0,1.0
5565,O Pátio das Cantigas,3415695,0,3415695,2015.csv,2015,0.0,1.0
5566,Turf,3414432,0,3414432,2013.csv,2013,0.0,1.0
5567,Billy Elliot,3413368,0,3413368,2014.csv,2014,0.0,1.0
5568,Midnight Diner,3412771,18555,3394216,2019.csv,2019,0.005436930869372718,0.9945630691306273
5569,Keeper of Darkness,3411154,0,3411154,2015.csv,2015,0.0,1.0
5570,A Living Promise,3409317,0,3409317,2016.csv,2016,0.0,1.0
5571,Yellowbird,3407795,0,3407795,2014.csv,2014,0.0,1.0
5572,Anuvahood,3405485,0,3405485,2011.csv,2011,0.0,1.0
5573,True Legend,3405482,0,3405482,2010.csv,2010,0.0,1.0
5574,Only Decent People,3405305,0,3405305,2012.csv,2012,0.0,1.0
5575,I Wish Someone Were Waiting for Me Somewhere,3403477,0,3403477,2020.csv,2020,0.0,1.0
5576,Friends 25th: The One With The Anniversary,3403406,2884827,518579,2019.csv,2019,0.8476294041909781,0.1523705958090219
5577,A Rough Draft,3403050,0,3403050,2018.csv,2018,0.0,1.0
5578,Honey Boy,3400977,3012615,388362,2019.csv,2019,0.8858086955601288,0.11419130443987124
5579,Jazbaa,3400203,0,3400203,2015.csv,2015,0.0,1.0
5580,The Protector 2,3399790,2463,3397327,2013.csv,2013,0.000724456510549181,0.9992755434894508
5581,The Good Lie,3396345,2722209,674136,2014.csv,2014,0.8015113305627078,0.19848866943729215
5582,Rock the Kasbah,3394174,3020664,373510,2015.csv,2015,0.889955553250953,0.11004444674904704
5583,Wave of Crimes,3392849,0,3392849,2018.csv,2018,0.0,1.0
5584,"All's Well, Ends Well 2012",3392158,47919,3344239,2012.csv,2012,0.01412640566860388,0.9858735943313961
5585,Kiba: The Fangs of Fiction,3391799,0,3391799,2021.csv,2021,0.0,1.0
5586,Gauguin: Voyage to Tahiti,3389322,200140,3189182,2017.csv,2017,0.059050158114218716,0.9409498418857812
5587,The Villagers,3388675,0,3388675,2018.csv,2018,0.0,1.0
5588,Anything for Alice,3387582,1092,3386490,2014.csv,2014,0.00032235382051268427,0.9996776461794873
5589,Hanni & Nanni: Mehr als beste Freunde,3384245,0,3384245,2017.csv,2017,0.0,1.0
5590,Marie Krøyer,3382354,0,3382354,2012.csv,2012,0.0,1.0
5591,The Gifted Hands,3378553,0,3378553,2013.csv,2013,0.0,1.0
5592,Bruder vor Luder,3378311,0,3378311,2015.csv,2015,0.0,1.0
5593,Apartment 1303 3D,3377891,0,3377891,2012.csv,2012,0.0,1.0
5594,The Neon Demon,3377430,1333124,2044306,2016.csv,2016,0.39471550853755666,0.6052844914624433
5595,12 Golden Ducks,3375891,0,3375891,2015.csv,2015,0.0,1.0
5596,Angels Wear White,3375245,0,3375245,2017.csv,2017,0.0,1.0
5597,The King's Speech PG-13 Version,3375215,3344306,30909,2011.csv,2011,0.9908423611532895,0.009157638846710506
5598,Crazy Ugly Duckling,3375129,0,3375129,2016.csv,2016,0.0,1.0
5599,The Hole in the Ground,3373474,21072,3352402,2019.csv,2019,0.006246379844634937,0.9937536201553651
5600,May God Save Us,3369996,0,3369996,2016.csv,2016,0.0,1.0
5601,Patrick the Pug,3369468,6290,3363178,2018.csv,2018,0.0018667635365582935,0.9981332364634417
5602,"All's Well, Ends Well 2010",3369236,0,3369236,2010.csv,2010,0.0,1.0
5603,It's for Your Own Good,3366372,256,3366116,2020.csv,2020,7.604625989046962e-05,0.9999239537401096
5604,J'irai où tu iras,3366005,0,3366005,2019.csv,2019,0.0,1.0
5605,The Last Full Measure,3364426,2949212,415214,2020.csv,2020,0.8765869720421849,0.12341302795781509
5606,Once in a Lifetime,3364417,0,3364417,2014.csv,2014,0.0,1.0
5607,Líbás jako dábel,3359755,0,3359755,2012.csv,2012,0.0,1.0
5608,Two Tails,3359460,0,3359460,2018.csv,2018,0.0,1.0
5609,Mr. Stein Goes Online,3358085,0,3358085,2017.csv,2017,0.0,1.0
5610,Oshin,3357828,0,3357828,2013.csv,2013,0.0,1.0
5611,Echo in the Canyon,3355324,3355324,0,2019.csv,2019,1.0,0.0
5612,Black Dawn,3354099,0,3354099,2012.csv,2012,0.0,1.0
5613,Shuriken Sentai Ninninger vs. ToQger the Movie: Ninjas in Wonderland,3352389,0,3352389,2016.csv,2016,0.0,1.0
5614,Four Sisters and a Wedding,3351356,0,3351356,2013.csv,2013,0.0,1.0
5615,Reality,3350996,72577,3278419,2012.csv,2012,0.021658336804937995,0.978341663195062
5616,One Left,3350205,0,3350205,2015.csv,2015,0.0,1.0
5617,Heaven on Earth 2015 Re-release,3350041,0,3350041,2015.csv,2015,0.0,1.0
5618,Panipat,3349899,461863,2888036,2019.csv,2019,0.13787370902824234,0.8621262909717576
5619,Arakawa Under the Bridge,3348319,0,3348319,2012.csv,2012,0.0,1.0
5620,Mistress America,3340737,2500431,840306,2015.csv,2015,0.7484668802123603,0.25153311978763965
5621,Tracers,3340503,0,3340503,2015.csv,2015,0.0,1.0
5622,Machine Gun Preacher,3338690,538690,2800000,2011.csv,2011,0.16134771422324326,0.8386522857767568
5623,The Mauritanian,3336536,836536,2500000,2021.csv,2021,0.25071990831209373,0.7492800916879062
5624,Atlas Shrugged II: The Strike,3336053,3336053,0,2012.csv,2012,1.0,0.0
5625,On Chesil Beach,3335913,745971,2589942,2018.csv,2018,0.22361824184263798,0.776381758157362
5626,The Program,3335613,13074,3322539,2015.csv,2015,0.003919519440654536,0.9960804805593455
5627,By the Sea,3334927,538460,2796467,2015.csv,2015,0.16146080558884798,0.838539194411152
5628,"We Can't Change the World. But, We Wanna Build a School in Cambodia.",3334273,0,3334273,2011.csv,2011,0.0,1.0
5629,Homeland,3333063,0,3333063,2013.csv,2013,0.0,1.0
5630,Indiana Jones and the Raiders of the Lost Ark 2012 IMAX Release,3332854,3125613,207241,2012.csv,2012,0.9378187583374489,0.062181241662551075
5631,"Ja, ik wil!",3331487,0,3331487,2015.csv,2015,0.0,1.0
5632,Kuiba 2,3330000,0,3330000,2013.csv,2013,0.0,1.0
5633,Last Ounce of Courage,3329674,3329674,0,2012.csv,2012,1.0,0.0
5634,Masha e o Urso,3329214,0,3329214,2016.csv,2016,0.0,1.0
5635,Vanishing Time: A Boy Who Returned,3328517,57759,3270758,2016.csv,2016,0.017352773021739112,0.9826472269782609
5636,Dance Juvenile,3327855,0,3327855,2019.csv,2019,0.0,1.0
5637,La passione di Laura,3327665,0,3327665,2010.csv,2010,0.0,1.0
5638,Poslední aristokratka,3327133,0,3327133,2019.csv,2019,0.0,1.0
5639,The Death & Life of John F. Donovan,3326364,152713,3173651,2019.csv,2019,0.04590988839465555,0.9540901116053444
5640,Obvious Child,3325417,3123963,201454,2014.csv,2014,0.9394199283879285,0.06058007161207151
5641,André Rieu 2019 Maastricht Concert - Shall We Dance? Encore,3324837,0,3324837,2019.csv,2019,0.0,1.0
5642,Flying Swords of Dragon Gate,3323381,170276,3153105,2011.csv,2011,0.051235774652379606,0.9487642253476204
5643,Breath,3322479,37108,3285371,2018.csv,2018,0.01116876886204548,0.9888312311379546
5644,Porady na zdrady,3322224,0,3322224,2017.csv,2017,0.0,1.0
5645,Wildlife,3321367,1050616,2270751,2018.csv,2018,0.31632035845481693,0.683679641545183
5646,Perfect World,3320638,0,3320638,2018.csv,2018,0.0,1.0
5647,André Rieu's 2018 Maastricht Concert,3320395,0,3320395,2018.csv,2018,0.0,1.0
5648,La deuxième étoile,3320313,0,3320313,2017.csv,2017,0.0,1.0
5649,Before The Winter Chill 2013 Re-release,3319705,0,3319705,2013.csv,2013,0.0,1.0
5650,Socios por accidente,3318081,0,3318081,2014.csv,2014,0.0,1.0
5651,Over Drive,3317996,0,3317996,2017.csv,2017,0.0,1.0
5652,Mayday Nowhere 3D,3314407,0,3314407,2013.csv,2013,0.0,1.0
5653,Let Me Introduce You to Sofia,3313429,0,3313429,2018.csv,2018,0.0,1.0
5654,Chhichhore,3311391,2004400,1306991,2019.csv,2019,0.6053045381835005,0.39469546181649945
5655,Life Eternal,3308744,0,3308744,2015.csv,2015,0.0,1.0
5656,2020 Oscar Nominated Short Films,3306611,3306611,0,2020.csv,2020,1.0,0.0
5657,Unit 7,3305084,0,3305084,2012.csv,2012,0.0,1.0
5658,Unexpected Love,3300000,0,3300000,2014.csv,2014,0.0,1.0
5659,Lotus Code,3300000,0,3300000,2015.csv,2015,0.0,1.0
5660,Thomas & Friends: Big World! Big Adventures! The Movie,3299661,0,3299661,2018.csv,2018,0.0,1.0
5661,The Other Family,3297256,0,3297256,2011.csv,2011,0.0,1.0
5662,Heist,3294317,50136,3244181,2015.csv,2015,0.015218936125454836,0.9847810638745451
5663,Yellow Flowers on the Green Grass,3293667,0,3293667,2015.csv,2015,0.0,1.0
5664,Thomas & Friends: The Great Race 2017 Re-release,3291829,0,3291829,2017.csv,2017,0.0,1.0
5665,Ava,3291445,497747,2793698,2020.csv,2020,0.1512244622042902,0.8487755377957098
5666,Exit Marrakech,3291151,0,3291151,2013.csv,2013,0.0,1.0
5667,Åsa-Nisse - Wälkom to Knohult,3288861,0,3288861,2011.csv,2011,0.0,1.0
5668,Off Course to China,3288447,0,3288447,2019.csv,2019,0.0,1.0
5669,My Amnesia Girl,3288330,0,3288330,2010.csv,2010,0.0,1.0
5670,Dust,3288150,0,3288150,2017.csv,2017,0.0,1.0
5671,Wonderstruck,3285916,1060377,2225539,2017.csv,2017,0.32270362358623894,0.6772963764137611
5672,Godzilla: Planet of the Monsters,3285291,0,3285291,2017.csv,2017,0.0,1.0
5673,Good Time,3283369,2026499,1256870,2017.csv,2017,0.6172011126376596,0.3827988873623403
5674,De Marathon,3281734,0,3281734,2012.csv,2012,0.0,1.0
5675,Saint Amour,3280041,0,3280041,2016.csv,2016,0.0,1.0
5676,Lino,3279783,0,3279783,2017.csv,2017,0.0,1.0
5677,Tamara Vol. 2,3277932,0,3277932,2018.csv,2018,0.0,1.0
5678,Bharath Ane Nenu,3276257,2663090,613167,2018.csv,2018,0.8128452682436085,0.18715473175639152
5679,Marianne & Leonard: Words of Love,3273573,1012034,2261539,2019.csv,2019,0.30915272089548634,0.6908472791045136
5680,The Famous Five and the Valley of Dinosaurs,3273025,0,3273025,2018.csv,2018,0.0,1.0
5681,Far Too Personal,3272428,0,3272428,2020.csv,2020,0.0,1.0
5682,Voice of Silence,3271053,0,3271053,2020.csv,2020,0.0,1.0
5683,Natale da chef,3268233,0,3268233,2017.csv,2017,0.0,1.0
5684,The Extraordinary Journey of the Fakir,3267486,0,3267486,2018.csv,2018,0.0,1.0
5685,Chicken with Plums,3265941,253874,3012067,2011.csv,2011,0.077733798620367,0.922266201379633
5686,Amundsen,3264993,0,3264993,2019.csv,2019,0.0,1.0
5687,Easy!,3264563,0,3264563,2011.csv,2011,0.0,1.0
5688,Mannenharten 2,3262993,0,3262993,2015.csv,2015,0.0,1.0
5689,Perfect Wedding,3258985,0,3258985,2010.csv,2010,0.0,1.0
5690,Serce nie sluga,3255942,0,3255942,2018.csv,2018,0.0,1.0
5691,The Soul-Mate,3255485,0,3255485,2018.csv,2018,0.0,1.0
5692,The Breakup Playlist,3255057,0,3255057,2015.csv,2015,0.0,1.0
5693,Bilal: A New Breed of Hero,3254027,0,3254027,2016.csv,2016,0.0,1.0
5694,Barefoot,3253522,0,3253522,2017.csv,2017,0.0,1.0
5695,Palme,3252741,0,3252741,2012.csv,2012,0.0,1.0
5696,Drop Dead Gorgeous,3251968,0,3251968,2015.csv,2015,0.0,1.0
5697,"Robin des Bois, la véritable histoire",3251375,0,3251375,2015.csv,2015,0.0,1.0
5698,Po prostu przyjazn,3250422,0,3250422,2017.csv,2017,0.0,1.0
5699,Monster Strike The Movie: Sora no Kanata,3249907,0,3249907,2018.csv,2018,0.0,1.0
5700,Last Floor,3248689,0,3248689,2014.csv,2014,0.0,1.0
5701,The Crew,3246104,0,3246104,2016.csv,2016,0.0,1.0
5702,Your Sister's Sister,3242802,1636190,1606612,2012.csv,2012,0.5045605621311446,0.4954394378688554
5703,High School Debut,3242697,0,3242697,2011.csv,2011,0.0,1.0
5704,In Harmony,3242445,3144,3239301,2015.csv,2015,0.0009696386523133006,0.9990303613476867
5705,The Front Runner,3242235,2000105,1242130,2018.csv,2018,0.616890817599588,0.3831091824004121
5706,On the Way,3240000,0,3240000,2014.csv,2014,0.0,1.0
5707,Identity Card,3239812,0,3239812,2010.csv,2010,0.0,1.0
5708,Exorcismus,3239065,0,3239065,2010.csv,2010,0.0,1.0
5709,The Adventures of Wei Bao Bao,3233185,0,3233185,2016.csv,2016,0.0,1.0
5710,Champ,3232193,0,3232193,2011.csv,2011,0.0,1.0
5711,Crazy Crying Lady,3232090,0,3232090,2012.csv,2012,0.0,1.0
5712,Ready to Mingle,3231457,0,3231457,2019.csv,2019,0.0,1.0
5713,The End Is My Beginning,3230509,0,3230509,2010.csv,2010,0.0,1.0
5714,No Such Thing as Housewives,3229789,0,3229789,2017.csv,2017,0.0,1.0
5715,Enemies of the Law,3229152,0,3229152,2015.csv,2015,0.0,1.0
5716,Savyasachi,3225899,0,3225899,2018.csv,2018,0.0,1.0
5717,Sleeping with Other People,3224947,819431,2405516,2015.csv,2015,0.25409130754706977,0.7459086924529302
5718,André Rieu's 2016 Maastricht Concert,3224716,0,3224716,2016.csv,2016,0.0,1.0
5719,Yowamushi Pedal: The Movie,3224657,0,3224657,2015.csv,2015,0.0,1.0
5720,The Red Thread,3223573,0,3223573,2016.csv,2016,0.0,1.0
5721,Love is in the Air 2013 Re-release,3221554,8425,3213129,2013.csv,2013,0.0026151975102698885,0.9973848024897302
5722,Gallipoli: End of the Road,3221143,0,3221143,2013.csv,2013,0.0,1.0
5723,Conviction,3220230,0,3220230,2019.csv,2019,0.0,1.0
5724,Kicking Off,3218397,0,3218397,2013.csv,2013,0.0,1.0
5725,Embrace of the Serpent,3217176,1329249,1887927,2015.csv,2015,0.41317260852374876,0.5868273914762512
5726,The Mystery of Happiness,3216374,8528,3207846,2014.csv,2014,0.0026514329490289375,0.9973485670509711
5727,Another Woman's Life,3216359,0,3216359,2012.csv,2012,0.0,1.0
5728,Arab Blues,3212579,0,3212579,2020.csv,2020,0.0,1.0
5729,Fan Gun Khae Wan Diaw,3209020,0,3209020,2016.csv,2016,0.0,1.0
5730,6 Souls,3205167,0,3205167,2010.csv,2010,0.0,1.0
5731,Kimmy Dora and the Temple of Kiyeme,3204780,0,3204780,2012.csv,2012,0.0,1.0
5732,Black Thursday,3204531,0,3204531,2011.csv,2011,0.0,1.0
5733,Qualquer Gato Vira-Lata 2,3204018,0,3204018,2015.csv,2015,0.0,1.0
5734,You Choose!,3202694,0,3202694,2017.csv,2017,0.0,1.0
5735,Saint Laurent,3202241,429477,2772764,2014.csv,2014,0.13411763824146902,0.865882361758531
5736,Qiaohu and the Fantastic Flying Ship,3202174,0,3202174,2019.csv,2019,0.0,1.0
5737,I,3200113,1449232,1750881,2015.csv,2015,0.4528690080631528,0.5471309919368472
5738,Dear Zindagi,3199581,2376479,823102,2016.csv,2016,0.7427469409275778,0.2572530590724223
5739,Nadide Hayat,3198186,0,3198186,2015.csv,2015,0.0,1.0
5740,Fill the Void,3197615,1775316,1422299,2012.csv,2012,0.5552000475354287,0.44479995246457127
5741,My Son,3197535,0,3197535,2017.csv,2017,0.0,1.0
5742,Samsam,3197240,53273,3143967,2020.csv,2020,0.016662183633383794,0.9833378163666162
5743,2001: A Space Odyssey 2010 Re-release,3194649,0,3194649,2010.csv,2010,0.0,1.0
5744,Victoria,3192275,0,3192275,2015.csv,2015,0.0,1.0
5745,Kiss & Tell,3191370,0,3191370,2018.csv,2018,0.0,1.0
5746,Empire of Lust,3191168,10654,3180514,2015.csv,2015,0.003338589507039429,0.9966614104929605
5747,She's the One,3189636,0,3189636,2013.csv,2013,0.0,1.0
5748,Voin,3187750,0,3187750,2015.csv,2015,0.0,1.0
5749,Three Brothers,3187345,0,3187345,2014.csv,2014,0.0,1.0
5750,Love Is Blind,3187255,0,3187255,2014.csv,2014,0.0,1.0
5751,Thoroughbreds,3187255,3072605,114650,2018.csv,2018,0.9640286076890616,0.03597139231093841
5752,Holy Camp!,3185945,0,3185945,2017.csv,2017,0.0,1.0
5753,Ricky Rapper and the Bicycle Thief,3185880,0,3185880,2010.csv,2010,0.0,1.0
5754,Showtime Championship Boxing: Floyd Mayweather vs. Conor McGregor,3184384,2620183,564201,2017.csv,2017,0.822822561600611,0.17717743839938901
5755,The Secret: Dare to Dream,3184114,0,3184114,2020.csv,2020,0.0,1.0
5756,Kidnapping Mr. Heineken,3184017,0,3184017,2015.csv,2015,0.0,1.0
5757,Miss You Like Crazy,3183529,0,3183529,2010.csv,2010,0.0,1.0
5758,Tea With the Dames,3181152,889343,2291809,2018.csv,2018,0.2795663332025631,0.7204336667974369
5759,Freche Mädchen 2,3181131,0,3181131,2010.csv,2010,0.0,1.0
5760,Pastorela,3179022,161194,3017828,2011.csv,2011,0.05070553144960935,0.9492944685503907
5761,Palm Beach,3178253,0,3178253,2019.csv,2019,0.0,1.0
5762,Everything About Her,3176352,0,3176352,2016.csv,2016,0.0,1.0
5763,"Love, Lies",3174887,0,3174887,2016.csv,2016,0.0,1.0
5764,Pilgrim's Progress,3173282,1294596,1878686,2019.csv,2019,0.4079675238443983,0.5920324761556017
5765,Sheep and Wolves: Pig Deal,3171916,0,3171916,2019.csv,2019,0.0,1.0
5766,Rosewater,3171593,3128941,42652,2014.csv,2014,0.9865518684143899,0.013448131585610134
5767,Lost in Panic Room,3171129,0,3171129,2010.csv,2010,0.0,1.0
5768,Land of Mine,3169553,435266,2734287,2015.csv,2015,0.1373272508773319,0.8626727491226681
5769,Countdown,3168201,0,3168201,2011.csv,2011,0.0,1.0
5770,The Most Beautiful Girl in the World,3168150,0,3168150,2018.csv,2018,0.0,1.0
5771,Summer of '92,3166999,0,3166999,2015.csv,2015,0.0,1.0
5772,Guadalupe Reyes,3163905,0,3163905,2019.csv,2019,0.0,1.0
5773,Magic Mirror 2,3161317,0,3161317,2018.csv,2018,0.0,1.0
5774,Mad Buddies,3156343,0,3156343,2012.csv,2012,0.0,1.0
5775,The Lodge,3155858,2138907,1016951,2020.csv,2020,0.6777576811123948,0.3222423188876052
5776,Last Stop: Kurtulus,3154795,0,3154795,2012.csv,2012,0.0,1.0
5777,Kak ya stal russkim,3154176,0,3154176,2019.csv,2019,0.0,1.0
5778,Road North,3153132,0,3153132,2012.csv,2012,0.0,1.0
5779,An Italian Name,3152087,0,3152087,2015.csv,2015,0.0,1.0
5780,Ingrid Goes West,3146831,3024308,122523,2017.csv,2017,0.9610646393149171,0.03893536068508287
5781,Partners in Crime,3146210,0,3146210,2012.csv,2012,0.0,1.0
5782,Boychoir,3146094,0,3146094,2015.csv,2015,0.0,1.0
5783,Celle que vous croyez,3144851,0,3144851,2019.csv,2019,0.0,1.0
5784,Petla,3144572,0,3144572,2020.csv,2020,0.0,1.0
5785,Heung-boo: The Revolutionist,3143995,0,3143995,2018.csv,2018,0.0,1.0
5786,Gekijouban Kamen tîchâ,3142052,0,3142052,2014.csv,2014,0.0,1.0
5787,Küçük Esnaf,3140566,0,3140566,2016.csv,2016,0.0,1.0
5788,Vsyo vklyucheno 2,3138768,0,3138768,2013.csv,2013,0.0,1.0
5789,Ricky Rapper and Cool Wendy,3137319,0,3137319,2012.csv,2012,0.0,1.0
5790,The Other Woman,3136670,0,3136670,2018.csv,2018,0.0,1.0
5791,Star Wars: Episode V - The Empire Strikes Back 2020 Re-release,3136150,2482000,654150,2020.csv,2020,0.7914162269024122,0.2085837730975878
5792,The Teacher's Diary,3131788,0,3131788,2014.csv,2014,0.0,1.0
5793,Canola,3131694,0,3131694,2016.csv,2016,0.0,1.0
5794,Mr. Know-It-All,3131350,0,3131350,2018.csv,2018,0.0,1.0
5795,Fuga da Reuma Park,3130495,0,3130495,2016.csv,2016,0.0,1.0
5796,LasseMajas detektivbyrå - Skuggor över Valleby 2014 Re-release,3130230,0,3130230,2014.csv,2014,0.0,1.0
5797,Le grand méchant loup,3129192,0,3129192,2013.csv,2013,0.0,1.0
5798,L'échange des princesses,3127238,0,3127238,2017.csv,2017,0.0,1.0
5799,Bez granits,3124744,0,3124744,2015.csv,2015,0.0,1.0
5800,Maybe This Time,3124420,0,3124420,2014.csv,2014,0.0,1.0
5801,Saving Leningrad,3124179,0,3124179,2019.csv,2019,0.0,1.0
5802,My Sister's Kids in Jutland,3123355,0,3123355,2010.csv,2010,0.0,1.0
5803,The Bad Education Movie,3121196,0,3121196,2015.csv,2015,0.0,1.0
5804,Romantic Debtors,3121099,0,3121099,2010.csv,2010,0.0,1.0
5805,Keeper of the Moon,3119059,0,3119059,2015.csv,2015,0.0,1.0
5806,The Deep Blue Sea,3115609,1126525,1989084,2011.csv,2011,0.3615745749867843,0.6384254250132158
5807,In a World...,3114953,2963902,151051,2013.csv,2013,0.9515077755587323,0.048492224441267655
5808,Hibiki: Shôsetsuka ni naru hôhô,3111540,0,3111540,2018.csv,2018,0.0,1.0
5809,Spy Cat,3109978,0,3109978,2019.csv,2019,0.0,1.0
5810,Echoes of the Rainbow,3106414,0,3106414,2010.csv,2010,0.0,1.0
5811,Saru Lock the Movie,3101844,0,3101844,2010.csv,2010,0.0,1.0
5812,Close Encounters of the Third Kind 2017 Re-release,3101507,3100479,1028,2017.csv,2017,0.9996685482251048,0.00033145177489523643
5813,Come Undone,3101465,10035,3091430,2010.csv,2010,0.003235567707518866,0.9967644322924811
5814,The Giant Pear,3099852,0,3099852,2018.csv,2018,0.0,1.0
5815,Girls und Panzer das Finale: Part I,3099118,0,3099118,2017.csv,2017,0.0,1.0
5816,King of Prism: Pride the Hero,3097917,0,3097917,2017.csv,2017,0.0,1.0
5817,These Daughters of Mine,3097650,0,3097650,2016.csv,2016,0.0,1.0
5818,Let Me Eat Your Pancreas,3097389,0,3097389,2017.csv,2017,0.0,1.0
5819,Looking for Teddy,3097253,0,3097253,2018.csv,2018,0.0,1.0
5820,Out of the Blue,3096999,0,3096999,2013.csv,2013,0.0,1.0
5821,Last Cop: The Movie,3096923,0,3096923,2017.csv,2017,0.0,1.0
5822,Raw,3096815,514870,2581945,2017.csv,2017,0.16625791337228735,0.8337420866277127
5823,All Our Desires,3093416,0,3093416,2011.csv,2011,0.0,1.0
5824,Premier de la classe,3092699,0,3092699,2019.csv,2019,0.0,1.0
5825,A Little Princess,3088328,0,3088328,2019.csv,2019,0.0,1.0
5826,The Prey,3087928,0,3087928,2011.csv,2011,0.0,1.0
5827,Happy New Year,3086192,0,3086192,2014.csv,2014,0.0,1.0
5828,Aquarius,3085977,285930,2800047,2016.csv,2016,0.09265461148932737,0.9073453885106726
5829,Take-Away Romance,3085722,0,3085722,2014.csv,2014,0.0,1.0
5830,(Sex) Appeal,3085233,0,3085233,2014.csv,2014,0.0,1.0
5831,Shed No Tears,3085180,0,3085180,2013.csv,2013,0.0,1.0
5832,The People Vs. Fritz Bauer,3083973,288483,2795490,2015.csv,2015,0.09354264774691608,0.9064573522530839
5833,Soreike! Anpanman: Ringo bouya to minna no negai,3083223,0,3083223,2014.csv,2014,0.0,1.0
5834,Dhobi Ghat,3082958,576639,2506319,2011.csv,2011,0.1870408224828233,0.8129591775171767
5835,Hatched,3080000,0,3080000,2013.csv,2013,0.0,1.0
5836,Little England,3078029,0,3078029,2013.csv,2013,0.0,1.0
5837,3 Hearts,3077754,161129,2916625,2014.csv,2014,0.052352787129835585,0.9476472128701644
5838,Hidalgo - La historia jamás contada.,3077143,0,3077143,2010.csv,2010,0.0,1.0
5839,Last Call for Nowhere,3076472,0,3076472,2016.csv,2016,0.0,1.0
5840,Ismael's Ghosts,3075562,102510,2973052,2017.csv,2017,0.03333049374390762,0.9666695062560924
5841,Living Is Easy with Eyes Closed,3075169,11600,3063569,2013.csv,2013,0.003772150408644208,0.9962278495913558
5842,Kick 2,3073989,0,3073989,2015.csv,2015,0.0,1.0
5843,Words on Bathroom Walls,3073857,2542518,531339,2020.csv,2020,0.8271425768993157,0.17285742310068425
5844,The End of the Tour,3072991,3002884,70107,2015.csv,2015,0.9771860705091554,0.022813929490844587
5845,Leto,3071877,0,3071877,2018.csv,2018,0.0,1.0
5846,Princess,3071782,0,3071782,2010.csv,2010,0.0,1.0
5847,The Beloved,3070000,0,3070000,2015.csv,2015,0.0,1.0
5848,The Wedding Unplanner,3069660,0,3069660,2020.csv,2020,0.0,1.0
5849,Das Tagebuch der Anne Frank,3068263,0,3068263,2016.csv,2016,0.0,1.0
5850,The Chase,3067956,0,3067956,2017.csv,2017,0.0,1.0
5851,Bad Seeds,3067893,0,3067893,2018.csv,2018,0.0,1.0
5852,Jane Got a Gun,3067531,1513793,1553738,2015.csv,2015,0.49348906335420895,0.506510936645791
5853,All my crazy love,3066959,0,3066959,2019.csv,2019,0.0,1.0
5854,Ever Been to the Moon?,3065820,0,3065820,2015.csv,2015,0.0,1.0
5855,Moby Dick,3062455,0,3062455,2011.csv,2011,0.0,1.0
5856,'71,3062178,1270847,1791331,2014.csv,2014,0.4150140847462166,0.5849859152537834
5857,Vai que Cola 2: O Começo,3061712,0,3061712,2019.csv,2019,0.0,1.0
5858,Magic Wonderland,3060000,0,3060000,2014.csv,2014,0.0,1.0
5859,The Japon,3059544,0,3059544,2019.csv,2019,0.0,1.0
5860,The Squad,3056677,0,3056677,2015.csv,2015,0.0,1.0
5861,Baby Blues,3056028,0,3056028,2013.csv,2013,0.0,1.0
5862,Andre Rieu's 2017 Maastricht Concert,3055674,0,3055674,2017.csv,2017,0.0,1.0
5863,Love is Everything,3055530,0,3055530,2018.csv,2018,0.0,1.0
5864,Remember,3054936,547009,2507927,2015.csv,2015,0.1790574336090838,0.8209425663909162
5865,Smoke & Mirrors,3054505,0,3054505,2016.csv,2016,0.0,1.0
5866,All Stars 2: Old Stars,3050365,0,3050365,2011.csv,2011,0.0,1.0
5867,Powstanie Warszawskie,3046182,0,3046182,2014.csv,2014,0.0,1.0
5868,The Photographer,3042381,0,3042381,2018.csv,2018,0.0,1.0
5869,Risto Räppääjä ja liukas Lennart,3039052,0,3039052,2014.csv,2014,0.0,1.0
5870,We Not Naughty,3035038,0,3035038,2012.csv,2012,0.0,1.0
5871,TT3D: Closer to the Edge,3034200,0,3034200,2011.csv,2011,0.0,1.0
5872,Laura's Star and the Dream Monster,3033432,0,3033432,2011.csv,2011,0.0,1.0
5873,Steal My Heart,3032434,0,3032434,2013.csv,2013,0.0,1.0
5874,Paris-Manhattan,3031682,0,3031682,2012.csv,2012,0.0,1.0
5875,Lift to Hell,3030000,0,3030000,2013.csv,2013,0.0,1.0
5876,Les Francis,3028854,0,3028854,2014.csv,2014,0.0,1.0
5877,Miss Puff,3026917,0,3026917,2018.csv,2018,0.0,1.0
5878,Tug of War!,3026813,0,3026813,2012.csv,2012,0.0,1.0
5879,Honeybee Hutch,3025283,0,3025283,2010.csv,2010,0.0,1.0
5880,Starred Up,3025189,54915,2970274,2014.csv,2014,0.018152584846764946,0.981847415153235
5881,Hunt Down,3024230,0,3024230,2019.csv,2019,0.0,1.0
5882,Dummie the Mummy and the Golden Scarabee,3023124,0,3023124,2014.csv,2014,0.0,1.0
5883,"Bloed, Zweet & Tranen",3022653,0,3022653,2015.csv,2015,0.0,1.0
5884,The Pasta Detectives 2,3022227,0,3022227,2015.csv,2015,0.0,1.0
5885,Un Natale al Sud,3020675,0,3020675,2016.csv,2016,0.0,1.0
5886,Ribbit,3020226,0,3020226,2014.csv,2014,0.0,1.0
5887,Potato Salad,3020134,0,3020134,2015.csv,2015,0.0,1.0
5888,Spy Time,3020097,0,3020097,2015.csv,2015,0.0,1.0
5889,The Greatest Miracle,3019382,555166,2464216,2011.csv,2011,0.18386742717549484,0.8161325728245051
5890,All Is True,3019143,1200481,1818662,2019.csv,2019,0.3976231003301268,0.6023768996698732
5891,Top Gun 2013 3D Release,3018873,3018873,0,2013.csv,2013,1.0,0.0
5892,Rigor Mortis,3016904,7865,3009039,2013.csv,2013,0.0026069772190298397,0.9973930227809702
5893,Oversize Love,3013782,0,3013782,2020.csv,2020,0.0,1.0
5894,Women VS Men,3010475,0,3010475,2015.csv,2015,0.0,1.0
5895,Rolling to You 2018 Re-release,3008361,0,3008361,2018.csv,2018,0.0,1.0
5896,Northmen - A Viking Saga,3005082,0,3005082,2014.csv,2014,0.0,1.0
5897,Zomboyashchik,3004952,0,3004952,2018.csv,2018,0.0,1.0
5898,Fighting Men of China,3004460,0,3004460,2018.csv,2018,0.0,1.0
5899,Remain Silent,3004005,0,3004005,2019.csv,2019,0.0,1.0
5900,The Second Mother,3003560,376986,2626574,2015.csv,2015,0.1255130578380322,0.8744869421619678
5901,The Enigma of Arrival,3002045,0,3002045,2020.csv,2020,0.0,1.0
5902,The Imposter,3001877,898317,2103560,2012.csv,2012,0.2992517681437314,0.7007482318562686
5903,Someone to Talk To,3000903,0,3000903,2016.csv,2016,0.0,1.0
5904,10000 Years Later,3000000,0,3000000,2015.csv,2015,0.0,1.0
5905,Heidi 2019 Re-release,2999491,0,2999491,2019.csv,2019,0.0,1.0
5906,Made for More,2999134,2999134,0,2018.csv,2018,1.0,0.0
5907,Valley of Knights,2997287,0,2997287,2015.csv,2015,0.0,1.0
5908,Askeladden - I Soria Moria slott,2996763,0,2996763,2019.csv,2019,0.0,1.0
5909,Les traducteurs,2996482,0,2996482,2020.csv,2020,0.0,1.0
5910,Appearances,2991236,0,2991236,2020.csv,2020,0.0,1.0
5911,El paseo 3,2991101,0,2991101,2013.csv,2013,0.0,1.0
5912,Odd Job,2987328,0,2987328,2016.csv,2016,0.0,1.0
5913,Çakallarla Dans 5,2987100,0,2987100,2018.csv,2018,0.0,1.0
5914,Twisted Justice,2985774,0,2985774,2016.csv,2016,0.0,1.0
5915,Loro 2,2985436,0,2985436,2018.csv,2018,0.0,1.0
5916,Real,2984948,0,2984948,2017.csv,2017,0.0,1.0
5917,Mio fratello rincorre i dinosauri,2983270,0,2983270,2019.csv,2019,0.0,1.0
5918,The Last Word,2982004,1783421,1198583,2017.csv,2017,0.5980612366717147,0.40193876332828526
5919,Memoir of War,2980982,103636,2877346,2018.csv,2018,0.034765724851743486,0.9652342751482565
5920,Mr. Majnu,2979992,0,2979992,2019.csv,2019,0.0,1.0
5921,Love Is Strange 2014 Re-release,2979739,2262223,717516,2014.csv,2014,0.759201728742014,0.24079827125798603
5922,Lulu femme nue,2978941,0,2978941,2014.csv,2014,0.0,1.0
5923,Sister Sister,2978284,0,2978284,2019.csv,2019,0.0,1.0
5924,I Can Quit Whenever I Want: Ad Honorem,2974521,0,2974521,2017.csv,2017,0.0,1.0
5925,My Cousin,2974059,0,2974059,2020.csv,2020,0.0,1.0
5926,Over Fingers,2972353,0,2972353,2019.csv,2019,0.0,1.0
5927,Mohamed Dubois,2970817,0,2970817,2013.csv,2013,0.0,1.0
5928,The Life of Budori Gusuko,2969820,0,2969820,2012.csv,2012,0.0,1.0
5929,Last Love,2967122,0,2967122,2013.csv,2013,0.0,1.0
5930,"Oh Brother, Oh Sister!",2966520,0,2966520,2014.csv,2014,0.0,1.0
5931,Romeo and Juliet,2966268,1162635,1803633,2013.csv,2013,0.39195210951943654,0.6080478904805634
5932,The Tunnel,2964640,0,2964640,2019.csv,2019,0.0,1.0
5933,Pas son genre,2963725,0,2963725,2014.csv,2014,0.0,1.0
5934,Tom Sawyer,2963639,0,2963639,2011.csv,2011,0.0,1.0
5935,In the Courtyard,2960409,0,2960409,2014.csv,2014,0.0,1.0
5936,How to Use Guys with Secret Tips,2956304,0,2956304,2013.csv,2013,0.0,1.0
5937,Mig äger ingen,2954287,0,2954287,2013.csv,2013,0.0,1.0
5938,Kardec,2953700,0,2953700,2019.csv,2019,0.0,1.0
5939,Ricky Rapper and the Miser from Seville,2953142,0,2953142,2015.csv,2015,0.0,1.0
5940,Long Long Time Ago,2951207,0,2951207,2016.csv,2016,0.0,1.0
5941,Man Up,2950880,0,2950880,2015.csv,2015,0.0,1.0
5942,"For Better, for Worse",2949767,0,2949767,2019.csv,2019,0.0,1.0
5943,The Last: Naruto the Movie,2949185,524451,2424734,2015.csv,2015,0.17782912906447035,0.8221708709355297
5944,Partly Sunny,2945187,0,2945187,2012.csv,2012,0.0,1.0
5945,The Horde,2943372,0,2943372,2012.csv,2012,0.0,1.0
5946,Sibyl,2943278,0,2943278,2019.csv,2019,0.0,1.0
5947,Dabangg,2942554,1288549,1654005,2010.csv,2010,0.4379015644232867,0.5620984355767132
5948,Freddy Frogface,2941889,0,2941889,2011.csv,2011,0.0,1.0
5949,Filly Brown,2940411,2850357,90054,2013.csv,2013,0.9693736691911436,0.030626330808856312
5950,Shippû rondo,2940357,0,2940357,2016.csv,2016,0.0,1.0
5951,On a Magical Night,2939209,0,2939209,2019.csv,2019,0.0,1.0
5952,The Empire of Shame,2937995,0,2937995,2014.csv,2014,0.0,1.0
5953,Our Women,2936982,0,2936982,2015.csv,2015,0.0,1.0
5954,Good Friends,2935188,0,2935188,2014.csv,2014,0.0,1.0
5955,American Heist,2931475,0,2931475,2015.csv,2015,0.0,1.0
5956,Joan Rivers: A Piece of Work,2930687,2930687,0,2010.csv,2010,1.0,0.0
5957,The Midnight Man,2930680,0,2930680,2017.csv,2017,0.0,1.0
5958,Three Quarter Moon,2929474,0,2929474,2011.csv,2011,0.0,1.0
5959,Barbara 2017 Re-release,2929455,0,2929455,2017.csv,2017,0.0,1.0
5960,The Informer,2927708,300460,2627248,2019.csv,2019,0.10262635481407299,0.897373645185927
5961,Le grand soir,2924568,0,2924568,2012.csv,2012,0.0,1.0
5962,Florida,2923145,0,2923145,2015.csv,2015,0.0,1.0
5963,A Kid,2922126,0,2922126,2016.csv,2016,0.0,1.0
5964,Behind Blue Skies,2921178,0,2921178,2010.csv,2010,0.0,1.0
5965,Como Novio de Pueblo,2918483,0,2918483,2019.csv,2019,0.0,1.0
5966,"Happy 8th of March, Men!",2918171,0,2918171,2014.csv,2014,0.0,1.0
5967,150 Milligrams,2918159,0,2918159,2016.csv,2016,0.0,1.0
5968,Mega Mindy en het zwarte kristal,2916442,0,2916442,2010.csv,2010,0.0,1.0
5969,My Avatar Horse,2915661,0,2915661,2012.csv,2012,0.0,1.0
5970,The Kids Are Back,2915643,0,2915643,2017.csv,2017,0.0,1.0
5971,Pay the Ghost,2914020,0,2914020,2015.csv,2015,0.0,1.0
5972,Brighton Rock,2913599,229653,2683946,2011.csv,2011,0.07882107318131287,0.9211789268186872
5973,The House That Jack Built,2911800,87993,2823807,2018.csv,2018,0.03021945188543169,0.9697805481145683
5974,Perdona si te llamo amor,2911031,0,2911031,2014.csv,2014,0.0,1.0
5975,Letters to God,2908893,2848578,60315,2010.csv,2010,0.9792653081429946,0.020734691857005397
5976,Love Is the Perfect Crime,2907305,0,2907305,2014.csv,2014,0.0,1.0
5977,God Loves Caviar,2906528,0,2906528,2012.csv,2012,0.0,1.0
5978,Men at Work: Miami,2906158,0,2906158,2020.csv,2020,0.0,1.0
5979,49 Days,2904527,0,2904527,2015.csv,2015,0.0,1.0
5980,De Club van Sinterklaas & Het Pratende Paard,2904410,0,2904410,2014.csv,2014,0.0,1.0
5981,Tina & Bettina: The Movie,2903844,0,2903844,2012.csv,2012,0.0,1.0
5982,Martin Eden,2902066,0,2902066,2019.csv,2019,0.0,1.0
5983,I'll Give It My All... Tomorrow,2900632,0,2900632,2013.csv,2013,0.0,1.0
5984,Brave Rabbit 2: Crazy Circus,2900000,0,2900000,2015.csv,2015,0.0,1.0
5985,Da guo chang jiang qu: Towards the river of glorious,2899674,0,2899674,2019.csv,2019,0.0,1.0
5986,Genis Aile: Yapistir,2896169,0,2896169,2015.csv,2015,0.0,1.0
5987,Caught in the Net,2894447,0,2894447,2020.csv,2020,0.0,1.0
5988,The East,2891812,2301839,589973,2013.csv,2013,0.7959850087073433,0.20401499129265666
5989,One-line,2890969,0,2890969,2017.csv,2017,0.0,1.0
5990,"Beijing, New York",2890000,0,2890000,2015.csv,2015,0.0,1.0
5991,Hero,2889720,0,2889720,2019.csv,2019,0.0,1.0
5992,Air Bound,2889160,0,2889160,2015.csv,2015,0.0,1.0
5993,Sien lui yau wan 2011 Re-release,2888786,0,2888786,2011.csv,2011,0.0,1.0
5994,Raven the Little Rascal - The Big Race,2886494,0,2886494,2015.csv,2015,0.0,1.0
5995,The Red Band Society - The Movie,2886400,0,2886400,2019.csv,2019,0.0,1.0
5996,We Are Family,2885324,0,2885324,2012.csv,2012,0.0,1.0
5997,Oh Mercy!,2885167,0,2885167,2019.csv,2019,0.0,1.0
5998,Advance Wave Upon Wave,2883905,0,2883905,2019.csv,2019,0.0,1.0
5999,Moshi Monsters,2883694,0,2883694,2013.csv,2013,0.0,1.0
6000,The Youngest Son,2882097,0,2882097,2010.csv,2010,0.0,1.0
6001,Super Bobrovs 2 (2016),2879785,0,2879785,2018.csv,2018,0.0,1.0
6002,Le Grand Chef 2: Kimchi Battle,2877959,0,2877959,2010.csv,2010,0.0,1.0
6003,The Oscar Nominated Short Films 2017: Live Action,2877797,2835355,42442,2017.csv,2017,0.9852519131822015,0.014748086817798475
6004,Scumbag,2876675,0,2876675,2020.csv,2020,0.0,1.0
6005,Rabbit Without Ears and Two-Eared Chick,2875527,0,2875527,2013.csv,2013,0.0,1.0
6006,A Secret Affair,2875137,0,2875137,2012.csv,2012,0.0,1.0
6007,No Breathing,2873570,0,2873570,2013.csv,2013,0.0,1.0
6008,Guilty,2873097,0,2873097,2011.csv,2011,0.0,1.0
6009,Horror Stories 2,2872739,0,2872739,2013.csv,2013,0.0,1.0
6010,Solomon's Perjury,2872612,0,2872612,2015.csv,2015,0.0,1.0
6011,Immenhof - Das Abenteuer eines Sommers,2871120,0,2871120,2019.csv,2019,0.0,1.0
6012,Flight 7500,2871035,0,2871035,2014.csv,2014,0.0,1.0
6013,Days of Being Wild 2018 Re-release,2870940,0,2870940,2018.csv,2018,0.0,1.0
6014,Life as It Should Be,2870736,0,2870736,2020.csv,2020,0.0,1.0
6015,The Invincible Dragon,2869666,0,2869666,2019.csv,2019,0.0,1.0
6016,Maria By Callas,2869237,1267301,1601936,2017.csv,2017,0.4416857164465675,0.5583142835534325
6017,Getúlio,2868827,0,2868827,2014.csv,2014,0.0,1.0
6018,1800 gramów,2867080,0,2867080,2019.csv,2019,0.0,1.0
6019,Starbuck,2865068,340058,2525010,2011.csv,2011,0.11869107469700545,0.8813089253029945
6020,Abschussfahrt,2864566,0,2864566,2015.csv,2015,0.0,1.0
6021,Branagh Theatre Live: The Winter's Tale,2862492,0,2862492,2016.csv,2016,0.0,1.0
6022,Home Run,2861020,2861020,0,2013.csv,2013,1.0,0.0
6023,NiNoKuni,2858846,0,2858846,2019.csv,2019,0.0,1.0
6024,Uno al año no hace daño 2,2855842,0,2855842,2015.csv,2015,0.0,1.0
6025,The Flowers of War,2855644,311434,2544210,2012.csv,2012,0.10905911241037047,0.8909408875896295
6026,Crow's Thumb,2853528,0,2853528,2012.csv,2012,0.0,1.0
6027,Inhumans,2852282,1521787,1330495,2017.csv,2017,0.5335331499480065,0.46646685005199345
6028,A Long Visit,2852034,0,2852034,2010.csv,2010,0.0,1.0
6029,The Salt of Life,2850852,317405,2533447,2011.csv,2011,0.1113368915678541,0.8886631084321459
6030,The Oscar Nominated Short Films 2016: Live Action,2850840,2816816,34024,2016.csv,2016,0.9880652719900099,0.011934728009990039
6031,Poly,2849513,0,2849513,2020.csv,2020,0.0,1.0
6032,Mr. Jones,2848478,0,2848478,2019.csv,2019,0.0,1.0
6033,God Bless the Broken Road,2848233,2846257,1976,2018.csv,2018,0.9993062365333173,0.0006937634666826766
6034,Remember You,2845124,14814,2830310,2016.csv,2016,0.005206802937235776,0.9947931970627643
6035,African Safari,2845077,0,2845077,2013.csv,2013,0.0,1.0
6036,Robot Sound,2843718,0,2843718,2016.csv,2016,0.0,1.0
6037,Kinky Boots the Musical,2843226,900451,1942775,2019.csv,2019,0.31670046630130705,0.683299533698693
6038,A Breath Away,2842040,77987,2764053,2018.csv,2018,0.027440500485566705,0.9725594995144333
6039,The Identical,2840991,2827666,13325,2014.csv,2014,0.9953097352297139,0.0046902647702861434
6040,Strobe Edge,2840684,0,2840684,2015.csv,2015,0.0,1.0
6041,Personal Shopper,2840408,1305195,1535213,2016.csv,2016,0.4595096901571887,0.5404903098428113
6042,Far til fire's vilde ferie,2839799,0,2839799,2015.csv,2015,0.0,1.0
6043,Husband & Wife,2839240,0,2839240,2017.csv,2017,0.0,1.0
6044,McDull: Rise of the Rice Cooker,2838514,0,2838514,2016.csv,2016,0.0,1.0
6045,City of Lies,2837181,565661,2271520,2019.csv,2019,0.19937430851256935,0.8006256914874307
6046,Fastlife,2835980,0,2835980,2014.csv,2014,0.0,1.0
6047,Zenek,2832175,0,2832175,2020.csv,2020,0.0,1.0
6048,The Fluffy Movie: Unity Through Laughter,2827393,2827393,0,2014.csv,2014,1.0,0.0
6049,A Coffee in Berlin,2826333,150275,2676058,2012.csv,2012,0.05316960174190373,0.9468303982580962
6050,Ouran High School Host Club,2821766,0,2821766,2012.csv,2012,0.0,1.0
6051,Everything Must Go,2820490,2711643,108847,2011.csv,2011,0.9614084786686001,0.03859152133139986
6052,The Irregular at Magic High School: The Girl Who Calls the Stars,2819492,0,2819492,2017.csv,2017,0.0,1.0
6053,"Go, Masao!",2817594,0,2817594,2012.csv,2012,0.0,1.0
6054,The Infidel,2817080,0,2817080,2010.csv,2010,0.0,1.0
6055,It's Complicated,2816433,0,2816433,2014.csv,2014,0.0,1.0
6056,Really?,2814977,0,2814977,2018.csv,2018,0.0,1.0
6057,Tumbleweed,2814941,0,2814941,2013.csv,2013,0.0,1.0
6058,Tatort: Tschiller: Off Duty,2814748,0,2814748,2016.csv,2016,0.0,1.0
6059,Walter,2811644,0,2811644,2019.csv,2019,0.0,1.0
6060,Far Til Fire Ved Vadehavet,2809868,0,2809868,2015.csv,2015,0.0,1.0
6061,Da Possessed,2807915,0,2807915,2014.csv,2014,0.0,1.0
6062,Let's Dance,2806934,0,2806934,2019.csv,2019,0.0,1.0
6063,Amigos...,2806622,0,2806622,2011.csv,2011,0.0,1.0
6064,The Shameless,2804063,0,2804063,2015.csv,2015,0.0,1.0
6065,Sono tornato,2803609,0,2803609,2018.csv,2018,0.0,1.0
6066,Super Crazy,2802383,0,2802383,2018.csv,2018,0.0,1.0
6067,Captive,2801508,2583301,218207,2015.csv,2015,0.9221108774274427,0.07788912257255735
6068,To the Wonder,2801166,587615,2213551,2013.csv,2013,0.20977514363661418,0.7902248563633858
6069,Pizza II: Villa,2800000,0,2800000,2013.csv,2013,0.0,1.0
6070,Unresolved Sexual Tension,2797434,0,2797434,2010.csv,2010,0.0,1.0
6071,Mr & Mme Adelman,2796077,0,2796077,2017.csv,2017,0.0,1.0
6072,"Cinco de Mayo, La Batalla",2794852,173472,2621380,2013.csv,2013,0.06206840290648664,0.9379315970935134
6073,Island of Lemurs: Madagascar 2016 Re-release,2794321,0,2794321,2016.csv,2016,0.0,1.0
6074,Tofu,2794217,0,2794217,2017.csv,2017,0.0,1.0
6075,Diego Maradona,2793443,0,2793443,2019.csv,2019,0.0,1.0
6076,Ninja Drones?,2791948,0,2791948,2019.csv,2019,0.0,1.0
6077,Karsten og Petra på vinterferie,2791208,0,2791208,2014.csv,2014,0.0,1.0
6078,After the Wedding,2790019,1574258,1215761,2019.csv,2019,0.564246336673693,0.4357536633263071
6079,Sky Stream,2789574,0,2789574,2018.csv,2018,0.0,1.0
6080,André Rieu's 2015 Maastricht Concert,2789480,0,2789480,2015.csv,2015,0.0,1.0
6081,Bangkok Sweety,2788735,0,2788735,2011.csv,2011,0.0,1.0
6082,Sarangi museoweo,2786587,0,2786587,2011.csv,2011,0.0,1.0
6083,Catch Me... I'm in Love,2785978,0,2785978,2011.csv,2011,0.0,1.0
6084,Kirk Cameron's Saving Christmas,2783970,2783970,0,2014.csv,2014,1.0,0.0
6085,Turning Mecards W: Resurrection of the Black Mirror,2780397,0,2780397,2017.csv,2017,0.0,1.0
6086,Bai Xue Gong Zhu Zhi Ai Ren Li Liang,2780000,0,2780000,2014.csv,2014,0.0,1.0
6087,Geuk-Jang-Pan Gong-Ryong-Me-Ka-Deu: Ta-I-Ni-So-Eo-Ui Seom,2779931,0,2779931,2019.csv,2019,0.0,1.0
6088,Hier kommt Lola,2779284,0,2779284,2010.csv,2010,0.0,1.0
6089,Agent Hamilton: But Not If It Concerns Your Daughter,2778028,0,2778028,2012.csv,2012,0.0,1.0
6090,Motorway,2776214,0,2776214,2012.csv,2012,0.0,1.0
6091,My Sassy Girl 2,2776022,0,2776022,2010.csv,2010,0.0,1.0
6092,Long Live Freedom,2772977,0,2772977,2013.csv,2013,0.0,1.0
6093,The Wonders,2772358,73378,2698980,2014.csv,2014,0.026467721701165577,0.9735322782988344
6094,Code 37,2770574,0,2770574,2011.csv,2011,0.0,1.0
6095,My Father's Bike,2770333,0,2770333,2012.csv,2012,0.0,1.0
6096,The Breaker Upperers,2767411,0,2767411,2018.csv,2018,0.0,1.0
6097,Little Tickles,2765772,0,2765772,2018.csv,2018,0.0,1.0
6098,Tinker Bell and the Lost Treasure 2012 Re-release,2765733,0,2765733,2012.csv,2012,0.0,1.0
6099,Jungle Child,2765120,0,2765120,2011.csv,2011,0.0,1.0
6100,The Blackout,2763702,0,2763702,2019.csv,2019,0.0,1.0
6101,On a marché sur Bangkok,2761073,0,2761073,2014.csv,2014,0.0,1.0
6102,As Mães de Chico Xavier,2759870,0,2759870,2011.csv,2011,0.0,1.0
6103,Sing My Life,2755954,0,2755954,2016.csv,2016,0.0,1.0
6104,Zip & Zap and the Captain's Island,2751812,0,2751812,2016.csv,2016,0.0,1.0
6105,Eye for an Eye,2750926,0,2750926,2019.csv,2019,0.0,1.0
6106,Happiness,2750684,0,2750684,2017.csv,2017,0.0,1.0
6107,Battle for Incheon: Operation Chromite,2749918,1023348,1726570,2016.csv,2016,0.37213764192241366,0.6278623580775863
6108,Pacemaker,2749626,0,2749626,2012.csv,2012,0.0,1.0
6109,Love Education,2749490,0,2749490,2017.csv,2017,0.0,1.0
6110,LasseMajas detektivbyrå - Skuggor över Valleby,2747991,0,2747991,2013.csv,2013,0.0,1.0
6111,The World Is Yours,2747894,0,2747894,2018.csv,2018,0.0,1.0
6112,March Comes in Like a Lion 2,2745799,0,2745799,2017.csv,2017,0.0,1.0
6113,Il était une forêt,2745549,0,2745549,2013.csv,2013,0.0,1.0
6114,The Sleeping Voice,2744208,0,2744208,2011.csv,2011,0.0,1.0
6115,Captain Sabertooth and the Magic Diamond,2742395,0,2742395,2019.csv,2019,0.0,1.0
6116,Just a Gigolo,2741409,0,2741409,2019.csv,2019,0.0,1.0
6117,Simran,2740865,0,2740865,2017.csv,2017,0.0,1.0
6118,Armor Hero Captor King,2740076,0,2740076,2016.csv,2016,0.0,1.0
6119,McQueen,2739246,1257275,1481971,2018.csv,2018,0.4589857939009494,0.5410142060990506
6120,Crumbs: All at Stake,2737554,0,2737554,2014.csv,2014,0.0,1.0
6121,Das geheime Leben der Bäume,2737511,0,2737511,2020.csv,2020,0.0,1.0
6122,The Midnight After,2734866,0,2734866,2014.csv,2014,0.0,1.0
6123,When Pigs Have Wings,2733806,0,2733806,2011.csv,2011,0.0,1.0
6124,My Big Gay Italian Wedding,2731730,0,2731730,2018.csv,2018,0.0,1.0
6125,Raja Rani,2731185,0,2731185,2013.csv,2013,0.0,1.0
6126,Edie,2731170,71790,2659380,2018.csv,2018,0.02628543810894232,0.9737145618910577
6127,Fortunata,2730233,0,2730233,2017.csv,2017,0.0,1.0
6128,Mees Kees langs de lijn,2730199,0,2730199,2016.csv,2016,0.0,1.0
6129,Silent Tokyo,2730104,0,2730104,2020.csv,2020,0.0,1.0
6130,Paris Follies,2729982,0,2729982,2014.csv,2014,0.0,1.0
6131,Lucky,2728446,955925,1772521,2017.csv,2017,0.35035511056476837,0.6496448894352316
6132,S.M.A.R.T. Chase,2727767,0,2727767,2017.csv,2017,0.0,1.0
6133,Behzat Ç.: Seni Kalbime Gömdüm,2727185,0,2727185,2011.csv,2011,0.0,1.0
6134,Operation Arctic,2726276,0,2726276,2014.csv,2014,0.0,1.0
6135,Cocktail,2724695,1227789,1496906,2012.csv,2012,0.4506152064726511,0.5493847935273489
6136,I Have to Buy New Shoes,2723904,0,2723904,2012.csv,2012,0.0,1.0
6137,Girls und Panzer das Finale: Part II,2721506,0,2721506,2019.csv,2019,0.0,1.0
6138,Unique Brothers,2720974,0,2720974,2014.csv,2014,0.0,1.0
6139,In the Name of Love,2719970,0,2719970,2011.csv,2011,0.0,1.0
6140,Chi-Raq,2719699,2653032,66667,2015.csv,2015,0.9754873609175133,0.0245126390824867
6141,Love the Way You Are,2719322,0,2719322,2019.csv,2019,0.0,1.0
6142,Hui dao guo qu yong bao ni,2718620,0,2718620,2019.csv,2019,0.0,1.0
6143,Every Blessed Day,2717393,0,2717393,2012.csv,2012,0.0,1.0
6144,The Crumbs 2014 Re-release,2717056,0,2717056,2014.csv,2014,0.0,1.0
6145,The Hidden Land: Back to No Man's Land in Northern Tibet,2716555,0,2716555,2018.csv,2018,0.0,1.0
6146,Un village presque parfait,2715460,0,2715460,2015.csv,2015,0.0,1.0
6147,Some Say No,2715050,0,2715050,2011.csv,2011,0.0,1.0
6148,Space Brothers,2714604,0,2714604,2014.csv,2014,0.0,1.0
6149,Billionaire Boys Club,2712606,0,2712606,2018.csv,2018,0.0,1.0
6150,Made in Italy,2712456,101339,2611117,2020.csv,2020,0.03736060603379373,0.9626393939662062
6151,"My Teacher, My Love",2711604,0,2711604,2018.csv,2018,0.0,1.0
6152,Ti stimo fratello,2711584,0,2711584,2012.csv,2012,0.0,1.0
6153,What Maisie Knew,2711379,1066471,1644908,2013.csv,2013,0.3933315851454186,0.6066684148545813
6154,009 Re: Cyborg,2711091,0,2711091,2012.csv,2012,0.0,1.0
6155,The Legend Is Born: Ip Man,2708867,0,2708867,2010.csv,2010,0.0,1.0
6156,"Ya, Ty, Vin, Vona",2708622,0,2708622,2018.csv,2018,0.0,1.0
6157,Meus 15 Anos,2707996,0,2707996,2017.csv,2017,0.0,1.0
6158,The Huntresses,2707851,0,2707851,2014.csv,2014,0.0,1.0
6159,Down a Dark Hall,2707199,0,2707199,2018.csv,2018,0.0,1.0
6160,Abel,2706679,0,2706679,2010.csv,2010,0.0,1.0
6161,Ikinci Sans,2705801,0,2705801,2016.csv,2016,0.0,1.0
6162,Dolfje Weerwolfje,2705676,0,2705676,2011.csv,2011,0.0,1.0
6163,Push and Shove,2704326,0,2704326,2019.csv,2019,0.0,1.0
6164,The Photographer of Mauthausen,2701645,0,2701645,2018.csv,2018,0.0,1.0
6165,Superclásico,2701266,0,2701266,2011.csv,2011,0.0,1.0
6166,The Guest,2700051,332890,2367161,2014.csv,2014,0.12329026377649904,0.876709736223501
6167,Under the Sicily Sun,2698994,0,2698994,2016.csv,2016,0.0,1.0
6168,De verbouwing,2698801,0,2698801,2012.csv,2012,0.0,1.0
6169,Pororo3: Cyber Space Adventure,2697830,0,2697830,2015.csv,2015,0.0,1.0
6170,Gangsterdam,2697522,954,2696568,2017.csv,2017,0.0003536579127065507,0.9996463420872934
6171,Pudsey the Dog: The Movie,2695490,0,2695490,2014.csv,2014,0.0,1.0
6172,Paper Birds,2693223,0,2693223,2010.csv,2010,0.0,1.0
6173,Jiro Dreams of Sushi,2692864,2552478,140386,2012.csv,2012,0.9478674006559559,0.05213259934404411
6174,Losers' Club,2692857,0,2692857,2011.csv,2011,0.0,1.0
6175,Carmina y amén.,2690532,0,2690532,2014.csv,2014,0.0,1.0
6176,A Hijacking,2688444,414437,2274007,2012.csv,2012,0.15415496845015184,0.8458450315498481
6177,Diary of an Ugly,2687398,0,2687398,2014.csv,2014,0.0,1.0
6178,Together Is Too Much,2685899,0,2685899,2010.csv,2010,0.0,1.0
6179,Apostle,2684779,0,2684779,2014.csv,2014,0.0,1.0
6180,One Third,2684720,0,2684720,2014.csv,2014,0.0,1.0
6181,Hope,2684147,0,2684147,2019.csv,2019,0.0,1.0
6182,Volta,2681008,0,2681008,2017.csv,2017,0.0,1.0
6183,My Big Night,2678216,0,2678216,2015.csv,2015,0.0,1.0
6184,The Journey Home,2677436,0,2677436,2014.csv,2014,0.0,1.0
6185,The Last Will Be the Last,2669776,0,2669776,2015.csv,2015,0.0,1.0
6186,Come as You Are,2665684,0,2665684,2011.csv,2011,0.0,1.0
6187,The Fifth Wheel,2664483,0,2664483,2013.csv,2013,0.0,1.0
6188,Miami Bici,2663916,0,2663916,2020.csv,2020,0.0,1.0
6189,The Memory Eraser,2662177,0,2662177,2020.csv,2020,0.0,1.0
6190,The Cup,2660645,0,2660645,2011.csv,2011,0.0,1.0
6191,I Kissed a Girl,2659946,0,2659946,2015.csv,2015,0.0,1.0
6192,Totally Innocents,2659775,0,2659775,2012.csv,2012,0.0,1.0
6193,A Little Thing Called Love,2659443,0,2659443,2010.csv,2010,0.0,1.0
6194,Conni & Co.,2657165,0,2657165,2016.csv,2016,0.0,1.0
6195,Pinocchio,2656550,0,2656550,2014.csv,2014,0.0,1.0
6196,Heart of a Lion,2654271,0,2654271,2013.csv,2013,0.0,1.0
6197,Secret Wars,2651650,0,2651650,2014.csv,2014,0.0,1.0
6198,People Get Eaten,2651302,0,2651302,2015.csv,2015,0.0,1.0
6199,Bad Hair,2650923,0,2650923,2014.csv,2014,0.0,1.0
6200,Hillsong: Let Hope Rise,2649761,2394386,255375,2016.csv,2016,0.9036233833919362,0.0963766166080639
6201,Svadba po obmenu,2649271,0,2649271,2011.csv,2011,0.0,1.0
6202,Twelve,2648195,183920,2464275,2010.csv,2010,0.06945107894244948,0.9305489210575505
6203,Pioneer,2647820,6871,2640949,2013.csv,2013,0.0025949649145334654,0.9974050350854665
6204,Petrang kabayo,2647739,0,2647739,2010.csv,2010,0.0,1.0
6205,Slaba plec?,2644199,0,2644199,2016.csv,2016,0.0,1.0
6206,Doi Mat Am Duong,2642944,0,2642944,2020.csv,2020,0.0,1.0
6207,Stories We Tell,2641053,1600145,1040908,2013.csv,2013,0.6058738692483642,0.39412613075163583
6208,The Weasel's Tale,2640752,0,2640752,2019.csv,2019,0.0,1.0
6209,The New Kid,2638984,0,2638984,2015.csv,2015,0.0,1.0
6210,Vic the Viking and the Magic Sword,2638760,0,2638760,2019.csv,2019,0.0,1.0
6211,A Good Husband,2637844,0,2637844,2010.csv,2010,0.0,1.0
6212,Zulu,2636607,0,2636607,2013.csv,2013,0.0,1.0
6213,A Boyfriend for My Wife,2636068,0,2636068,2016.csv,2016,0.0,1.0
6214,Kakegurui,2635709,0,2635709,2019.csv,2019,0.0,1.0
6215,The Titan,2635408,0,2635408,2018.csv,2018,0.0,1.0
6216,Mees Kees in de Wolken,2635299,0,2635299,2019.csv,2019,0.0,1.0
6217,Ded Moroz. Bitva Magov,2632583,0,2632583,2016.csv,2016,0.0,1.0
6218,Beautiful Accident,2632092,51766,2580326,2017.csv,2017,0.01966724567378344,0.9803327543262166
6219,Yu-Gi-Oh! Bonds Beyond Time,2631615,0,2631615,2010.csv,2010,0.0,1.0
6220,Maniac,2631275,31081,2600194,2012.csv,2012,0.011812144302666958,0.988187855697333
6221,11.6,2628870,0,2628870,2013.csv,2013,0.0,1.0
6222,The Passage,2628589,0,2628589,2019.csv,2019,0.0,1.0
6223,Pettersson und Findus - Findus zieht um,2627805,0,2627805,2018.csv,2018,0.0,1.0
6224,Almost Perfect,2626013,0,2626013,2012.csv,2012,0.0,1.0
6225,Slove,2625945,0,2625945,2011.csv,2011,0.0,1.0
6226,Bobby Jasoos,2625077,0,2625077,2014.csv,2014,0.0,1.0
6227,Third Person,2624761,1021398,1603363,2014.csv,2014,0.3891394302185989,0.610860569781401
6228,The Happy Prince,2621992,466440,2155552,2018.csv,2018,0.17789527961946489,0.8221047203805351
6229,The Butcher of Prague,2615533,0,2615533,2011.csv,2011,0.0,1.0
6230,Penny Pinchers,2613917,0,2613917,2011.csv,2011,0.0,1.0
6231,The Little Mermaid,2613377,147175,2466202,2018.csv,2018,0.05631602329093736,0.9436839767090627
6232,The Suck Up Project,2612093,0,2612093,2012.csv,2012,0.0,1.0
6233,Mais Forte que o Mundo: A História de José Aldo,2612004,0,2612004,2016.csv,2016,0.0,1.0
6234,Kamen Rider Zero-One: Real×Time,2611150,0,2611150,2020.csv,2020,0.0,1.0
6235,Happy End,2610794,301718,2309076,2017.csv,2017,0.11556560954253764,0.8844343904574624
6236,SuckSeed,2610717,0,2610717,2011.csv,2011,0.0,1.0
6237,LasseMajas detektivbyrå - Stella Nostra,2610090,0,2610090,2015.csv,2015,0.0,1.0
6238,Soreike! Anpanman: Brakkunôzu to mahou no uta,2608812,0,2608812,2010.csv,2010,0.0,1.0
6239,How to Make Out,2607444,0,2607444,2020.csv,2020,0.0,1.0
6240,Les ex,2604618,0,2604618,2017.csv,2017,0.0,1.0
6241,Poster Boys,2602256,97049,2505207,2017.csv,2017,0.03729417858965452,0.9627058214103454
6242,American Renegades,2602149,0,2602149,2017.csv,2017,0.0,1.0
6243,Mentada de Padre,2601804,0,2601804,2019.csv,2019,0.0,1.0
6244,"Salaud, on t'aime.",2601132,0,2601132,2014.csv,2014,0.0,1.0
6245,Among Wolves 2012 Re-release,2597659,0,2597659,2012.csv,2012,0.0,1.0
6246,N-Secure,2595644,2595644,0,2010.csv,2010,1.0,0.0
6247,The Signal,2595622,600896,1994726,2014.csv,2014,0.23150366270589476,0.7684963372941053
6248,Legend of Kung Fu Rabbit 2014 Re-release,2595445,0,2595445,2014.csv,2014,0.0,1.0
6249,Leo Da Vinci: Mission Mona Lisa,2594564,19978,2574586,2018.csv,2018,0.007699944961851009,0.992300055038149
6250,Nanga Parbat,2593419,0,2593419,2010.csv,2010,0.0,1.0
6251,Me and You,2593225,0,2593225,2012.csv,2012,0.0,1.0
6252,SDU: Sex Duties Unit,2592386,0,2592386,2013.csv,2013,0.0,1.0
6253,Small Country: An African Childhood,2590629,0,2590629,2020.csv,2020,0.0,1.0
6254,Gekijôban Shirobako,2588312,0,2588312,2020.csv,2020,0.0,1.0
6255,Medicinen,2587899,0,2587899,2014.csv,2014,0.0,1.0
6256,The Kiss of Evil,2587512,0,2587512,2011.csv,2011,0.0,1.0
6257,A Question of Faith,2587072,2587072,0,2017.csv,2017,1.0,0.0
6258,Peacekeeping Force,2585854,0,2585854,2018.csv,2018,0.0,1.0
6259,Blancanieves,2585522,279735,2305787,2012.csv,2012,0.10819285235244566,0.8918071476475543
6260,How to Train Your Dragon: The Hidden World 2020 Re-release,2585332,0,2585332,2020.csv,2020,0.0,1.0
6261,Assassination Nation,2584988,2005142,579846,2018.csv,2018,0.7756871598630245,0.2243128401369755
6262,Chasing Fifty,2584586,0,2584586,2015.csv,2015,0.0,1.0
6263,Girls und Panzer das Finale: Part III,2582956,0,2582956,2021.csv,2021,0.0,1.0
6264,Metallica & San Francisco Symphony - S&M2,2582847,1252385,1330462,2019.csv,2019,0.4848854771498273,0.5151145228501727
6265,Frog Kingdom,2580000,0,2580000,2013.csv,2013,0.0,1.0
6266,A Castle in Italy,2579459,0,2579459,2013.csv,2013,0.0,1.0
6267,Fallen,2578927,0,2578927,2016.csv,2016,0.0,1.0
6268,Land,2577830,2577830,0,2021.csv,2021,1.0,0.0
6269,Combustion,2577377,0,2577377,2013.csv,2013,0.0,1.0
6270,The Chef's Wife,2577351,0,2577351,2014.csv,2014,0.0,1.0
6271,Kung Fu League,2577213,0,2577213,2018.csv,2018,0.0,1.0
6272,Obywatel,2575872,0,2575872,2014.csv,2014,0.0,1.0
6273,Twin Murders: The Silence of the White City,2575843,0,2575843,2019.csv,2019,0.0,1.0
6274,Ordinary Person,2574748,0,2574748,2017.csv,2017,0.0,1.0
6275,Our Happy Holiday,2574579,0,2574579,2019.csv,2019,0.0,1.0
6276,Piazza Fontana: The Italian Conspiracy,2574171,0,2574171,2012.csv,2012,0.0,1.0
6277,The Gatekeepers,2573616,2415727,157889,2013.csv,2013,0.9386509098482446,0.06134909015175535
6278,My Dictator,2572088,0,2572088,2014.csv,2014,0.0,1.0
6279,The Red Collar,2571446,0,2571446,2018.csv,2018,0.0,1.0
6280,Schweinskopf al dente,2571219,0,2571219,2016.csv,2016,0.0,1.0
6281,Is Genesis History?,2570392,2570392,0,2017.csv,2017,1.0,0.0
6282,Waves,2570294,1658790,911504,2019.csv,2019,0.6453697514759013,0.3546302485240988
6283,Maquia: When the Promised Flower Blooms 2018 Re-release,2569927,18539,2551388,2018.csv,2018,0.007213823583315791,0.9927861764166842
6284,Blood Ties,2566435,42472,2523963,2013.csv,2013,0.016549026178336874,0.9834509738216631
6285,Surely Someday,2565396,0,2565396,2010.csv,2010,0.0,1.0
6286,SK1,2563070,0,2563070,2015.csv,2015,0.0,1.0
6287,Man of Will,2562653,0,2562653,2017.csv,2017,0.0,1.0
6288,Lyubov s aktsentom,2562614,0,2562614,2012.csv,2012,0.0,1.0
6289,So Undercover,2562285,0,2562285,2012.csv,2012,0.0,1.0
6290,Knutsen & Ludvigsen 2 - Det store dyret,2561134,0,2561134,2020.csv,2020,0.0,1.0
6291,Bayi Toplantisi,2560632,0,2560632,2020.csv,2020,0.0,1.0
6292,Minority Opinion,2560105,0,2560105,2015.csv,2015,0.0,1.0
6293,August. Eighth 2013 Re-release,2560000,0,2560000,2013.csv,2013,0.0,1.0
6294,God's Own Country,2559939,335609,2224330,2017.csv,2017,0.1311003895014686,0.8688996104985314
6295,Diaz: Don't Clean Up This Blood,2558925,0,2558925,2012.csv,2012,0.0,1.0
6296,Happy Birthday,2556857,0,2556857,2019.csv,2019,0.0,1.0
6297,Baby Blues,2555607,0,2555607,2013.csv,2013,0.0,1.0
6298,The Last Chance: Diary of Comedians,2553549,0,2553549,2013.csv,2013,0.0,1.0
6299,The Only Living Boy in New York,2550321,624332,1925989,2017.csv,2017,0.2448052617690087,0.7551947382309914
6300,"1,000 Times Good Night",2549568,53895,2495673,2013.csv,2013,0.021138875291814144,0.9788611247081859
6301,Dad in Training,2548238,0,2548238,2016.csv,2016,0.0,1.0
6302,Take That - Greatest Hits Live,2547964,0,2547964,2019.csv,2019,0.0,1.0
6303,Kong Curling,2547610,0,2547610,2011.csv,2011,0.0,1.0
6304,The King & I: From the London Palladium,2546661,0,2546661,2018.csv,2018,0.0,1.0
6305,Gatao,2546192,0,2546192,2015.csv,2015,0.0,1.0
6306,Disney's Newsies: The Broadway Musical!,2545060,2545060,0,2017.csv,2017,1.0,0.0
6307,The Voice,2545050,0,2545050,2010.csv,2010,0.0,1.0
6308,The Dinner,2544921,1323312,1221609,2017.csv,2017,0.5199815632783886,0.4800184367216114
6309,Blind Shaman,2543147,0,2543147,2019.csv,2019,0.0,1.0
6310,The Robot Giant,2543135,0,2543135,2012.csv,2012,0.0,1.0
6311,Likes and Dislikes,2542925,0,2542925,2014.csv,2014,0.0,1.0
6312,Reunion,2542557,0,2542557,2013.csv,2013,0.0,1.0
6313,Oh! My Gran,2541300,0,2541300,2020.csv,2020,0.0,1.0
6314,El Jeremías,2540144,650465,1889679,2016.csv,2016,0.25607406509237274,0.7439259349076273
6315,Here Comes the Bride,2538106,0,2538106,2010.csv,2010,0.0,1.0
6316,In the Name of My Daughter,2537899,277528,2260371,2014.csv,2014,0.10935344550748473,0.8906465544925153
6317,So What Is Love,2537725,0,2537725,2019.csv,2019,0.0,1.0
6318,El Coco,2537462,0,2537462,2016.csv,2016,0.0,1.0
6319,Couch Potatoes,2536918,0,2536918,2017.csv,2017,0.0,1.0
6320,Sifir Bir,2536753,0,2536753,2020.csv,2020,0.0,1.0
6321,The Girl with a Bracelet,2535002,0,2535002,2020.csv,2020,0.0,1.0
6322,Pazze di me,2534546,0,2534546,2013.csv,2013,0.0,1.0
6323,IN OUR HANDS: Battle for Jerusalem,2534370,2534370,0,2017.csv,2017,1.0,0.0
6324,Sapore di te,2534077,0,2534077,2014.csv,2014,0.0,1.0
6325,Poetry,2533089,356149,2176940,2010.csv,2010,0.14059869195278965,0.8594013080472104
6326,Roza of Smyrna,2532773,0,2532773,2016.csv,2016,0.0,1.0
6327,Spirits in the Forest,2531785,704744,1827041,2019.csv,2019,0.2783585494028916,0.7216414505971084
6328,Hamon: Yakuza Boogie,2530859,0,2530859,2017.csv,2017,0.0,1.0
6329,Bucky Larson: Born to Be a Star,2530394,2529395,999,2011.csv,2011,0.9996051998226363,0.00039480017736368326
6330,Please Get Married with My Wife,2528431,0,2528431,2016.csv,2016,0.0,1.0
6331,Chateau De La Reine,2527939,0,2527939,2015.csv,2015,0.0,1.0
6332,"Lusers, los amigos no se eligen",2527852,0,2527852,2015.csv,2015,0.0,1.0
6333,The Escape,2527317,0,2527317,2015.csv,2015,0.0,1.0
6334,O Vendedor de Sonhos,2526180,0,2526180,2016.csv,2016,0.0,1.0
6335,Chempiony: Bystree. Vyshe. Silnee,2520972,0,2520972,2016.csv,2016,0.0,1.0
6336,Ittefaq,2520487,298032,2222455,2017.csv,2017,0.11824381558008433,0.8817561844199157
6337,Restless,2518012,163265,2354747,2011.csv,2011,0.06483884906029042,0.9351611509397095
6338,Birds of Passage,2517405,507259,2010146,2018.csv,2018,0.2015007517662037,0.7984992482337963
6339,Into the Labyrinth,2516726,0,2516726,2019.csv,2019,0.0,1.0
6340,Kantai Collection: KanColle Movie,2516283,0,2516283,2016.csv,2016,0.0,1.0
6341,The Suicide Shop,2514478,0,2514478,2012.csv,2012,0.0,1.0
6342,Honey Bunny,2513124,0,2513124,2017.csv,2017,0.0,1.0
6343,Belle fille,2513010,0,2513010,2020.csv,2020,0.0,1.0
6344,Maide'nin Altin Günü,2512221,0,2512221,2017.csv,2017,0.0,1.0
6345,Is the Order a Rabbit?: Dear My Sister,2512001,0,2512001,2017.csv,2017,0.0,1.0
6346,Shoot Me in the Heart,2510949,0,2510949,2015.csv,2015,0.0,1.0
6347,LBJ,2510151,2470979,39172,2017.csv,2017,0.9843945643110713,0.015605435688928674
6348,The Rover,2510007,1114423,1395584,2014.csv,2014,0.44399198886696334,0.5560080111330367
6349,Ròm,2509318,0,2509318,2020.csv,2020,0.0,1.0
6350,The Swimmers,2509063,0,2509063,2014.csv,2014,0.0,1.0
6351,Twilight: Saya in Sasara,2508680,0,2508680,2014.csv,2014,0.0,1.0
6352,Grace Unplugged,2507201,2507201,0,2013.csv,2013,1.0,0.0
6353,Cool Kids Don't Cry,2505687,0,2505687,2012.csv,2012,0.0,1.0
6354,Er Conde Suelto In Hollywood,2505408,0,2505408,2014.csv,2014,0.0,1.0
6355,The Twins,2504008,0,2504008,2019.csv,2019,0.0,1.0
6356,Do Not Run the Thief,2503510,0,2503510,2016.csv,2016,0.0,1.0
6357,I'm in Love with a Church Girl,2503392,2387730,115662,2013.csv,2013,0.953797887026882,0.046202112973118076
6358,Sorrow and Joy,2500342,0,2500342,2013.csv,2013,0.0,1.0
6359,Fire with Fire,2500277,0,2500277,2013.csv,2013,0.0,1.0
6360,A Friendly Tale,2498547,0,2498547,2020.csv,2020,0.0,1.0
6361,Skylab,2496391,0,2496391,2011.csv,2011,0.0,1.0
6362,The Queen of Versailles,2495706,2401999,93707,2012.csv,2012,0.9624527087725878,0.037547291227412204
6363,Ogni maledetto Natale,2495677,0,2495677,2014.csv,2014,0.0,1.0
6364,Still Life,2495025,9481,2485544,2013.csv,2013,0.0037999619242292163,0.9962000380757707
6365,Latin Lover,2494636,0,2494636,2015.csv,2015,0.0,1.0
6366,The Tooth and the Nail,2492254,0,2492254,2017.csv,2017,0.0,1.0
6367,The Parade,2492128,0,2492128,2011.csv,2011,0.0,1.0
6368,Doktor Proktors tidsbadekar,2491993,0,2491993,2015.csv,2015,0.0,1.0
6369,Dirty Dancing 2016 Re-release,2490700,0,2490700,2016.csv,2016,0.0,1.0
6370,Musallat 2: Lanet,2487699,0,2487699,2011.csv,2011,0.0,1.0
6371,Going with the West,2483823,0,2483823,2012.csv,2012,0.0,1.0
6372,Bir Baba Hindu,2483680,0,2483680,2016.csv,2016,0.0,1.0
6373,"One Nation, One King",2481681,6576,2475105,2018.csv,2018,0.0026498167975658434,0.9973501832024342
6374,Naparnik,2480679,0,2480679,2017.csv,2017,0.0,1.0
6375,Lída Baarová,2480082,0,2480082,2016.csv,2016,0.0,1.0
6376,Se mi lasci non vale,2479399,0,2479399,2016.csv,2016,0.0,1.0
6377,Una festa esagerata,2477497,0,2477497,2018.csv,2018,0.0,1.0
6378,Cairo Time,2477315,1603616,873699,2010.csv,2010,0.6473201833436604,0.35267981665633963
6379,The Christmas Candle,2476775,2258620,218155,2013.csv,2013,0.9119197343319437,0.08808026566805624
6380,Queens of the Field,2476539,0,2476539,2020.csv,2020,0.0,1.0
6381,Schuks! Your Country Needs You,2474815,0,2474815,2013.csv,2013,0.0,1.0
6382,Magical Girl Lyrical Nanoha the Movie 1st,2473891,0,2473891,2010.csv,2010,0.0,1.0
6383,The Sweet Escape,2472665,0,2472665,2015.csv,2015,0.0,1.0
6384,Flipped 2017 Re-release,2470709,0,2470709,2017.csv,2017,0.0,1.0
6385,The Killer Who Never Kills,2469954,0,2469954,2011.csv,2011,0.0,1.0
6386,Still Human,2467971,0,2467971,2019.csv,2019,0.0,1.0
6387,"Love, Surreal and Odd",2467470,0,2467470,2017.csv,2017,0.0,1.0
6388,Stonehearst Asylum,2467351,0,2467351,2014.csv,2014,0.0,1.0
6389,Great Minds,2465973,0,2465973,2017.csv,2017,0.0,1.0
6390,The Boy with the Golden Pants,2465894,0,2465894,2014.csv,2014,0.0,1.0
6391,The Healing,2465876,0,2465876,2012.csv,2012,0.0,1.0
6392,High Heel,2465506,0,2465506,2014.csv,2014,0.0,1.0
6393,Fuchsia the Mini-Witch,2464092,0,2464092,2010.csv,2010,0.0,1.0
6394,Half Brothers,2461980,0,2461980,2015.csv,2015,0.0,1.0
6395,The Midwife,2460914,0,2460914,2015.csv,2015,0.0,1.0
6396,The Queens,2460000,0,2460000,2015.csv,2015,0.0,1.0
6397,Travel Mates,2459261,0,2459261,2017.csv,2017,0.0,1.0
6398,Mormor og de åtte ungene,2458910,0,2458910,2013.csv,2013,0.0,1.0
6399,The Bastard and the Beautiful World,2458785,0,2458785,2018.csv,2018,0.0,1.0
6400,Roxane,2458404,0,2458404,2019.csv,2019,0.0,1.0
6401,The Resistance Fighter,2458025,0,2458025,2019.csv,2019,0.0,1.0
6402,Gulaab Gang,2457372,0,2457372,2014.csv,2014,0.0,1.0
6403,The Silenced,2457364,0,2457364,2015.csv,2015,0.0,1.0
6404,Fabulous 30,2457135,0,2457135,2011.csv,2011,0.0,1.0
6405,Painted Skin: The Resurrection,2455359,50425,2404934,2012.csv,2012,0.020536711739505303,0.9794632882604947
6406,Bet on Revenge,2453468,0,2453468,2017.csv,2017,0.0,1.0
6407,Piku,2452343,1801807,650536,2015.csv,2015,0.7347287879387182,0.2652712120612818
6408,Purge,2451380,0,2451380,2012.csv,2012,0.0,1.0
6409,Footnote,2451259,2007758,443501,2011.csv,2011,0.819072158429607,0.18092784157039302
6410,De Club van Sinterklaas & De Pietenschool,2450350,0,2450350,2013.csv,2013,0.0,1.0
6411,The Tree,2450045,71158,2378887,2010.csv,2010,0.029043548179727312,0.9709564518202727
6412,Love at First Fight,2446362,25229,2421133,2014.csv,2014,0.010312864571964411,0.9896871354280355
6413,Some Kind of Beautiful,2446097,0,2446097,2015.csv,2015,0.0,1.0
6414,Kabir Singh,2445252,0,2445252,2019.csv,2019,0.0,1.0
6415,The Olsen Gang in Deep Trouble,2444372,0,2444372,2013.csv,2013,0.0,1.0
6416,Lean on Pete,2443584,1163056,1280528,2018.csv,2018,0.47596317540137767,0.5240368245986223
6417,Nightfall,2443464,0,2443464,2012.csv,2012,0.0,1.0
6418,Smeshannye chuvstva,2442803,0,2442803,2014.csv,2014,0.0,1.0
6419,Just Like Brothers,2441241,0,2441241,2012.csv,2012,0.0,1.0
6420,Bigil,2441136,0,2441136,2019.csv,2019,0.0,1.0
6421,The First King,2440478,0,2440478,2019.csv,2019,0.0,1.0
6422,Cold Prey III,2439448,0,2439448,2010.csv,2010,0.0,1.0
6423,Room No. 7,2436110,0,2436110,2017.csv,2017,0.0,1.0
6424,Pinocchio,2435973,0,2435973,2013.csv,2013,0.0,1.0
6425,Coriolanus,2435325,757195,1678130,2012.csv,2012,0.31092154024616836,0.6890784597538316
6426,Match,2434881,0,2434881,2012.csv,2012,0.0,1.0
6427,Encore heureux,2434473,0,2434473,2016.csv,2016,0.0,1.0
6428,Ti presento un amico,2433357,0,2433357,2010.csv,2010,0.0,1.0
6429,The Unknown Girl,2432640,150549,2282091,2016.csv,2016,0.061887085635359114,0.9381129143646408
6430,Escape from Pretoria,2431995,0,2431995,2020.csv,2020,0.0,1.0
6431,Joe,2431443,373375,2058068,2014.csv,2014,0.15356107463757118,0.8464389253624288
6432,The Grace Card,2430735,2430735,0,2011.csv,2011,1.0,0.0
6433,Strangers,2430165,0,2430165,2017.csv,2017,0.0,1.0
6434,The Sweet Sins of Sexy Susan,2429611,0,2429611,2013.csv,2013,0.0,1.0
6435,The List of My Desires,2428622,0,2428622,2014.csv,2014,0.0,1.0
6436,How to Get Rid of Cellulite,2428521,0,2428521,2011.csv,2011,0.0,1.0
6437,Daylight,2428270,0,2428270,2013.csv,2013,0.0,1.0
6438,The Breadwinner 2018 Re-release,2426907,834,2426073,2018.csv,2018,0.0003436472843829615,0.999656352715617
6439,Aakrosh,2424574,0,2424574,2010.csv,2010,0.0,1.0
6440,Rage,2424381,0,2424381,2014.csv,2014,0.0,1.0
6441,Life of Riley,2423379,11616,2411763,2014.csv,2014,0.004793307196274293,0.9952066928037258
6442,Vitamin,2422835,0,2422835,2014.csv,2014,0.0,1.0
6443,After.Life,2422634,108595,2314039,2010.csv,2010,0.044825177884897184,0.9551748221151029
6444,Lat Mat 2: Phim Truong,2421796,0,2421796,2015.csv,2015,0.0,1.0
6445,Freelance,2421562,0,2421562,2015.csv,2015,0.0,1.0
6446,Haunted Road,2420000,0,2420000,2014.csv,2014,0.0,1.0
6447,Hearts Beat Loud,2417165,2386251,30914,2018.csv,2018,0.9872106372548005,0.012789362745199439
6448,Change of Gangster,2415054,0,2415054,2019.csv,2019,0.0,1.0
6449,The Art of Self-Defense,2414269,2410914,3355,2019.csv,2019,0.9986103454089001,0.0013896545910998318
6450,Rodin,2413672,44261,2369411,2017.csv,2017,0.018337620024593233,0.9816623799754067
6451,Mega Mindy en de Snoepbaron,2413638,0,2413638,2011.csv,2011,0.0,1.0
6452,Tenderness,2413189,0,2413189,2017.csv,2017,0.0,1.0
6453,The Oscar Nominated Short Films 2015: Live Action,2412593,2412593,0,2015.csv,2015,1.0,0.0
6454,The Dinosaur Project,2412327,0,2412327,2012.csv,2012,0.0,1.0
6455,Italian Race,2412312,0,2412312,2016.csv,2016,0.0,1.0
6456,The Sleepless,2410654,0,2410654,2012.csv,2012,0.0,1.0
6457,Haunt,2408629,0,2408629,2014.csv,2014,0.0,1.0
6458,Beloved Sisters,2407680,54030,2353650,2014.csv,2014,0.022440689792663476,0.9775593102073366
6459,Homecoming,2406065,0,2406065,2011.csv,2011,0.0,1.0
6460,The Possession of Michael King,2405143,0,2405143,2014.csv,2014,0.0,1.0
6461,Otto the Rhino,2403520,0,2403520,2013.csv,2013,0.0,1.0
6462,Sound! Euphonium the Movie - Our Promise: A Brand New Day,2403030,90341,2312689,2019.csv,2019,0.037594620125424985,0.962405379874575
6463,The Stroller Strategy,2401291,3462,2397829,2013.csv,2013,0.0014417244723775669,0.9985582755276224
6464,After Lucia,2401169,0,2401169,2012.csv,2012,0.0,1.0
6465,Soreike! Anpanman: Buruburu no takarasagashi daibouken!,2400733,0,2400733,2017.csv,2017,0.0,1.0
6466,The Reunion,2397518,0,2397518,2013.csv,2013,0.0,1.0
6467,La vida precoz y breve de Sabina Rivas,2393988,0,2393988,2012.csv,2012,0.0,1.0
6468,Amiche da morire,2393573,0,2393573,2013.csv,2013,0.0,1.0
6469,The Man Who Killed Don Quixote,2390383,391963,1998420,2018.csv,2018,0.1639749780683681,0.8360250219316319
6470,The Dark Valley,2390284,0,2390284,2014.csv,2014,0.0,1.0
6471,Um Tio Quase Perfeito,2389525,0,2389525,2017.csv,2017,0.0,1.0
6472,Lommbock,2389356,0,2389356,2017.csv,2017,0.0,1.0
6473,Monty Python Live (Mostly),2388772,0,2388772,2014.csv,2014,0.0,1.0
6474,Ronal the Barbarian,2388045,0,2388045,2011.csv,2011,0.0,1.0
6475,We Are the Night,2385730,0,2385730,2010.csv,2010,0.0,1.0
6476,Twilight/New Moon,2385237,2385237,0,2010.csv,2010,1.0,0.0
6477,Spicy Hot in Love,2385191,0,2385191,2016.csv,2016,0.0,1.0
6478,Seuls,2385151,0,2385151,2017.csv,2017,0.0,1.0
6479,Finding Vivian Maier,2384584,1514782,869802,2014.csv,2014,0.6352395218620942,0.3647604781379058
6480,Back to the Future Part II 2010 Re-release,2382708,0,2382708,2010.csv,2010,0.0,1.0
6481,Kummeli V,2382008,0,2382008,2014.csv,2014,0.0,1.0
6482,Armed Hands,2381580,0,2381580,2012.csv,2012,0.0,1.0
6483,"Maruyama, the Middle Schooler",2379974,0,2379974,2013.csv,2013,0.0,1.0
6484,Next Gen,2379961,0,2379961,2019.csv,2019,0.0,1.0
6485,Mais qui a re-tué Pamela Rose?,2379355,0,2379355,2012.csv,2012,0.0,1.0
6486,Laggies,2379154,1066981,1312173,2014.csv,2014,0.44847075893363775,0.5515292410663623
6487,Naked Ambition 2,2375047,0,2375047,2014.csv,2014,0.0,1.0
6488,A Fairy-Tale Wedding,2374155,0,2374155,2014.csv,2014,0.0,1.0
6489,The Swallows of Kabul,2373010,0,2373010,2019.csv,2019,0.0,1.0
6490,Moy paren - angel,2372984,0,2372984,2012.csv,2012,0.0,1.0
6491,I Wish,2371548,145808,2225740,2011.csv,2011,0.06148220487209198,0.938517795127908
6492,Spud,2371544,0,2371544,2010.csv,2010,0.0,1.0
6493,A ti te quería encontrar,2371462,0,2371462,2018.csv,2018,0.0,1.0
6494,Irre sind männlich,2371307,0,2371307,2014.csv,2014,0.0,1.0
6495,The Branch,2369212,0,2369212,2018.csv,2018,0.0,1.0
6496,Sunday League - Pepik Hnatek's Final Match,2367323,0,2367323,2012.csv,2012,0.0,1.0
6497,South Wind,2365712,0,2365712,2018.csv,2018,0.0,1.0
6498,Lore,2362019,970325,1391694,2012.csv,2012,0.4108032153848043,0.5891967846151958
6499,The Way 2012 Re-release,2361169,0,2361169,2012.csv,2012,0.0,1.0
6500,Cake,2360281,1951776,408505,2015.csv,2015,0.8269252686438606,0.17307473135613938
6501,Soap Opera,2360231,0,2360231,2014.csv,2014,0.0,1.0
6502,Les gazelles,2359515,0,2359515,2014.csv,2014,0.0,1.0
6503,Non si ruba a casa dei ladri,2359147,0,2359147,2016.csv,2016,0.0,1.0
6504,Gantz: O,2359127,0,2359127,2016.csv,2016,0.0,1.0
6505,Daddy Cool: Join the Fun 2017 Re-release,2359016,0,2359016,2017.csv,2017,0.0,1.0
6506,Entelköy Efeköy'e Karsi,2358597,0,2358597,2011.csv,2011,0.0,1.0
6507,Gloria Mundi,2358012,0,2358012,2019.csv,2019,0.0,1.0
6508,Hadi Be Oglum,2356353,0,2356353,2018.csv,2018,0.0,1.0
6509,Black Tide,2355728,0,2355728,2018.csv,2018,0.0,1.0
6510,Arrivano i prof,2355619,0,2355619,2018.csv,2018,0.0,1.0
6511,Desi Boyz,2355293,1078826,1276467,2011.csv,2011,0.4580432243461854,0.5419567756538146
6512,To the Top,2354749,0,2354749,2017.csv,2017,0.0,1.0
6513,Sara,2354440,0,2354440,2015.csv,2015,0.0,1.0
6514,Lola & Her Brothers,2354010,0,2354010,2018.csv,2018,0.0,1.0
6515,Vai que dá certo 2,2353642,0,2353642,2016.csv,2016,0.0,1.0
6516,Midnight Diner 2,2352311,0,2352311,2017.csv,2017,0.0,1.0
6517,Why Your Crush Doesn't Have a Crush on You?,2352001,0,2352001,2013.csv,2013,0.0,1.0
6518,The Nightmare Before Christmas 2020 Re-release,2351189,2286000,65189,2020.csv,2020,0.9722740281619214,0.027725971838078522
6519,La tour 2 contrôle infernale,2351182,0,2351182,2016.csv,2016,0.0,1.0
6520,Extinction,2350695,0,2350695,2015.csv,2015,0.0,1.0
6521,Mysterious Island 2,2350000,0,2350000,2013.csv,2013,0.0,1.0
6522,Chico & Rita,2347919,350524,1997395,2010.csv,2010,0.14929135119226855,0.8507086488077314
6523,Çarsi Pazar,2346973,0,2346973,2015.csv,2015,0.0,1.0
6524,Bizans oyunlari: Geym of Bizans,2346620,0,2346620,2016.csv,2016,0.0,1.0
6525,Memories of the Sword,2345062,111071,2233991,2015.csv,2015,0.047363779720962604,0.9526362202790374
6526,Jerry Cotton,2343548,0,2343548,2010.csv,2010,0.0,1.0
6527,Heavily in Love!,2343492,0,2343492,2018.csv,2018,0.0,1.0
6528,Terraferma,2343302,19996,2323306,2011.csv,2011,0.008533257770445295,0.9914667422295547
6529,1991,2342264,2342264,0,2018.csv,2018,1.0,0.0
6530,The Fury of a Patient Man,2341847,0,2341847,2016.csv,2016,0.0,1.0
6531,Housefull,2340550,1183658,1156892,2010.csv,2010,0.5057178868214736,0.49428211317852644
6532,Ong-bak 3,2340516,14890,2325626,2010.csv,2010,0.00636184499486438,0.9936381550051356
6533,Untold Body,2340262,0,2340262,2019.csv,2019,0.0,1.0
6534,Allá en el Rancho,2339361,0,2339361,2019.csv,2019,0.0,1.0
6535,Rose,2339219,0,2339219,2012.csv,2012,0.0,1.0
6536,Death in Buenos Aires,2338860,0,2338860,2014.csv,2014,0.0,1.0
6537,High Ground,2338837,0,2338837,2021.csv,2021,0.0,1.0
6538,The Pearls of the Stone Man,2337561,0,2337561,2015.csv,2015,0.0,1.0
6539,Superjuffie,2337011,0,2337011,2018.csv,2018,0.0,1.0
6540,Aquí entre nos,2336212,0,2336212,2012.csv,2012,0.0,1.0
6541,Smolensk,2336032,0,2336032,2016.csv,2016,0.0,1.0
6542,"The Things We Say, the Things We Do",2335674,0,2335674,2020.csv,2020,0.0,1.0
6543,Couples,2335488,0,2335488,2011.csv,2011,0.0,1.0
6544,Meru,2334228,2334228,0,2015.csv,2015,1.0,0.0
6545,Jem and the Holograms,2333684,2184640,149044,2015.csv,2015,0.9361335982078122,0.0638664017921878
6546,Brother and Sister,2332534,0,2332534,2010.csv,2010,0.0,1.0
6547,Queen of Spades: The Dark Rite,2332251,0,2332251,2015.csv,2015,0.0,1.0
6548,Love Will Take Over,2331842,0,2331842,2018.csv,2018,0.0,1.0
6549,Heilstätten,2330777,0,2330777,2018.csv,2018,0.0,1.0
6550,Violetta,2330571,0,2330571,2013.csv,2013,0.0,1.0
6551,Un fidanzato per mia moglie,2330427,0,2330427,2014.csv,2014,0.0,1.0
6552,Under the Bed 2,2330000,0,2330000,2014.csv,2014,0.0,1.0
6553,Bowling Balls,2329855,0,2329855,2014.csv,2014,0.0,1.0
6554,A Single Rider,2328997,0,2328997,2017.csv,2017,0.0,1.0
6555,Cemetery Junction,2328877,0,2328877,2010.csv,2010,0.0,1.0
6556,Tiger Team: The Mountain of the 1000 Dragons,2327924,0,2327924,2010.csv,2010,0.0,1.0
6557,The Limehouse Golem,2327419,0,2327419,2017.csv,2017,0.0,1.0
6558,Fugly,2326942,0,2326942,2014.csv,2014,0.0,1.0
6559,The Silence,2325977,0,2325977,2019.csv,2019,0.0,1.0
6560,Bhaag Milkha Bhaag,2325917,1636731,689186,2013.csv,2013,0.7036927800949045,0.2963072199050955
6561,The Shamer's Daughter,2325150,0,2325150,2015.csv,2015,0.0,1.0
6562,Resident Evil: Damnation,2325035,0,2325035,2012.csv,2012,0.0,1.0
6563,"Zabawa, Zabawa",2323646,0,2323646,2019.csv,2019,0.0,1.0
6564,March of the Penguins 2: The Next Step,2323262,0,2323262,2017.csv,2017,0.0,1.0
6565,Wine Wars,2321975,0,2321975,2017.csv,2017,0.0,1.0
6566,Polish Roulette,2321694,0,2321694,2012.csv,2012,0.0,1.0
6567,Alibaba and the Thief,2320000,0,2320000,2015.csv,2015,0.0,1.0
6568,Switch,2319599,0,2319599,2011.csv,2011,0.0,1.0
6569,The Oranges,2316971,366377,1950594,2012.csv,2012,0.158127572593701,0.841872427406299
6570,Shaapit: The Cursed,2316497,0,2316497,2010.csv,2010,0.0,1.0
6571,Coursier,2314305,0,2314305,2010.csv,2010,0.0,1.0
6572,Don't Lose Heart,2313892,0,2313892,2013.csv,2013,0.0,1.0
6573,Austenland,2313509,2159041,154468,2013.csv,2013,0.9332321594599373,0.06676784054006274
6574,A Aa,2313043,2313043,0,2016.csv,2016,1.0,0.0
6575,Cold Feet,2311508,0,2311508,2019.csv,2019,0.0,1.0
6576,"Paws, Bones & Rock'n'roll",2310879,0,2310879,2015.csv,2015,0.0,1.0
6577,30+ (Single On Sale),2310687,0,2310687,2011.csv,2011,0.0,1.0
6578,WARx2,2310625,2310625,0,2015.csv,2015,1.0,0.0
6579,Karakomik Filmler Double Bill,2310561,0,2310561,2019.csv,2019,0.0,1.0
6580,"Pokaz kotku, co masz w srodku",2310135,0,2310135,2011.csv,2011,0.0,1.0
6581,Couple Therapy for Cheaters,2309020,0,2309020,2017.csv,2017,0.0,1.0
6582,Futro z misia,2308943,0,2308943,2019.csv,2019,0.0,1.0
6583,The Resurrection of Gavin Stone,2308355,2303792,4563,2017.csv,2017,0.9980232676516394,0.001976732348360629
6584,The Village of No Return,2307393,0,2307393,2017.csv,2017,0.0,1.0
6585,SMS - Sotto mentite spoglie 2014 Re-release,2306928,0,2306928,2014.csv,2014,0.0,1.0
6586,Beyond the Edge,2305829,0,2305829,2018.csv,2018,0.0,1.0
6587,"Blue, Painful and Brittle",2305766,0,2305766,2020.csv,2020,0.0,1.0
6588,Blackfish,2303417,2073582,229835,2013.csv,2013,0.900219977537719,0.09978002246228104
6589,Blood of Youth,2302688,0,2302688,2016.csv,2016,0.0,1.0
6590,Re: Zero kara Hajimeru Isekai Seikatsu: Hyouketsu no Kizuna,2300303,0,2300303,2019.csv,2019,0.0,1.0
6591,O Shaolin do Sertão,2300185,0,2300185,2016.csv,2016,0.0,1.0
6592,Ace in the Hole 2014 Re-release,2300000,0,2300000,2014.csv,2014,0.0,1.0
6593,Tiramisù,2299588,0,2299588,2016.csv,2016,0.0,1.0
6594,Hooked 2: Next Level,2298594,0,2298594,2010.csv,2010,0.0,1.0
6595,Piranhas,2298525,23494,2275031,2019.csv,2019,0.010221337596937167,0.9897786624030628
6596,Lucknow Central,2297750,0,2297750,2017.csv,2017,0.0,1.0
6597,Roohi,2297636,0,2297636,2021.csv,2021,0.0,1.0
6598,Divines,2297612,0,2297612,2016.csv,2016,0.0,1.0
6599,The Remaining,2297261,1169603,1127658,2014.csv,2014,0.509129350126085,0.49087064987391504
6600,3 from Hell,2295825,2172949,122876,2019.csv,2019,0.9464784990145155,0.05352150098548452
6601,Elis,2295553,0,2295553,2016.csv,2016,0.0,1.0
6602,Tour de Force,2294493,0,2294493,2014.csv,2014,0.0,1.0
6603,Ek Main Aur Ekk Tu,2293823,1155545,1138278,2012.csv,2012,0.5037638039203548,0.4962361960796452
6604,Rock on 2,2293659,98868,2194791,2016.csv,2016,0.043104925361616524,0.9568950746383835
6605,Oszukane,2292776,0,2292776,2013.csv,2013,0.0,1.0
6606,7 Pecados Rurais,2292724,0,2292724,2013.csv,2013,0.0,1.0
6607,Bends,2291573,0,2291573,2013.csv,2013,0.0,1.0
6608,Antboy II: Revenge of the Red Fury,2291188,0,2291188,2014.csv,2014,0.0,1.0
6609,Going Away,2290889,19501,2271388,2014.csv,2014,0.008512415922377732,0.9914875840776223
6610,American Honey,2290649,663246,1627403,2016.csv,2016,0.28954501540829697,0.7104549845917031
6611,Cinayet Süsü,2290543,0,2290543,2019.csv,2019,0.0,1.0
6612,Kunta,2290000,0,2290000,2013.csv,2013,0.0,1.0
6613,"God, You're Such a Prick",2288507,0,2288507,2020.csv,2020,0.0,1.0
6614,Mersal,2287182,0,2287182,2017.csv,2017,0.0,1.0
6615,The Last Family,2284311,0,2284311,2016.csv,2016,0.0,1.0
6616,Casper and Emma - Best Friends,2283582,0,2283582,2013.csv,2013,0.0,1.0
6617,My Best Holidays,2282178,0,2282178,2012.csv,2012,0.0,1.0
6618,E-San Love Story,2281699,0,2281699,2017.csv,2017,0.0,1.0
6619,Er Conde Jones 2012 Re-release,2281387,0,2281387,2012.csv,2012,0.0,1.0
6620,Because I Love You,2281031,0,2281031,2017.csv,2017,0.0,1.0
6621,Documentary of AKB48: No Flower Without Rain,2280815,0,2280815,2013.csv,2013,0.0,1.0
6622,The Ghost Must Be Crazy,2280532,0,2280532,2011.csv,2011,0.0,1.0
6623,My King My Father,2280212,0,2280212,2017.csv,2017,0.0,1.0
6624,Sarkar,2278361,0,2278361,2018.csv,2018,0.0,1.0
6625,Jill and Joy's Winter,2277838,0,2277838,2015.csv,2015,0.0,1.0
6626,407 Dark Flight 3D,2277221,0,2277221,2012.csv,2012,0.0,1.0
6627,Spindl,2275889,0,2275889,2017.csv,2017,0.0,1.0
6628,Home Alone,2273682,0,2273682,2016.csv,2016,0.0,1.0
6629,See You in Montevideo,2273204,0,2273204,2014.csv,2014,0.0,1.0
6630,Ghost Graduation,2273092,0,2273092,2012.csv,2012,0.0,1.0
6631,Please Open Your Window,2271771,0,2271771,2016.csv,2016,0.0,1.0
6632,The Storage,2270985,0,2270985,2011.csv,2011,0.0,1.0
6633,RV: Resurrected Victims,2269892,20374,2249518,2017.csv,2017,0.008975757436917704,0.9910242425630823
6634,"Tsatsiki, Dad and the Olive War",2269772,0,2269772,2015.csv,2015,0.0,1.0
6635,Are We OK?,2268939,0,2268939,2013.csv,2013,0.0,1.0
6636,Luce,2268204,2010613,257591,2019.csv,2019,0.8864339362773366,0.1135660637226634
6637,Status: Svoboden,2267640,0,2267640,2016.csv,2016,0.0,1.0
6638,Sleepwalk with Me,2266067,2266067,0,2012.csv,2012,1.0,0.0
6639,My Friend 'A',2264811,0,2264811,2018.csv,2018,0.0,1.0
6640,Coma,2264690,0,2264690,2020.csv,2020,0.0,1.0
6641,Más sabe el Diablo por Viejo,2263958,0,2263958,2018.csv,2018,0.0,1.0
6642,"Sergeant Keroro the Super Movie: Creation! Ultimate Keroro, Wonder Space-Time Island De Arimasu!!",2263266,0,2263266,2010.csv,2010,0.0,1.0
6643,Gibraltar,2262343,0,2262343,2013.csv,2013,0.0,1.0
6644,How to Catch the Firebird's Feather,2262115,0,2262115,2013.csv,2013,0.0,1.0
6645,Puzzle,2260946,2032018,228928,2018.csv,2018,0.8987468077521533,0.1012531922478467
6646,Bleach the Movie: Hell Verse,2260690,0,2260690,2010.csv,2010,0.0,1.0
6647,Ci vediamo domani,2259155,0,2259155,2013.csv,2013,0.0,1.0
6648,Minority Option,2255765,0,2255765,2015.csv,2015,0.0,1.0
6649,Something New,2255165,0,2255165,2016.csv,2016,0.0,1.0
6650,Gold 2017 Re-release,2254827,0,2254827,2017.csv,2017,0.0,1.0
6651,G.D.O. BlackCat,2253956,0,2253956,2013.csv,2013,0.0,1.0
6652,Shadow Dancer,2253819,100616,2153203,2012.csv,2012,0.04464244910527421,0.9553575508947258
6653,Bablo,2252547,0,2252547,2011.csv,2011,0.0,1.0
6654,Love of My Loves,2252509,0,2252509,2014.csv,2014,0.0,1.0
6655,Lucky Case!,2251834,0,2251834,2017.csv,2017,0.0,1.0
6656,An Interview with God,2251795,1201434,1050361,2018.csv,2018,0.5335450163092111,0.4664549836907889
6657,Life Is Not for Cowards,2250806,0,2250806,2013.csv,2013,0.0,1.0
6658,Wings,2250147,0,2250147,2012.csv,2012,0.0,1.0
6659,Marius,2249781,9781,2240000,2013.csv,2013,0.0043475342711135,0.9956524657288865
6660,The King of Staten Island,2249395,0,2249395,2020.csv,2020,0.0,1.0
6661,"Don't Cry for Me, Sudan",2248561,0,2248561,2010.csv,2010,0.0,1.0
6662,Now Is Good,2247064,0,2247064,2012.csv,2012,0.0,1.0
6663,My All-American,2246000,2246000,0,2015.csv,2015,1.0,0.0
6664,Two Buddies and a Badger,2245670,0,2245670,2015.csv,2015,0.0,1.0
6665,Kids Police,2244654,0,2244654,2013.csv,2013,0.0,1.0
6666,Truth or Die 2018 Re-release,2243470,0,2243470,2018.csv,2018,0.0,1.0
6667,Haunt,2243353,0,2243353,2019.csv,2019,0.0,1.0
6668,Barbie in Rock 'N Royals,2243176,0,2243176,2015.csv,2015,0.0,1.0
6669,Kishiryu Sentai Ryusoulger vs. Lupinranger vs. Patranger,2242513,0,2242513,2020.csv,2020,0.0,1.0
6670,No culpes al karma de lo que te pasa por gilipollas,2242471,5614,2236857,2016.csv,2016,0.0025034883394255713,0.9974965116605744
6671,Half Brothers,2241980,2241980,0,2020.csv,2020,1.0,0.0
6672,Relic,2241793,1047083,1194710,2020.csv,2020,0.4670739002218314,0.5329260997781686
6673,Son Mektup,2241575,0,2241575,2015.csv,2015,0.0,1.0
6674,Family of Strangers,2239530,0,2239530,2019.csv,2019,0.0,1.0
6675,Seven Something,2238732,0,2238732,2012.csv,2012,0.0,1.0
6676,Successful Woman,2238561,0,2238561,2018.csv,2018,0.0,1.0
6677,Bad Boy,2237552,0,2237552,2020.csv,2020,0.0,1.0
6678,Draquila - L'Italia che trema,2237507,0,2237507,2010.csv,2010,0.0,1.0
6679,Çilgin Dersane 3,2237347,0,2237347,2014.csv,2014,0.0,1.0
6680,La cena di Natale,2236363,0,2236363,2016.csv,2016,0.0,1.0
6681,At War,2235052,4605,2230447,2018.csv,2018,0.002060354747898483,0.9979396452521015
6682,Adiós,2232821,0,2232821,2019.csv,2019,0.0,1.0
6683,Punk Samurai Slash Down,2232159,0,2232159,2018.csv,2018,0.0,1.0
6684,Un monde plus grand,2231225,0,2231225,2019.csv,2019,0.0,1.0
6685,El cielo en tu mirada,2230843,0,2230843,2012.csv,2012,0.0,1.0
6686,"Onneli, Anneli ja salaperäinen muukalainen",2228701,0,2228701,2017.csv,2017,0.0,1.0
6687,Elena,2227905,233380,1994525,2011.csv,2011,0.10475312008366605,0.895246879916334
6688,Hand in Hand,2227676,0,2227676,2012.csv,2012,0.0,1.0
6689,Sinterklaas en het pakjesmysterie,2227113,0,2227113,2010.csv,2010,0.0,1.0
6690,Sea Level 2013 Re-release,2226446,0,2226446,2013.csv,2013,0.0,1.0
6691,Delhi Safari,2225597,0,2225597,2012.csv,2012,0.0,1.0
6692,Heal the Living,2223529,3176,2220353,2016.csv,2016,0.0014283600528709093,0.998571639947129
6693,Vedalam,2222913,0,2222913,2015.csv,2015,0.0,1.0
6694,Totally True Love,2221278,0,2221278,2011.csv,2011,0.0,1.0
6695,Pelle Politibil på sporet,2220689,0,2220689,2013.csv,2013,0.0,1.0
6696,Herstory,2218854,0,2218854,2018.csv,2018,0.0,1.0
6697,Cómplices,2217938,0,2217938,2018.csv,2018,0.0,1.0
6698,The High Note,2217874,0,2217874,2020.csv,2020,0.0,1.0
6699,Red Carpet,2217013,0,2217013,2014.csv,2014,0.0,1.0
6700,May Who?,2216783,0,2216783,2015.csv,2015,0.0,1.0
6701,The Lovers,2216083,2194521,21562,2017.csv,2017,0.9902702200233475,0.0097297799766525
6702,Roger Waters: The Wall,2214417,0,2214417,2015.csv,2015,0.0,1.0
6703,The Big Heart of Girls,2212893,0,2212893,2011.csv,2011,0.0,1.0
6704,Everyday I Love You,2212624,0,2212624,2015.csv,2015,0.0,1.0
6705,Just the Way You Are,2211899,0,2211899,2015.csv,2015,0.0,1.0
6706,Wolf is Coming,2211702,0,2211702,2015.csv,2015,0.0,1.0
6707,Oru Yamandan Premakadha,2210977,0,2210977,2019.csv,2019,0.0,1.0
6708,Bill Cunningham: New York,2210382,1510026,700356,2011.csv,2011,0.6831516000401741,0.31684839995982594
6709,Enchanted Mirror Romance,2210000,0,2210000,2015.csv,2015,0.0,1.0
6710,Te presento a Laura,2206942,0,2206942,2010.csv,2010,0.0,1.0
6711,Don't Go Breaking My Heart,2206089,0,2206089,2011.csv,2011,0.0,1.0
6712,Speed Walking,2204542,0,2204542,2014.csv,2014,0.0,1.0
6713,You to Me Are Everything,2203119,0,2203119,2010.csv,2010,0.0,1.0
6714,Rölli and the Golden Key,2202837,0,2202837,2013.csv,2013,0.0,1.0
6715,De Film van Dylan Haegens,2201702,0,2201702,2018.csv,2018,0.0,1.0
6716,Moomins on the Riviera,2200510,0,2200510,2014.csv,2014,0.0,1.0
6717,Love Guide for Dumpees,2199663,0,2199663,2015.csv,2015,0.0,1.0
6718,A Five Star Life,2198866,0,2198866,2013.csv,2013,0.0,1.0
6719,Chacun pour tous,2197748,0,2197748,2018.csv,2018,0.0,1.0
6720,The Insanity,2197630,0,2197630,2016.csv,2016,0.0,1.0
6721,The Unintentional Kidnapping of Mrs. Elfriede Ott,2196166,0,2196166,2010.csv,2010,0.0,1.0
6722,Elliot the Littlest Reindeer,2195706,24262,2171444,2018.csv,2018,0.0110497489190265,0.9889502510809735
6723,Goodnight Mommy,2193474,1178196,1015278,2015.csv,2015,0.5371369799687619,0.46286302003123814
6724,Montevideo: Taste of a Dream,2192931,0,2192931,2010.csv,2010,0.0,1.0
6725,Esrefpasalilar,2192706,0,2192706,2010.csv,2010,0.0,1.0
6726,Na izmene,2192575,0,2192575,2010.csv,2010,0.0,1.0
6727,My Giraffe,2191952,0,2191952,2017.csv,2017,0.0,1.0
6728,3 Faces,2191516,72324,2119192,2018.csv,2018,0.033001812443988546,0.9669981875560114
6729,What Will People Say,2191131,44156,2146975,2017.csv,2017,0.020152149734543486,0.9798478502654565
6730,Party Town,2190829,0,2190829,2016.csv,2016,0.0,1.0
6731,Queen of Spades: Through the Looking Glass,2190242,0,2190242,2019.csv,2019,0.0,1.0
6732,Chez Nous 2017 Re-release,2187885,0,2187885,2017.csv,2017,0.0,1.0
6733,Boomerang,2187885,0,2187885,2015.csv,2015,0.0,1.0
6734,Dovlatov,2187653,0,2187653,2018.csv,2018,0.0,1.0
6735,Kimi ga odoru natsu,2186542,0,2186542,2010.csv,2010,0.0,1.0
6736,Anchorman 2: The Legend Continues R-Rated Extended Cut,2185255,2184339,916,2014.csv,2014,0.9995808269515457,0.0004191730484542994
6737,Destination Wedding,2182965,0,2182965,2018.csv,2018,0.0,1.0
6738,Elf 2020 Re-release,2181963,2003568,178395,2020.csv,2020,0.9182410517501901,0.08175894824980992
6739,Cine Holliúdy,2180341,0,2180341,2013.csv,2013,0.0,1.0
6740,It Must Be Heaven,2179183,0,2179183,2019.csv,2019,0.0,1.0
6741,Border,2177678,771930,1405748,2018.csv,2018,0.35447389375288724,0.6455261062471127
6742,Teng Nong jiworn bin,2177424,0,2177424,2011.csv,2011,0.0,1.0
6743,The Island,2177406,0,2177406,2010.csv,2010,0.0,1.0
6744,Gone with the Wind 2019 Re-release,2176120,2176120,0,2019.csv,2019,1.0,0.0
6745,Veere Di Wedding,2176099,0,2176099,2018.csv,2018,0.0,1.0
6746,The Suffering,2175625,0,2175625,2017.csv,2017,0.0,1.0
6747,"Thi Mai, rumbo a Vietnam",2174896,0,2174896,2018.csv,2018,0.0,1.0
6748,Everyone's Life,2173040,0,2173040,2017.csv,2017,0.0,1.0
6749,The Oscar Nominated Short Films 2014: Live Action,2171849,2171849,0,2014.csv,2014,1.0,0.0
6750,Boca Juniors 3D: The Movie,2171383,0,2171383,2015.csv,2015,0.0,1.0
6751,Perfect Obedience,2170783,0,2170783,2014.csv,2014,0.0,1.0
6752,Henry's Crime,2169799,102541,2067258,2011.csv,2011,0.04725829443188056,0.9527417055681194
6753,Yakuza and the Family,2168905,0,2168905,2021.csv,2021,0.0,1.0
6754,"Babe, I Love You",2168605,0,2168605,2010.csv,2010,0.0,1.0
6755,Zhenshchiny protiv muzhchin: Krymskie kanikuly,2167427,0,2167427,2018.csv,2018,0.0,1.0
6756,The Reluctant Fundamentalist,2167020,552959,1614061,2013.csv,2013,0.25517023377726095,0.7448297662227391
6757,Bungo Stray Dogs: Dead Apple,2166349,0,2166349,2018.csv,2018,0.0,1.0
6758,Murmur of the Hearts,2166063,0,2166063,2015.csv,2015,0.0,1.0
6759,Fireman Sam: Set for Action!,2165271,0,2165271,2018.csv,2018,0.0,1.0
6760,The Benefactor,2159380,0,2159380,2015.csv,2015,0.0,1.0
6761,USS Indianapolis: Men of Courage,2158568,0,2158568,2016.csv,2016,0.0,1.0
6762,Sunny Side,2157683,0,2157683,2017.csv,2017,0.0,1.0
6763,Gaturro,2157668,0,2157668,2010.csv,2010,0.0,1.0
6764,Vezir Parmagi,2157645,0,2157645,2017.csv,2017,0.0,1.0
6765,About Love. For Adults Only,2157136,0,2157136,2017.csv,2017,0.0,1.0
6766,Help! I've Shrunk the Family,2156387,0,2156387,2014.csv,2014,0.0,1.0
6767,Horror Stories,2155362,0,2155362,2012.csv,2012,0.0,1.0
6768,The Mysterious Family,2155017,0,2155017,2017.csv,2017,0.0,1.0
6769,Couple from the Future,2149883,0,2149883,2021.csv,2021,0.0,1.0
6770,The Sexy Guys,2148689,0,2148689,2019.csv,2019,0.0,1.0
6771,The Saratov Approach,2146999,2146999,0,2013.csv,2013,1.0,0.0
6772,Dabbe 6: The Return,2146683,0,2146683,2015.csv,2015,0.0,1.0
6773,Day of the Siege,2143479,0,2143479,2012.csv,2012,0.0,1.0
6774,The Oscar Nominated Short Films 2013: Live Action,2142342,2142342,0,2013.csv,2013,1.0,0.0
6775,The Line,2142072,0,2142072,2017.csv,2017,0.0,1.0
6776,Stuck with a Perfect Woman,2141546,0,2141546,2016.csv,2016,0.0,1.0
6777,Mrs Mills,2141498,0,2141498,2018.csv,2018,0.0,1.0
6778,The Best Years of a Life,2140987,0,2140987,2019.csv,2019,0.0,1.0
6779,Brimstone,2140941,0,2140941,2017.csv,2017,0.0,1.0
6780,The Outpost,2140701,0,2140701,2020.csv,2020,0.0,1.0
6781,Let Yourself Go,2140190,12189,2128001,2017.csv,2017,0.0056952887360468,0.9943047112639533
6782,The Attack,2139516,1720325,419191,2013.csv,2013,0.80407204246194,0.19592795753806
6783,Freshly Squeezed,2139144,0,2139144,2012.csv,2012,0.0,1.0
6784,Master i Margarita,2139115,0,2139115,2011.csv,2011,0.0,1.0
6785,Train Brain Express,2137888,0,2137888,2012.csv,2012,0.0,1.0
6786,Mission of Honor,2137751,0,2137751,2018.csv,2018,0.0,1.0
6787,El Hubiera Sí Existe,2136481,0,2136481,2019.csv,2019,0.0,1.0
6788,A Quiet Life,2135121,0,2135121,2010.csv,2010,0.0,1.0
6789,Amanda,2133404,0,2133404,2018.csv,2018,0.0,1.0
6790,High Life,2133033,1225852,907181,2018.csv,2018,0.5746990318480774,0.42530096815192264
6791,On Body and Soul,2131259,0,2131259,2017.csv,2017,0.0,1.0
6792,Xingu,2131168,0,2131168,2012.csv,2012,0.0,1.0
6793,My Scientology Movie,2130866,22936,2107930,2016.csv,2016,0.010763698890498042,0.989236301109502
6794,Fahim,2130736,0,2130736,2019.csv,2019,0.0,1.0
6795,Mountain,2129889,365412,1764477,2017.csv,2017,0.17156387022985706,0.8284361297701429
6796,Setup,2128644,0,2128644,2011.csv,2011,0.0,1.0
6797,I Go Crazy,2128497,0,2128497,2017.csv,2017,0.0,1.0
6798,I.T.,2128301,0,2128301,2016.csv,2016,0.0,1.0
6799,Stand by Me,2127887,0,2127887,2018.csv,2018,0.0,1.0
6800,L'oncle Charles,2127484,0,2127484,2012.csv,2012,0.0,1.0
6801,Enter the Forbidden City,2127425,0,2127425,2019.csv,2019,0.0,1.0
6802,Porta dos Fundos: Contrato Vitalício,2127303,0,2127303,2016.csv,2016,0.0,1.0
6803,The Grad Job,2127299,0,2127299,2014.csv,2014,0.0,1.0
6804,Heleno,2126384,0,2126384,2012.csv,2012,0.0,1.0
6805,Space Panda 3,2124913,0,2124913,2016.csv,2016,0.0,1.0
6806,Matataki,2124848,0,2124848,2010.csv,2010,0.0,1.0
6807,Charlatan,2124762,0,2124762,2020.csv,2020,0.0,1.0
6808,Olsenbanden jr. Mestertyvens skatt,2124685,0,2124685,2010.csv,2010,0.0,1.0
6809,We Believed,2124145,0,2124145,2010.csv,2010,0.0,1.0
6810,Fanney Khan,2122952,0,2122952,2018.csv,2018,0.0,1.0
6811,Sightseers,2122909,61782,2061127,2012.csv,2012,0.029102519231865333,0.9708974807681346
6812,Jai Ho,2122804,1264515,858289,2014.csv,2014,0.595681466588531,0.404318533411469
6813,Little Black Dress,2121635,0,2121635,2011.csv,2011,0.0,1.0
6814,The Last Blossom,2120983,0,2120983,2011.csv,2011,0.0,1.0
6815,Midnight Hair,2120000,0,2120000,2014.csv,2014,0.0,1.0
6816,Facet (nie)potrzebny od zaraz,2118066,0,2118066,2014.csv,2014,0.0,1.0
6817,Faust,2117923,0,2117923,2011.csv,2011,0.0,1.0
6818,"Katmandú, un espejo en el cielo",2115291,0,2115291,2012.csv,2012,0.0,1.0
6819,Two Mothers,2114952,0,2114952,2013.csv,2013,0.0,1.0
6820,Abracadabra,2114260,13975,2100285,2017.csv,2017,0.006609877687701608,0.9933901223122984
6821,The Bears' Famous Invasion of Sicily,2113745,0,2113745,2019.csv,2019,0.0,1.0
6822,National Theatre Live: A Streetcar Named Desire,2111308,0,2111308,2014.csv,2014,0.0,1.0
6823,Happiest Season,2110618,0,2110618,2020.csv,2020,0.0,1.0
6824,Pyat nevest,2110493,0,2110493,2011.csv,2011,0.0,1.0
6825,Farm House,2110000,0,2110000,2014.csv,2014,0.0,1.0
6826,Adnan Semp-It,2108040,0,2108040,2010.csv,2010,0.0,1.0
6827,Loca Por El Trabajo,2105743,0,2105743,2018.csv,2018,0.0,1.0
6828,When Santa Fell to Earth,2105608,0,2105608,2011.csv,2011,0.0,1.0
6829,"20,000 Days on Earth",2105558,279558,1826000,2014.csv,2014,0.13277145535767715,0.8672285446423228
6830,Unlikely Revolutionaries,2104909,0,2104909,2010.csv,2010,0.0,1.0
6831,The Eye of the Storm,2104689,83566,2021123,2011.csv,2011,0.03970467845843258,0.9602953215415674
6832,Killing for the Prosecution 2019 Re-release,2103626,0,2103626,2019.csv,2019,0.0,1.0
6833,On Air,2103261,0,2103261,2012.csv,2012,0.0,1.0
6834,April 9th,2102722,0,2102722,2015.csv,2015,0.0,1.0
6835,Man and a Baby,2102178,0,2102178,2017.csv,2017,0.0,1.0
6836,Plan de table,2100761,0,2100761,2012.csv,2012,0.0,1.0
6837,Paris Holiday,2100109,0,2100109,2015.csv,2015,0.0,1.0
6838,Once Upon a Time in Anatolia,2099472,152408,1947064,2011.csv,2011,0.07259349017276724,0.9274065098272327
6839,Back To Youth,2099187,0,2099187,2019.csv,2019,0.0,1.0
6840,Gulu Mermaid,2098041,0,2098041,2015.csv,2015,0.0,1.0
6841,Ghosthunters: On Icy Trails,2097768,0,2097768,2015.csv,2015,0.0,1.0
6842,The Wizard of Oz 2019 Re-release,2097514,2076020,21494,2019.csv,2019,0.9897526309717122,0.010247369028287772
6843,Indian Horse,2097362,2097362,0,2018.csv,2018,1.0,0.0
6844,It All Began When I Met You,2097204,0,2097204,2013.csv,2013,0.0,1.0
6845,Daddy Cool,2096987,0,2096987,2017.csv,2017,0.0,1.0
6846,Mary Shelley,2096600,108900,1987700,2018.csv,2018,0.051941238195173135,0.9480587618048268
6847,Gekijouban Bad Boys J: Saigo ni mamorumono,2095543,0,2095543,2013.csv,2013,0.0,1.0
6848,Long Weekend,2094257,0,2094257,2013.csv,2013,0.0,1.0
6849,L'homme qui rit,2092903,0,2092903,2012.csv,2012,0.0,1.0
6850,100 Meters,2091517,0,2091517,2016.csv,2016,0.0,1.0
6851,Library War: Wings of Revolution,2091309,0,2091309,2012.csv,2012,0.0,1.0
6852,The Captive,2090612,1075178,1015434,2014.csv,2014,0.5142886389248699,0.48571136107513013
6853,The Olive Tree,2090232,0,2090232,2016.csv,2016,0.0,1.0
6854,Free! Road to the World - The Dream,2090149,0,2090149,2019.csv,2019,0.0,1.0
6855,Behzat Ç. Ankara Yaniyor,2089459,0,2089459,2013.csv,2013,0.0,1.0
6856,"The Butcher, the Chef, and the Swordsman",2089266,47896,2041370,2011.csv,2011,0.022924797512619263,0.9770752024873808
6857,30 Rojullo Preminchadam Ela?,2088571,0,2088571,2021.csv,2021,0.0,1.0
6858,Danger Close,2088085,0,2088085,2019.csv,2019,0.0,1.0
6859,Lost in Paris,2087225,691597,1395628,2017.csv,2017,0.33134760267819713,0.6686523973218029
6860,Benjamin the Elephant (2020),2086431,49,2086382,2019.csv,2019,2.3485080503500953e-05,0.9999765149194965
6861,Odnoklassniki.ru: naCLICKay udachu,2085738,0,2085738,2013.csv,2013,0.0,1.0
6862,Girl Most Likely,2085617,1378591,707026,2013.csv,2013,0.6609991192054917,0.3390008807945083
6863,Papicha,2085207,0,2085207,2019.csv,2019,0.0,1.0
6864,3 A.M. 3D,2084774,0,2084774,2012.csv,2012,0.0,1.0
6865,Equals,2084628,33258,2051370,2016.csv,2016,0.01595392559247981,0.9840460744075202
6866,High Strung,2084451,53447,2031004,2016.csv,2016,0.02564080422135133,0.9743591957786487
6867,Saranae Siblor,2084293,0,2084293,2010.csv,2010,0.0,1.0
6868,Another Child,2083565,0,2083565,2019.csv,2019,0.0,1.0
6869,I'm Not Ashamed,2082980,2082980,0,2016.csv,2016,1.0,0.0
6870,Don't Knock Twice,2081591,0,2081591,2017.csv,2017,0.0,1.0
6871,The Night Beyond the Tricornered Window,2081564,0,2081564,2021.csv,2021,0.0,1.0
6872,Dany,2080679,0,2080679,2018.csv,2018,0.0,1.0
6873,A Cat in Paris,2080634,309973,1770661,2010.csv,2010,0.1489800704977425,0.8510199295022575
6874,Harvie and the Magic Museum,2079037,0,2079037,2017.csv,2017,0.0,1.0
6875,Valami Amerika 3,2078058,0,2078058,2018.csv,2018,0.0,1.0
6876,Odeio o Dia dos Namorados,2077146,0,2077146,2013.csv,2013,0.0,1.0
6877,JoJo's Bizarre Adventure: Diamond Is Unbreakable - Chapter 1,2077113,0,2077113,2017.csv,2017,0.0,1.0
6878,Sag Salim 2: Sil Bastan,2076076,0,2076076,2014.csv,2014,0.0,1.0
6879,Superfast!,2075731,0,2075731,2015.csv,2015,0.0,1.0
6880,Thuppakki,2075056,0,2075056,2012.csv,2012,0.0,1.0
6881,Dangerous Liaisons,2074864,54000,2020864,2012.csv,2012,0.02602580217305809,0.973974197826942
6882,The Last Ride,2073210,0,2073210,2016.csv,2016,0.0,1.0
6883,Black '47,2073063,57520,2015543,2018.csv,2018,0.027746383009102954,0.9722536169908971
6884,Tutte lo vogliono,2073049,0,2073049,2015.csv,2015,0.0,1.0
6885,Yuli,2072661,0,2072661,2018.csv,2018,0.0,1.0
6886,Kukaracha 3D,2070537,0,2070537,2011.csv,2011,0.0,1.0
6887,Singam 2,2070341,0,2070341,2013.csv,2013,0.0,1.0
6888,Behind the Yellow Line,2069000,0,2069000,2016.csv,2016,0.0,1.0
6889,Taxi! Taxi!,2068116,0,2068116,2013.csv,2013,0.0,1.0
6890,A Fool,2067820,8212,2059608,2015.csv,2015,0.003971332127554622,0.9960286678724454
6891,Golmaal 3,2067671,1132192,935479,2010.csv,2010,0.5475687379665334,0.4524312620334666
6892,Pech to nie grzech,2064772,0,2064772,2018.csv,2018,0.0,1.0
6893,Man of the Gold Medal,2064078,0,2064078,2016.csv,2016,0.0,1.0
6894,Ordinary Happiness,2063694,0,2063694,2019.csv,2019,0.0,1.0
6895,American Pastoral,2063436,544098,1519338,2016.csv,2016,0.263685425668642,0.7363145743313579
6896,Farewell to the Night,2061454,0,2061454,2019.csv,2019,0.0,1.0
6897,Peter Capusotto y sus 3 dimensiones,2059596,0,2059596,2012.csv,2012,0.0,1.0
6898,Vlastníci,2058974,0,2058974,2019.csv,2019,0.0,1.0
6899,Perfumes,2058848,0,2058848,2020.csv,2020,0.0,1.0
6900,Blood Father 2018 Re-release,2057916,0,2057916,2018.csv,2018,0.0,1.0
6901,Golmaal Again,2057329,1013893,1043436,2017.csv,2017,0.4928200594071245,0.5071799405928755
6902,Under the Silver Lake,2053469,46083,2007386,2018.csv,2018,0.022441536736127986,0.977558463263872
6903,Ghost in the Shell: Stand Alone Complex - Solid State Society,2053304,0,2053304,2011.csv,2011,0.0,1.0
6904,A Reindeer's Journey,2053289,0,2053289,2019.csv,2019,0.0,1.0
6905,Mobile Suit Gundam: The Origin VI - Rise of the Red Comet,2053231,0,2053231,2018.csv,2018,0.0,1.0
6906,Iqbal Faroog,2051184,0,2051184,2015.csv,2015,0.0,1.0
6907,Julia's Disappearance,2050945,0,2050945,2010.csv,2010,0.0,1.0
6908,Mike Says Goodbye!,2050192,0,2050192,2012.csv,2012,0.0,1.0
6909,Okja,2049823,0,2049823,2017.csv,2017,0.0,1.0
6910,Misconduct,2049761,0,2049761,2016.csv,2016,0.0,1.0
6911,The Voices,2047501,0,2047501,2015.csv,2015,0.0,1.0
6912,The Lookout,2046528,0,2046528,2012.csv,2012,0.0,1.0
6913,Sürgün Inek 2014 Re-release,2045669,0,2045669,2014.csv,2014,0.0,1.0
6914,Tutto molto bello,2045527,0,2045527,2014.csv,2014,0.0,1.0
6915,Being 17,2045219,52713,1992506,2016.csv,2016,0.025773767992571944,0.9742262320074281
6916,Detective Conan: Strategy Above the Depths 2013 Re-release,2044865,0,2044865,2013.csv,2013,0.0,1.0
6917,42nd Street: The Musical,2044503,187440,1857063,2019.csv,2019,0.09167998286136043,0.9083200171386395
6918,Looking for Magical DoReMi,2044264,0,2044264,2020.csv,2020,0.0,1.0
6919,Winning Streak,2044056,0,2044056,2012.csv,2012,0.0,1.0
6920,"Gia Gan, My Nhan va Gang To",2043050,0,2043050,2015.csv,2015,0.0,1.0
6921,Io sono Tempesta,2042920,0,2042920,2018.csv,2018,0.0,1.0
6922,W.E.,2042203,583455,1458748,2012.csv,2012,0.2856988262185493,0.7143011737814507
6923,Checkered Ninja,2042046,0,2042046,2019.csv,2019,0.0,1.0
6924,Oldur Beni Sevgilim,2041847,0,2041847,2019.csv,2019,0.0,1.0
6925,What the Day Owes the Night,2041270,0,2041270,2012.csv,2012,0.0,1.0
6926,The Father,2041134,1401904,639230,2020.csv,2020,0.686826048657266,0.313173951342734
6927,12 Citizens,2040000,0,2040000,2015.csv,2015,0.0,1.0
6928,The Jade and the Pearl,2039827,0,2039827,2010.csv,2010,0.0,1.0
6929,At the End of the Tunnel,2039463,0,2039463,2016.csv,2016,0.0,1.0
6930,Blue,2038579,0,2038579,2017.csv,2017,0.0,1.0
6931,How to Grow Up Despite Your Parents,2038275,0,2038275,2016.csv,2016,0.0,1.0
6932,Mandira Filozofu Istanbul,2036837,0,2036837,2015.csv,2015,0.0,1.0
6933,Back Home,2036333,0,2036333,2018.csv,2018,0.0,1.0
6934,Tiktik: The Aswang Chronicles,2035311,0,2035311,2012.csv,2012,0.0,1.0
6935,The End,2035226,0,2035226,2012.csv,2012,0.0,1.0
6936,Mr. Hurt,2035200,0,2035200,2017.csv,2017,0.0,1.0
6937,Parents d'élèves,2033629,0,2033629,2020.csv,2020,0.0,1.0
6938,Devil's Knot,2033154,0,2033154,2014.csv,2014,0.0,1.0
6939,Chlap na strídacku,2032855,0,2032855,2020.csv,2020,0.0,1.0
6940,Raid,2031135,1010385,1020750,2018.csv,2018,0.49744847092881567,0.5025515290711844
6941,Operation Cicero,2030534,0,2030534,2019.csv,2019,0.0,1.0
6942,Balala the Fairies: The Magic Trial,2030000,0,2030000,2013.csv,2013,0.0,1.0
6943,Forever Love,2030000,0,2030000,2013.csv,2013,0.0,1.0
6944,Alphabet,2029628,0,2029628,2013.csv,2013,0.0,1.0
6945,Legend of the Ancient Sword,2029441,0,2029441,2018.csv,2018,0.0,1.0
6946,Onneli ja Anneli,2028978,0,2028978,2014.csv,2014,0.0,1.0
6947,Climax,2027391,817339,1210052,2018.csv,2018,0.40314818404540614,0.5968518159545939
6948,Present Laughter,2026562,0,2026562,2019.csv,2019,0.0,1.0
6949,The Misfits Club,2026510,0,2026510,2014.csv,2014,0.0,1.0
6950,"Dzien dobry, kocham cie!",2025979,0,2025979,2014.csv,2014,0.0,1.0
6951,The Magic Kids: Three Unlikely Heroes,2024412,0,2024412,2020.csv,2020,0.0,1.0
6952,"She Remembers, He Forgets",2023892,0,2023892,2015.csv,2015,0.0,1.0
6953,Mumbai Saga,2023431,0,2023431,2021.csv,2021,0.0,1.0
6954,Love Is a Broadway Hit,2022609,0,2022609,2017.csv,2017,0.0,1.0
6955,Seoul Station,2021735,0,2021735,2016.csv,2016,0.0,1.0
6956,Neds,2019693,0,2019693,2010.csv,2010,0.0,1.0
6957,Corporate,2019265,0,2019265,2017.csv,2017,0.0,1.0
6958,Armadillo,2018685,14566,2004119,2010.csv,2010,0.007215588365693509,0.9927844116343065
6959,Kamikaze,2016156,0,2016156,2014.csv,2014,0.0,1.0
6960,Midden in de winternacht,2015130,0,2015130,2013.csv,2013,0.0,1.0
6961,Graduation,2015002,175975,1839027,2016.csv,2016,0.0873324195211717,0.9126675804788283
6962,Dépression et des potes,2013149,0,2013149,2012.csv,2012,0.0,1.0
6963,Samoubiytsy,2013142,0,2013142,2012.csv,2012,0.0,1.0
6964,Yeh Saali Zindagi,2011887,0,2011887,2011.csv,2011,0.0,1.0
6965,Made in China 2019 Re-release,2011855,0,2011855,2019.csv,2019,0.0,1.0
6966,National Security,2009251,0,2009251,2012.csv,2012,0.0,1.0
6967,Little Men,2008649,702537,1306112,2016.csv,2016,0.34975598026335114,0.6502440197366489
6968,De Grote Slijmfilm,2008512,0,2008512,2020.csv,2020,0.0,1.0
6969,Hotell Gyllene Knorren - Filmen,2008270,0,2008270,2011.csv,2011,0.0,1.0
6970,Mega Mindy Versus ROX,2008229,0,2008229,2015.csv,2015,0.0,1.0
6971,Jock the Hero Dog,2008173,0,2008173,2011.csv,2011,0.0,1.0
6972,Tada's Do-It-All House: Disconcerto,2007811,0,2007811,2014.csv,2014,0.0,1.0
6973,Won't Last a Day Without You,2006123,0,2006123,2011.csv,2011,0.0,1.0
6974,Dabbe: The Possession,2005958,0,2005958,2013.csv,2013,0.0,1.0
6975,An Impossible Love,2005749,0,2005749,2018.csv,2018,0.0,1.0
6976,A Beautiful Day,2003851,0,2003851,2018.csv,2018,0.0,1.0
6977,The Whiskey Bandit,2003742,0,2003742,2017.csv,2017,0.0,1.0
6978,The Dinner,2003063,0,2003063,2013.csv,2013,0.0,1.0
6979,Kill Time,2002591,0,2002591,2016.csv,2016,0.0,1.0
6980,A Barefoot Dream,2000972,0,2000972,2010.csv,2010,0.0,1.0
6981,"Tukky, jaoying khaai gop",2000227,0,2000227,2010.csv,2010,0.0,1.0
6982,Blind Man,2000203,0,2000203,2012.csv,2012,0.0,1.0
6983,A Prominent Patient,2000121,0,2000121,2016.csv,2016,0.0,1.0
6984,Greater,2000093,2000093,0,2016.csv,2016,1.0,0.0
6985,The Art of Love,1999775,0,1999775,2011.csv,2011,0.0,1.0
6986,"It's Me, It's Me",1999546,0,1999546,2013.csv,2013,0.0,1.0
6987,Tomorrow's a New Day,1999118,0,1999118,2019.csv,2019,0.0,1.0
6988,Peterloo,1998945,151971,1846974,2018.csv,2018,0.07602560350584933,0.9239743964941507
6989,Na kryuchke!,1997922,0,1997922,2011.csv,2011,0.0,1.0
6990,Strike Witches the Movie,1997136,0,1997136,2012.csv,2012,0.0,1.0
6991,Jurassic World: Fallen Kingdom 2020 Re-release,1996736,0,1996736,2020.csv,2020,0.0,1.0
6992,Petta,1996655,0,1996655,2019.csv,2019,0.0,1.0
6993,Tour De Force,1995786,0,1995786,2013.csv,2013,0.0,1.0
6994,1898: Our Last Men in the Philippines,1995045,2848,1992197,2016.csv,2016,0.001427536722229323,0.9985724632777707
6995,Antboy,1994566,0,1994566,2013.csv,2013,0.0,1.0
6996,Valentine Sweety,1991757,0,1991757,2012.csv,2012,0.0,1.0
6997,Ernest et Célestine en hiver,1991734,0,1991734,2017.csv,2017,0.0,1.0
6998,Wojna zensko-meska,1988982,0,1988982,2011.csv,2011,0.0,1.0
6999,The Trip to Spain,1988841,1157604,831237,2017.csv,2017,0.5820495454387756,0.41795045456122437
7000,The Day I Died: Unclosed Case,1988723,0,1988723,2020.csv,2020,0.0,1.0
7001,Accidental Family,1988694,0,1988694,2017.csv,2017,0.0,1.0
7002,Happiness for Sale,1988663,0,1988663,2013.csv,2013,0.0,1.0
7003,Keep an Eye Out,1988526,0,1988526,2018.csv,2018,0.0,1.0
7004,La sedia della felicità,1987730,0,1987730,2014.csv,2014,0.0,1.0
7005,Barbie and the Secret Door,1986375,0,1986375,2014.csv,2014,0.0,1.0
7006,"It's a Great, Great World",1984489,0,1984489,2011.csv,2011,0.0,1.0
7007,Vuonna 85,1984020,0,1984020,2013.csv,2013,0.0,1.0
7008,Etiquette for Mistresses,1983655,0,1983655,2015.csv,2015,0.0,1.0
7009,Summer 1993,1983149,185903,1797246,2017.csv,2017,0.0937413174703464,0.9062586825296536
7010,The Metropolitan Opera HD Live: Verdi: La Traviata,1982588,1882931,99657,2018.csv,2018,0.9497338831870262,0.05026611681297375
7011,Dark World 2: Equilibrium,1982480,0,1982480,2013.csv,2013,0.0,1.0
7012,Doing Good,1981888,0,1981888,2016.csv,2016,0.0,1.0
7013,Heaven Will Wait,1981458,0,1981458,2016.csv,2016,0.0,1.0
7014,The Legacy of the Bones,1981353,0,1981353,2019.csv,2019,0.0,1.0
7015,Kafalar Karisik,1980522,0,1980522,2018.csv,2018,0.0,1.0
7016,I Love You Too,1980411,0,1980411,2010.csv,2010,0.0,1.0
7017,3 Little Pigs and the Magic Lamp,1980000,0,1980000,2015.csv,2015,0.0,1.0
7018,(Nie)znajomi,1979437,0,1979437,2019.csv,2019,0.0,1.0
7019,Juliusz,1979096,0,1979096,2018.csv,2018,0.0,1.0
7020,Lord of Shanghai,1979066,0,1979066,2017.csv,2017,0.0,1.0
7021,"Stars 80, la suite",1978927,0,1978927,2017.csv,2017,0.0,1.0
7022,Frog Story,1978239,0,1978239,2016.csv,2016,0.0,1.0
7023,Ziteitai pseftis,1977642,0,1977642,2010.csv,2010,0.0,1.0
7024,Widows,1977469,0,1977469,2011.csv,2011,0.0,1.0
7025,Papi Sitter,1975973,0,1975973,2020.csv,2020,0.0,1.0
7026,Singham Returns,1974745,1232018,742727,2014.csv,2014,0.6238871347946191,0.37611286520538095
7027,People Who Are Well,1973147,0,1973147,2014.csv,2014,0.0,1.0
7028,Beloved,1971858,137515,1834343,2011.csv,2011,0.06973879457851427,0.9302612054214857
7029,Uma Quase Dupla,1971739,0,1971739,2018.csv,2018,0.0,1.0
7030,The New Legend of Shaolin 2011 Re-release,1971490,0,1971490,2011.csv,2011,0.0,1.0
7031,Como se Tornar o Pior Aluno da Escola,1971484,0,1971484,2017.csv,2017,0.0,1.0
7032,Diary of a Chambermaid,1971247,54235,1917012,2015.csv,2015,0.027513041237348743,0.9724869587626512
7033,Exterminator,1970978,0,1970978,2018.csv,2018,0.0,1.0
7034,Tátova volha,1970347,0,1970347,2018.csv,2018,0.0,1.0
7035,No Game No Life: Zero 2019 Re-release,1969797,0,1969797,2019.csv,2019,0.0,1.0
7036,Jo Pil-ho: The Dawning Rage,1969256,0,1969256,2019.csv,2019,0.0,1.0
7037,A Boy Who Wished to Be Okuda Tamio and a Girl Who Drove All Men Crazy,1969052,0,1969052,2017.csv,2017,0.0,1.0
7038,The Juror,1966413,0,1966413,2019.csv,2019,0.0,1.0
7039,Team Spirit,1966165,0,1966165,2016.csv,2016,0.0,1.0
7040,Crazy Wedding,1966105,0,1966105,2018.csv,2018,0.0,1.0
7041,All My Life,1965113,913935,1051178,2020.csv,2020,0.4650801251632858,0.5349198748367142
7042,Príbeh kmotra,1964878,0,1964878,2013.csv,2013,0.0,1.0
7043,Conquest,1964806,0,1964806,2019.csv,2019,0.0,1.0
7044,Things from Another World 2011 Re-release,1963597,0,1963597,2011.csv,2011,0.0,1.0
7045,Maquia: When the Promised Flower Blooms,1963575,185699,1777876,2018.csv,2018,0.09457189055676508,0.9054281094432349
7046,The Day I Saw Your Heart,1963145,0,1963145,2011.csv,2011,0.0,1.0
7047,Misfit,1963049,0,1963049,2017.csv,2017,0.0,1.0
7048,Menashe,1962265,1703036,259229,2017.csv,2017,0.8678929706232339,0.13210702937676613
7049,"A Date with Luyu: Tian xia di yi cun. Hua xi cun, Shu ji Wu Renbao",1960664,0,1960664,2010.csv,2010,0.0,1.0
7050,Color Me Love,1960533,0,1960533,2010.csv,2010,0.0,1.0
7051,The Dancer,1960510,0,1960510,2016.csv,2016,0.0,1.0
7052,13rd Sister,1959302,0,1959302,2019.csv,2019,0.0,1.0
7053,Holy Goalie,1958544,0,1958544,2018.csv,2018,0.0,1.0
7054,Those Happy Years,1958508,0,1958508,2013.csv,2013,0.0,1.0
7055,Breaking Wind,1958083,0,1958083,2012.csv,2012,0.0,1.0
7056,Headwinds,1957345,0,1957345,2011.csv,2011,0.0,1.0
7057,30 Chua Phai Tet,1957005,0,1957005,2020.csv,2020,0.0,1.0
7058,"Love, Chunibyo & Other Delusions! Take on Me",1956834,0,1956834,2018.csv,2018,0.0,1.0
7059,Potseluy skvoz stenu,1956616,0,1956616,2011.csv,2011,0.0,1.0
7060,Magical Girl Lyrical Nanoha: Detonation,1956419,0,1956419,2018.csv,2018,0.0,1.0
7061,Angel & Tony,1956275,0,1956275,2011.csv,2011,0.0,1.0
7062,Shin Megami Tensei: Persona 3,1956267,0,1956267,2013.csv,2013,0.0,1.0
7063,Firangi,1955266,0,1955266,2017.csv,2017,0.0,1.0
7064,The Bachelor 2,1954469,0,1954469,2017.csv,2017,0.0,1.0
7065,Holy Motors,1954125,641100,1313025,2012.csv,2012,0.3280752254845519,0.6719247745154481
7066,El Badla,1953865,0,1953865,2018.csv,2018,0.0,1.0
7067,Valentino,1952361,0,1952361,2013.csv,2013,0.0,1.0
7068,A Ghost Story,1951683,1596371,355312,2017.csv,2017,0.8179458446889172,0.1820541553110828
7069,Smoorverliefd,1950459,0,1950459,2013.csv,2013,0.0,1.0
7070,Dear Devil Brother,1950104,0,1950104,2019.csv,2019,0.0,1.0
7071,Euforia,1949722,0,1949722,2018.csv,2018,0.0,1.0
7072,Zombie for Sale,1949681,0,1949681,2019.csv,2019,0.0,1.0
7073,Deadfall,1946254,66351,1879903,2012.csv,2012,0.03409164476990156,0.9659083552300984
7074,The Stand-In Thief,1945971,0,1945971,2017.csv,2017,0.0,1.0
7075,Marie Curie: The Courage of Knowledge,1944392,127986,1816406,2017.csv,2017,0.06582314677287296,0.9341768532271271
7076,Kazantzakis,1944344,0,1944344,2017.csv,2017,0.0,1.0
7077,V/H/S,1944287,100345,1843942,2012.csv,2012,0.0516101789499184,0.9483898210500816
7078,Housefull 3,1944262,1326999,617263,2016.csv,2016,0.6825206685107255,0.3174793314892746
7079,In and Out,1943343,0,1943343,2017.csv,2017,0.0,1.0
7080,Hayaller Ülkesi: Gamonya,1943338,0,1943338,2020.csv,2020,0.0,1.0
7081,In My Father's Garden,1941580,0,1941580,2016.csv,2016,0.0,1.0
7082,28 Days Later... 2016 Re-release,1941549,0,1941549,2016.csv,2016,0.0,1.0
7083,Yam yasothon 3,1941524,0,1941524,2013.csv,2013,0.0,1.0
7084,Toro,1941305,0,1941305,2016.csv,2016,0.0,1.0
7085,Abigail,1940234,0,1940234,2019.csv,2019,0.0,1.0
7086,A Chilling Cosplay,1939889,0,1939889,2013.csv,2013,0.0,1.0
7087,That's Not Cheating,1938977,0,1938977,2016.csv,2016,0.0,1.0
7088,Another Earth,1938783,1321194,617589,2011.csv,2011,0.6814553253252169,0.3185446746747831
7089,Liefling,1938655,0,1938655,2010.csv,2010,0.0,1.0
7090,As the Gods Will,1938654,0,1938654,2014.csv,2014,0.0,1.0
7091,Láska je láska,1938047,0,1938047,2012.csv,2012,0.0,1.0
7092,Homme Fatale,1937442,0,1937442,2019.csv,2019,0.0,1.0
7093,No Such Thing as Housewives 2,1937239,0,1937239,2019.csv,2019,0.0,1.0
7094,Gekijouban Sengoku Basara: The Last Party,1936376,0,1936376,2011.csv,2011,0.0,1.0
7095,Devushki byvayut raznye,1933579,0,1933579,2019.csv,2019,0.0,1.0
7096,Doktor od jezera hrochu,1929575,0,1929575,2010.csv,2010,0.0,1.0
7097,The Butler,1929069,0,1929069,2018.csv,2018,0.0,1.0
7098,122,1928719,0,1928719,2019.csv,2019,0.0,1.0
7099,The Christmas Tango,1927222,0,1927222,2011.csv,2011,0.0,1.0
7100,Ali Kundilli,1926557,0,1926557,2015.csv,2015,0.0,1.0
7101,Barkley,1926435,0,1926435,2017.csv,2017,0.0,1.0
7102,Mere Dad Ki Maruti,1925068,0,1925068,2013.csv,2013,0.0,1.0
7103,Born to Love You,1924766,0,1924766,2012.csv,2012,0.0,1.0
7104,Luka Chuppi,1923586,1042905,880681,2019.csv,2019,0.5421670775312359,0.45783292246876406
7105,Call Girl,1922273,0,1922273,2012.csv,2012,0.0,1.0
7106,Jane,1921221,1723379,197842,2017.csv,2017,0.8970227787433096,0.10297722125669041
7107,Hide and Never Seek,1919930,0,1919930,2016.csv,2016,0.0,1.0
7108,The Canterville Ghost,1918805,0,1918805,2016.csv,2016,0.0,1.0
7109,The Craft: Legacy,1918716,0,1918716,2020.csv,2020,0.0,1.0
7110,Süskind,1918164,0,1918164,2012.csv,2012,0.0,1.0
7111,Hur många kramar finns det i världen?,1917521,0,1917521,2013.csv,2013,0.0,1.0
7112,The Keeper,1916514,0,1916514,2019.csv,2019,0.0,1.0
7113,Bennie Stout,1915540,0,1915540,2011.csv,2011,0.0,1.0
7114,Alludu Adhurs,1915032,0,1915032,2021.csv,2021,0.0,1.0
7115,Old Fashioned,1914090,1914090,0,2015.csv,2015,1.0,0.0
7116,Ingrid 2015 Re-release,1913279,0,1913279,2015.csv,2015,0.0,1.0
7117,Mia fora kai ena... moro,1912076,0,1912076,2011.csv,2011,0.0,1.0
7118,Se Puder... Dirija!,1909712,0,1909712,2013.csv,2013,0.0,1.0
7119,Wasao,1908654,0,1908654,2011.csv,2011,0.0,1.0
7120,Serra Pelada - A Lenda Da Montanha De Ouro,1908156,0,1908156,2013.csv,2013,0.0,1.0
7121,My Dear Assistant,1908077,0,1908077,2019.csv,2019,0.0,1.0
7122,According to Our Butler,1907988,0,1907988,2019.csv,2019,0.0,1.0
7123,Jurassic Park 2020 Re-release,1907782,1386600,521182,2020.csv,2020,0.7268126022784573,0.2731873977215426
7124,E a Vida Continua...,1907227,0,1907227,2012.csv,2012,0.0,1.0
7125,Kumanthong,1907218,0,1907218,2019.csv,2019,0.0,1.0
7126,Jungle,1906640,0,1906640,2017.csv,2017,0.0,1.0
7127,Absurd Accident,1905999,0,1905999,2017.csv,2017,0.0,1.0
7128,Mrs. Lowry and Son,1905981,0,1905981,2019.csv,2019,0.0,1.0
7129,7 Days in Havana,1905509,0,1905509,2012.csv,2012,0.0,1.0
7130,Tuintje in mijn hart,1905084,0,1905084,2017.csv,2017,0.0,1.0
7131,Dönerse Senindir,1904967,0,1904967,2016.csv,2016,0.0,1.0
7132,Someday,1900652,0,1900652,2011.csv,2011,0.0,1.0
7133,Pirates Down the Street,1900298,0,1900298,2020.csv,2020,0.0,1.0
7134,A Few Hours of Spring,1900262,0,1900262,2012.csv,2012,0.0,1.0
7135,The Haunted Cinema,1900000,0,1900000,2014.csv,2014,0.0,1.0
7136,Play,1899658,0,1899658,2020.csv,2020,0.0,1.0
7137,Professor Marston & the Wonder Women,1899615,1584759,314856,2017.csv,2017,0.8342527301584794,0.16574726984152052
7138,Coconut the Little Dragon 2: Into the Jungle,1898800,0,1898800,2018.csv,2018,0.0,1.0
7139,Flying Pigs,1898456,0,1898456,2010.csv,2010,0.0,1.0
7140,Sweet Dreams,1898410,0,1898410,2016.csv,2016,0.0,1.0
7141,Frank,1897363,645186,1252177,2014.csv,2014,0.3400435235640202,0.6599564764359799
7142,Dummie the Mummy and the Sphinx of Shakaba,1897147,0,1897147,2015.csv,2015,0.0,1.0
7143,Kein Sex ist auch keine Lösung,1896512,0,1896512,2011.csv,2011,0.0,1.0
7144,The Dinner Club,1896467,0,1896467,2010.csv,2010,0.0,1.0
7145,Game of Thrones Season 4 Finale,1896092,1896092,0,2015.csv,2015,1.0,0.0
7146,Spirou & Fantasio's Big Adventures,1894378,0,1894378,2018.csv,2018,0.0,1.0
7147,Valley of the Wolves: Homeland,1893015,0,1893015,2017.csv,2017,0.0,1.0
7148,The Art of Getting By,1892130,1430241,461889,2011.csv,2011,0.7558893944919218,0.2441106055080782
7149,In the Forests of Siberia,1891986,0,1891986,2016.csv,2016,0.0,1.0
7150,The Mighty Macs,1891936,1891936,0,2011.csv,2011,1.0,0.0
7151,Awake: The Life of Yogananda,1891918,1539680,352238,2014.csv,2014,0.8138196264320123,0.1861803735679876
7152,Mission London,1891264,0,1891264,2010.csv,2010,0.0,1.0
7153,La Historia Du Un Amor,1890232,0,1890232,2017.csv,2017,0.0,1.0
7154,Red Lips,1889869,136163,1753706,2011.csv,2011,0.07204890921010927,0.9279510907898907
7155,The Sound of a Flower,1889637,0,1889637,2015.csv,2015,0.0,1.0
7156,Zhizn vperedi,1889263,0,1889263,2017.csv,2017,0.0,1.0
7157,Saint Young Men: The Movie,1888062,0,1888062,2013.csv,2013,0.0,1.0
7158,Silent Night,1888044,0,1888044,2017.csv,2017,0.0,1.0
7159,The Metropolitan Opera HD Live: The Gershwins' Porgy and Bess,1887761,0,1887761,2020.csv,2020,0.0,1.0
7160,Toriko the Movie: Secret Recipe of Gourmet God!,1887024,0,1887024,2013.csv,2013,0.0,1.0
7161,Ninja Kids!!!: Summer Mission Impossible,1885257,0,1885257,2013.csv,2013,0.0,1.0
7162,Ligabue Campovolo - il film 3D,1884892,0,1884892,2011.csv,2011,0.0,1.0
7163,Ego,1884827,0,1884827,2013.csv,2013,0.0,1.0
7164,3 Days in Quiberon,1882287,0,1882287,2018.csv,2018,0.0,1.0
7165,Tusk,1882074,1826705,55369,2014.csv,2014,0.9705808592010728,0.02941914079892714
7166,"Life, Above All",1881974,0,1881974,2012.csv,2012,0.0,1.0
7167,The Aquatic Effect,1879961,0,1879961,2016.csv,2016,0.0,1.0
7168,Chocolate Kisses,1879629,0,1879629,2011.csv,2011,0.0,1.0
7169,Low Cost,1879181,0,1879181,2011.csv,2011,0.0,1.0
7170,Emil & Ida i Lönneberga,1878256,0,1878256,2013.csv,2013,0.0,1.0
7171,El-Cin 2013 Re-release,1878082,0,1878082,2013.csv,2013,0.0,1.0
7172,Kill Your Darlings,1877924,1030064,847860,2013.csv,2013,0.5485120803610796,0.45148791963892043
7173,Fantastic Fungi,1877675,1788322,89353,2019.csv,2019,0.9524129575139467,0.04758704248605323
7174,The Man Who Will Come,1877452,0,1877452,2010.csv,2010,0.0,1.0
7175,Time of happiness,1877234,0,1877234,2017.csv,2017,0.0,1.0
7176,Tone-Deaf Clinic,1875097,0,1875097,2012.csv,2012,0.0,1.0
7177,Red State,1874460,1104682,769778,2011.csv,2011,0.5893334613702079,0.410666538629792
7178,Last Flag Flying,1872950,965481,907469,2017.csv,2017,0.5154867989001308,0.4845132010998692
7179,The Wrath of Vajra,1872903,0,1872903,2013.csv,2013,0.0,1.0
7180,Artificial Paradises,1872736,0,1872736,2012.csv,2012,0.0,1.0
7181,Afro Tanaka,1872727,0,1872727,2012.csv,2012,0.0,1.0
7182,A Tale of Three Cities,1871119,0,1871119,2015.csv,2015,0.0,1.0
7183,Max Pinlig 3 - på Roskilde,1871079,0,1871079,2012.csv,2012,0.0,1.0
7184,Escape Room,1870824,0,1870824,2017.csv,2017,0.0,1.0
7185,The Whistleblower,1870392,1124966,745426,2011.csv,2011,0.6014600147990368,0.39853998520096323
7186,Beyond the Dream,1869039,0,1869039,2020.csv,2020,0.0,1.0
7187,Purple Rain 2016 Re-release,1868929,1868075,854,2016.csv,2016,0.9995430538024719,0.000456946197528103
7188,D@bbe: Demon Possession,1867540,0,1867540,2012.csv,2012,0.0,1.0
7189,Pachamama,1866211,0,1866211,2018.csv,2018,0.0,1.0
7190,The Devil's Flower,1865696,0,1865696,2010.csv,2010,0.0,1.0
7191,Chouf,1865664,0,1865664,2016.csv,2016,0.0,1.0
7192,Single Street,1865000,0,1865000,2019.csv,2019,0.0,1.0
7193,Inseparables,1864605,6258,1858347,2016.csv,2016,0.003356206810557732,0.9966437931894423
7194,Matthias & Maxime,1863999,374739,1489260,2019.csv,2019,0.2010403439057639,0.7989596560942361
7195,Korea 1%,1863930,0,1863930,2010.csv,2010,0.0,1.0
7196,Monster Island,1863643,0,1863643,2017.csv,2017,0.0,1.0
7197,A Better Life,1863506,1759252,104254,2011.csv,2011,0.9440549158414301,0.05594508415856992
7198,Girlhood,1862990,60765,1802225,2014.csv,2014,0.03261692225937874,0.9673830777406213
7199,Demi soeurs,1862432,0,1862432,2018.csv,2018,0.0,1.0
7200,The Hallow,1862407,13906,1848501,2015.csv,2015,0.007466681557790537,0.9925333184422095
7201,The Dark Horse,1862114,67533,1794581,2014.csv,2014,0.036266845101857355,0.9637331548981426
7202,The Rodriguez and the Beyond,1861881,0,1861881,2019.csv,2019,0.0,1.0
7203,Babovresky 2,1861804,0,1861804,2014.csv,2014,0.0,1.0
7204,Sonsuz Ask,1861593,0,1861593,2017.csv,2017,0.0,1.0
7205,Inside the Girls,1860000,0,1860000,2014.csv,2014,0.0,1.0
7206,The Confessions,1859604,0,1859604,2016.csv,2016,0.0,1.0
7207,Kill Buljo 2,1857719,0,1857719,2013.csv,2013,0.0,1.0
7208,Good People,1857574,0,1857574,2014.csv,2014,0.0,1.0
7209,My Father Is a Cleaning Lady,1856973,0,1856973,2011.csv,2011,0.0,1.0
7210,Omar W Salma 3,1856517,0,1856517,2012.csv,2012,0.0,1.0
7211,Saraba itoshi no daitôryô,1856488,0,1856488,2010.csv,2010,0.0,1.0
7212,The Pact,1855647,2488,1853159,2018.csv,2018,0.0013407722481700453,0.9986592277518299
7213,Wajah Tum Ho,1855282,0,1855282,2016.csv,2016,0.0,1.0
7214,Death Ouija 2,1854170,0,1854170,2017.csv,2017,0.0,1.0
7215,Ismael,1853974,0,1853974,2013.csv,2013,0.0,1.0
7216,Paraiso: Tatlong kwento ng pag-asa 2014 Re-release,1853151,0,1853151,2014.csv,2014,0.0,1.0
7217,Ex with Benefits,1851952,0,1851952,2015.csv,2015,0.0,1.0
7218,Unforgettable,1850357,0,1850357,2016.csv,2016,0.0,1.0
7219,Trick,1849612,0,1849612,2010.csv,2010,0.0,1.0
7220,O Candidato Honesto 2,1848523,0,1848523,2018.csv,2018,0.0,1.0
7221,Sweet Country,1847693,104297,1743396,2018.csv,2018,0.056447147875756415,0.9435528521242436
7222,The Bachelor 3,1846062,0,1846062,2018.csv,2018,0.0,1.0
7223,Misbehaviour,1845897,0,1845897,2020.csv,2020,0.0,1.0
7224,Romang,1843971,0,1843971,2019.csv,2019,0.0,1.0
7225,Mój biegun,1843438,0,1843438,2013.csv,2013,0.0,1.0
7226,All Is Well,1843389,0,1843389,2015.csv,2015,0.0,1.0
7227,The House Elf,1842316,0,1842316,2019.csv,2019,0.0,1.0
7228,Mr. Deng Goes to Washington,1840000,0,1840000,2015.csv,2015,0.0,1.0
7229,Karbala,1839975,0,1839975,2015.csv,2015,0.0,1.0
7230,Father's Chair,1839839,0,1839839,2013.csv,2013,0.0,1.0
7231,Parterapi,1839532,0,1839532,2010.csv,2010,0.0,1.0
7232,Kóblic,1839313,0,1839313,2016.csv,2016,0.0,1.0
7233,I Miss U,1838915,0,1838915,2012.csv,2012,0.0,1.0
7234,The Inhabitant,1838846,0,1838846,2018.csv,2018,0.0,1.0
7235,Witches Don't Exist,1838581,0,1838581,2014.csv,2014,0.0,1.0
7236,Crazy Little Things,1838382,0,1838382,2018.csv,2018,0.0,1.0
7237,The Alien Girl,1837466,0,1837466,2010.csv,2010,0.0,1.0
7238,24/7 in Love,1837164,0,1837164,2012.csv,2012,0.0,1.0
7239,Vita Cuore e Battito,1836942,0,1836942,2016.csv,2016,0.0,1.0
7240,Tiger Theory,1836839,0,1836839,2016.csv,2016,0.0,1.0
7241,Love Over Distance,1836193,0,1836193,2017.csv,2017,0.0,1.0
7242,Casper and Emma's Wonderful Christmas,1836028,0,1836028,2014.csv,2014,0.0,1.0
7243,Arrambam,1835852,0,1835852,2013.csv,2013,0.0,1.0
7244,Jackie,1835156,0,1835156,2012.csv,2012,0.0,1.0
7245,Roommate,1832755,0,1832755,2013.csv,2013,0.0,1.0
7246,Crooked Arrows,1832541,1832541,0,2012.csv,2012,1.0,0.0
7247,"El Potro, lo mejor del amor",1830556,0,1830556,2018.csv,2018,0.0,1.0
7248,Fall... in Love 2013 Re-release,1830000,0,1830000,2013.csv,2013,0.0,1.0
7249,Youth in Asia on Belmont St.,1829101,0,1829101,2016.csv,2016,0.0,1.0
7250,99 Homes,1828232,1411927,416305,2015.csv,2015,0.7722909346297406,0.22770906537025937
7251,Grease 2018 Re-release,1827688,1213413,614275,2018.csv,2018,0.6639059839534975,0.33609401604650246
7252,The Wedding Video,1827650,0,1827650,2012.csv,2012,0.0,1.0
7253,Swingersi,1827589,0,1827589,2020.csv,2020,0.0,1.0
7254,Mutlu Aile Defteri,1827360,0,1827360,2013.csv,2013,0.0,1.0
7255,Rams,1826583,149250,1677333,2015.csv,2015,0.08170994693370079,0.9182900530662992
7256,A Somewhat Gentle Man,1826459,37743,1788716,2010.csv,2010,0.02066457555302364,0.9793354244469764
7257,Crack,1826247,0,1826247,2019.csv,2019,0.0,1.0
7258,The Little Stranger,1824902,713143,1111759,2018.csv,2018,0.39078427225133183,0.6092157277486682
7259,Mozart's Sister,1824891,707885,1117006,2010.csv,2010,0.3879053598269705,0.6120946401730295
7260,Pokemon Deo Mu-bi XY&Z Bolkenion: Gigyewanggukui Bimil,1824859,0,1824859,2016.csv,2016,0.0,1.0
7261,Infinitely Polar Bear,1824678,1430655,394023,2015.csv,2015,0.7840588860061884,0.21594111399381152
7262,Human Flow,1824537,527845,1296692,2017.csv,2017,0.28930353289629096,0.710696467103709
7263,Dummie the Mummy and the Tomb of Achnetut,1823711,0,1823711,2017.csv,2017,0.0,1.0
7264,Le dindon,1822834,0,1822834,2019.csv,2019,0.0,1.0
7265,The Fantastic Journey of Margot & Marguerite,1822472,0,1822472,2020.csv,2020,0.0,1.0
7266,Rasputin 2013 Re-release,1821978,0,1821978,2013.csv,2013,0.0,1.0
7267,Paano na kaya,1821533,0,1821533,2010.csv,2010,0.0,1.0
7268,Kayhan,1821339,0,1821339,2018.csv,2018,0.0,1.0
7269,Der kleine Rabe Socke - Suche nach dem verlorenen Schatz,1820705,0,1820705,2019.csv,2019,0.0,1.0
7270,Bröderna Karlsson,1820573,0,1820573,2010.csv,2010,0.0,1.0
7271,The Seagull,1820461,1252960,567501,2018.csv,2018,0.688265225127042,0.311734774872958
7272,Hating kapatid,1820332,0,1820332,2010.csv,2010,0.0,1.0
7273,Nochnaya smena,1819252,0,1819252,2018.csv,2018,0.0,1.0
7274,MT/Warrior VS Dragon,1817380,0,1817380,2016.csv,2016,0.0,1.0
7275,Varg Veum - Skriften på veggen,1816022,0,1816022,2010.csv,2010,0.0,1.0
7276,Ay Lav Yu Tuu,1815484,0,1815484,2017.csv,2017,0.0,1.0
7277,Tutta un'altra vita,1815376,0,1815376,2019.csv,2019,0.0,1.0
7278,The Tag-Along,1814080,0,1814080,2015.csv,2015,0.0,1.0
7279,Luv Shuv Tey Chicken Khurana,1813916,143507,1670409,2012.csv,2012,0.07911446836567956,0.9208855316343204
7280,Raazi,1812763,0,1812763,2018.csv,2018,0.0,1.0
7281,Wife of a Spy,1812710,0,1812710,2020.csv,2020,0.0,1.0
7282,Pat a Mat: Zimní radovánky,1811643,0,1811643,2018.csv,2018,0.0,1.0
7283,Space Sheriff Gavan: The Movie,1810856,0,1810856,2012.csv,2012,0.0,1.0
7284,Homies,1810644,0,1810644,2015.csv,2015,0.0,1.0
7285,Operasjon Mørkemann,1809667,0,1809667,2018.csv,2018,0.0,1.0
7286,Someone You Love,1809617,0,1809617,2014.csv,2014,0.0,1.0
7287,The Monk,1809527,13472,1796055,2011.csv,2011,0.0074450395047987675,0.9925549604952012
7288,Bella Donna's,1807505,0,1807505,2017.csv,2017,0.0,1.0
7289,The Other Side of Heaven 2: Fire of Faith,1807216,1807216,0,2019.csv,2019,1.0,0.0
7290,Moses,1807117,1807117,0,2018.csv,2018,1.0,0.0
7291,Trouble Makers,1806679,0,1806679,2017.csv,2017,0.0,1.0
7292,The Face of Love,1806548,350006,1456542,2013.csv,2013,0.19374298385650424,0.8062570161434958
7293,Cornouaille,1805634,0,1805634,2012.csv,2012,0.0,1.0
7294,Phoo Chai Lunla,1803558,0,1803558,2010.csv,2010,0.0,1.0
7295,Happy as Lazzaro,1802696,0,1802696,2018.csv,2018,0.0,1.0
7296,Li Bao Guo,1799319,0,1799319,2018.csv,2018,0.0,1.0
7297,Wings of Christmas,1799192,0,1799192,2013.csv,2013,0.0,1.0
7298,Elvis & Nixon,1798432,1055287,743145,2016.csv,2016,0.5867817076208608,0.41321829237913915
7299,Spy Nation 2017 Re-release,1798360,0,1798360,2017.csv,2017,0.0,1.0
7300,The Polar Express 2010 IMAX Release,1798274,672796,1125478,2010.csv,2010,0.3741343087872037,0.6258656912127962
7301,The Matrix 2019 Re-release,1798259,0,1798259,2019.csv,2019,0.0,1.0
7302,Last Knights,1797955,0,1797955,2015.csv,2015,0.0,1.0
7303,"Il était une fois, une fois",1797867,0,1797867,2012.csv,2012,0.0,1.0
7304,Sinterklaas en het raadsel van 5 december,1796195,0,1796195,2011.csv,2011,0.0,1.0
7305,Guardians of Oz,1795996,0,1795996,2015.csv,2015,0.0,1.0
7306,Hello Jadoo,1795749,0,1795749,2016.csv,2016,0.0,1.0
7307,Albert,1794574,0,1794574,2015.csv,2015,0.0,1.0
7308,Içimdeki Ses,1792433,0,1792433,2015.csv,2015,0.0,1.0
7309,While the Wolf's Away,1791561,0,1791561,2017.csv,2017,0.0,1.0
7310,Pak! Pak! My Dr. Kwak!,1790877,0,1790877,2011.csv,2011,0.0,1.0
7311,A Noble Intention,1790201,0,1790201,2015.csv,2015,0.0,1.0
7312,Broadcasting Girl,1790000,0,1790000,2014.csv,2014,0.0,1.0
7313,Bombay Talkies,1789657,0,1789657,2013.csv,2013,0.0,1.0
7314,Mine,1788934,0,1788934,2016.csv,2016,0.0,1.0
7315,L'agenzia dei bugiardi,1788083,0,1788083,2019.csv,2019,0.0,1.0
7316,The Rotterdam Bombing,1787158,0,1787158,2012.csv,2012,0.0,1.0
7317,Små citroner gula,1786541,0,1786541,2013.csv,2013,0.0,1.0
7318,Caccia al tesoro,1786335,0,1786335,2017.csv,2017,0.0,1.0
7319,The Ritual,1785977,0,1785977,2017.csv,2017,0.0,1.0
7320,"Six Years, Six Days",1785824,0,1785824,2017.csv,2017,0.0,1.0
7321,Harry Potter IMAX Marathon,1784557,1729226,55331,2016.csv,2016,0.9689945459853622,0.031005454014637807
7322,"Bergoglio, the Pope Francis",1784438,0,1784438,2015.csv,2015,0.0,1.0
7323,Soldiers of Fortune,1784286,38898,1745388,2012.csv,2012,0.021800316765361608,0.9781996832346384
7324,"I Have Loved you for 30 Years, Yayoi",1783960,0,1783960,2020.csv,2020,0.0,1.0
7325,Opposites Attract,1783792,0,1783792,2015.csv,2015,0.0,1.0
7326,Wings Over Everest,1782513,0,1782513,2019.csv,2019,0.0,1.0
7327,Bakaleya High School,1780758,0,1780758,2012.csv,2012,0.0,1.0
7328,Cheese in the Trap,1779970,0,1779970,2018.csv,2018,0.0,1.0
7329,Talk Back and You're Dead,1779905,0,1779905,2014.csv,2014,0.0,1.0
7330,Gekijô rei,1778877,0,1778877,2015.csv,2015,0.0,1.0
7331,Lev Yashin. Vratar moey mechty,1778723,0,1778723,2019.csv,2019,0.0,1.0
7332,Song to Song,1778021,443684,1334337,2017.csv,2017,0.2495381100673164,0.7504618899326836
7333,Ondine,1777019,550472,1226547,2010.csv,2010,0.30977271486686414,0.6902272851331359
7334,Tom of Finland,1776931,378296,1398635,2017.csv,2017,0.2128929035511227,0.7871070964488773
7335,Make Me Shudder,1776457,0,1776457,2013.csv,2013,0.0,1.0
7336,Les municipaux - Trop c'est trop,1776200,0,1776200,2019.csv,2019,0.0,1.0
7337,The Diary of a Teenage Girl,1775133,1477002,298131,2015.csv,2015,0.832051457552758,0.16794854244724197
7338,Casper and Emma Go Treasure Hunting,1774862,0,1774862,2018.csv,2018,0.0,1.0
7339,Open Season: Scared Silly,1774429,0,1774429,2015.csv,2015,0.0,1.0
7340,"Me, Myself & Her",1774250,0,1774250,2015.csv,2015,0.0,1.0
7341,Dubrovskiy,1773671,0,1773671,2014.csv,2014,0.0,1.0
7342,Chiara Ferragni: Unposted,1773242,0,1773242,2019.csv,2019,0.0,1.0
7343,Polaroid,1772204,0,1772204,2019.csv,2019,0.0,1.0
7344,Fad jang toh,1772041,0,1772041,2013.csv,2013,0.0,1.0
7345,Forever Young,1771103,0,1771103,2016.csv,2016,0.0,1.0
7346,After the Dark,1770376,0,1770376,2013.csv,2013,0.0,1.0
7347,Evolusi: KL Drift 2,1770338,0,1770338,2010.csv,2010,0.0,1.0
7348,Dior and I,1769832,1028953,740879,2015.csv,2015,0.5813845607944709,0.4186154392055291
7349,Ushi Must Marry,1769565,0,1769565,2013.csv,2013,0.0,1.0
7350,Sprookjesboom de Film,1768177,0,1768177,2012.csv,2012,0.0,1.0
7351,I Saw the Light,1767963,1646788,121175,2016.csv,2016,0.9314606697085855,0.06853933029141447
7352,The Sandman and the Lost Sand of Dreams,1767918,0,1767918,2010.csv,2010,0.0,1.0
7353,Invisible Life,1766249,146535,1619714,2019.csv,2019,0.08296395355354766,0.9170360464464523
7354,Escape Plan: The Extractors,1766092,0,1766092,2019.csv,2019,0.0,1.0
7355,Los que aman odian,1764833,0,1764833,2017.csv,2017,0.0,1.0
7356,Game,1764828,139528,1625300,2011.csv,2011,0.07906039568728511,0.9209396043127149
7357,Aigaio SOS,1764311,0,1764311,2018.csv,2018,0.0,1.0
7358,The Metropolitan Opera HD Live: Puccini: La Bohème,1764201,1764201,0,2018.csv,2018,1.0,0.0
7359,Family Heist,1764140,0,1764140,2017.csv,2017,0.0,1.0
7360,The Gifted,1764126,0,1764126,2014.csv,2014,0.0,1.0
7361,Bromance: My Brother's Romance,1764028,0,1764028,2013.csv,2013,0.0,1.0
7362,A Boy and His Samurai,1763791,0,1763791,2010.csv,2010,0.0,1.0
7363,Fool's Day,1762945,0,1762945,2014.csv,2014,0.0,1.0
7364,Tales of the Night,1762194,10975,1751219,2011.csv,2011,0.006228031646912883,0.9937719683530871
7365,Yol Ayrimi,1761937,0,1761937,2017.csv,2017,0.0,1.0
7366,Solo,1760138,0,1760138,2016.csv,2016,0.0,1.0
7367,8 Seconds,1759935,0,1759935,2015.csv,2015,0.0,1.0
7368,Everybody Has a Plan,1759900,0,1759900,2012.csv,2012,0.0,1.0
7369,Teo-ning-me-ca-deu-W: Beul-laek-mi-leo-ui Bu-hwal,1759462,0,1759462,2017.csv,2017,0.0,1.0
7370,The Way We Dance,1759061,0,1759061,2013.csv,2013,0.0,1.0
7371,Rush 2015 Re-release,1758414,0,1758414,2015.csv,2015,0.0,1.0
7372,Khamoshiyan,1758212,0,1758212,2015.csv,2015,0.0,1.0
7373,Greystone Park,1757134,0,1757134,2012.csv,2012,0.0,1.0
7374,Fasten Your Seatbelt,1755894,0,1755894,2013.csv,2013,0.0,1.0
7375,The Truth Beneath,1755561,0,1755561,2016.csv,2016,0.0,1.0
7376,Flipped,1755212,1755212,0,2010.csv,2010,1.0,0.0
7377,Sai de Baixo: O Filme,1753663,0,1753663,2019.csv,2019,0.0,1.0
7378,Streif: One Hell of a Ride,1753060,0,1753060,2014.csv,2014,0.0,1.0
7379,"When I Get Home, My Wife Always Pretends to Be Dead.",1752391,0,1752391,2018.csv,2018,0.0,1.0
7380,Back to the Beginning,1752277,0,1752277,2016.csv,2016,0.0,1.0
7381,The Blizzard,1752067,0,1752067,2018.csv,2018,0.0,1.0
7382,Turk's Head,1751180,0,1751180,2010.csv,2010,0.0,1.0
7383,3Grapes,1750746,0,1750746,2020.csv,2020,0.0,1.0
7384,Socialphobia,1750719,0,1750719,2015.csv,2015,0.0,1.0
7385,Flirting in the Air,1750354,0,1750354,2014.csv,2014,0.0,1.0
7386,My Mother's Wound,1749704,0,1749704,2016.csv,2016,0.0,1.0
7387,Papa 2012 Re-release,1747575,0,1747575,2012.csv,2012,0.0,1.0
7388,Signal: The Movie,1747428,0,1747428,2021.csv,2021,0.0,1.0
7389,The Metropolitan Opera HD Live: Massenet: Cendrillon,1747259,1243306,503953,2018.csv,2018,0.7115751013444487,0.2884248986555514
7390,Khun Phan,1746350,0,1746350,2016.csv,2016,0.0,1.0
7391,Nobody's Perfect!,1746269,0,1746269,2017.csv,2017,0.0,1.0
7392,Realnaya skazka,1744195,0,1744195,2011.csv,2011,0.0,1.0
7393,Beast,1744071,800365,943706,2018.csv,2018,0.45890620278646915,0.5410937972135309
7394,"Turn Me On, Dammit!",1743743,126085,1617658,2011.csv,2011,0.07230710030090444,0.9276928996990955
7395,Wuthering Heights,1742215,100915,1641300,2011.csv,2011,0.057923390626300426,0.9420766093736995
7396,The Priest,1741065,0,1741065,2010.csv,2010,0.0,1.0
7397,The Comeback Trail,1740212,0,1740212,2020.csv,2020,0.0,1.0
7398,Tale of a Lake,1740042,0,1740042,2016.csv,2016,0.0,1.0
7399,Royal Shakespeare Company: Richard II,1739518,0,1739518,2013.csv,2013,0.0,1.0
7400,The Great Magician,1738798,0,1738798,2012.csv,2012,0.0,1.0
7401,Darbar,1738535,0,1738535,2020.csv,2020,0.0,1.0
7402,Some Like It Veiled,1738143,0,1738143,2017.csv,2017,0.0,1.0
7403,Digimon Adventure tri. Part 1: Reunion,1738035,0,1738035,2015.csv,2015,0.0,1.0
7404,Amsterdam Vice,1737522,0,1737522,2019.csv,2019,0.0,1.0
7405,Eep! 2010 Re-release,1737357,0,1737357,2010.csv,2010,0.0,1.0
7406,Doctor Who: Deep Breath,1736320,0,1736320,2014.csv,2014,0.0,1.0
7407,Dad 2012 Re-release,1734213,0,1734213,2012.csv,2012,0.0,1.0
7408,De Club van Sinterklaas & De Verdwenen Schoentjes,1732892,0,1732892,2015.csv,2015,0.0,1.0
7409,Kardesim Benim 2,1732579,0,1732579,2017.csv,2017,0.0,1.0
7410,The Dragon Spell,1731355,0,1731355,2016.csv,2016,0.0,1.0
7411,First Position,1730824,1014071,716753,2012.csv,2012,0.5858891487522706,0.4141108512477294
7412,A Moment of Love,1730000,0,1730000,2013.csv,2013,0.0,1.0
7413,The Moment of the Sunrise,1729565,0,1729565,2019.csv,2019,0.0,1.0
7414,Groenten uit Balen,1729514,0,1729514,2011.csv,2011,0.0,1.0
7415,Some Time Later,1729112,0,1729112,2018.csv,2018,0.0,1.0
7416,Bizim Köyün Sarkisi,1728998,0,1728998,2018.csv,2018,0.0,1.0
7417,Che vuoi che sia,1728588,0,1728588,2016.csv,2016,0.0,1.0
7418,Spunti na vode,1728483,0,1728483,2017.csv,2017,0.0,1.0
7419,After Love,1728251,13693,1714558,2016.csv,2016,0.007923038956725614,0.9920769610432744
7420,Girl Rising,1727259,1727259,0,2013.csv,2013,1.0,0.0
7421,"Re: Zero, Starting Life in Another World: OVA: Memory Snow",1725339,0,1725339,2018.csv,2018,0.0,1.0
7422,3 Türken & ein Baby,1723883,0,1723883,2015.csv,2015,0.0,1.0
7423,The Prayer,1722220,0,1722220,2018.csv,2018,0.0,1.0
7424,Once Upon a Time in the North,1721942,0,1721942,2012.csv,2012,0.0,1.0
7425,Diana Vreeland: The Eye Has to Travel,1721472,1017579,703893,2012.csv,2012,0.5911098176444345,0.40889018235556546
7426,Gekijouban anime Nintama rantarou: Ninjutsu gakuen zenin shutsudou! no dan,1721191,0,1721191,2011.csv,2011,0.0,1.0
7427,Jan Pawel II: Szukalem Was...,1720882,0,1720882,2011.csv,2011,0.0,1.0
7428,A Faithful Man,1720605,77491,1643114,2018.csv,2018,0.04503706545081527,0.9549629345491847
7429,The Red and the Blue,1720151,0,1720151,2012.csv,2012,0.0,1.0
7430,Diaz: Don't Clean Up This Blood 2012 Re-release,1720010,0,1720010,2012.csv,2012,0.0,1.0
7431,The Souvenir,1719157,1036737,682420,2019.csv,2019,0.6030496342102554,0.39695036578974463
7432,Pension complète,1717480,0,1717480,2015.csv,2015,0.0,1.0
7433,Siberian Exile,1716849,0,1716849,2013.csv,2013,0.0,1.0
7434,Weiner,1715955,1676108,39847,2016.csv,2016,0.9767785285744672,0.02322147142553272
7435,An Almost Perfect Country,1714707,0,1714707,2016.csv,2016,0.0,1.0
7436,The Garden of Sinners: Future Gospel,1713850,0,1713850,2013.csv,2013,0.0,1.0
7437,Grand Central,1713691,0,1713691,2013.csv,2013,0.0,1.0
7438,Sel8nne,1713266,0,1713266,2013.csv,2013,0.0,1.0
7439,Them Who?,1712863,0,1712863,2015.csv,2015,0.0,1.0
7440,Amongst Bees,1712607,0,1712607,2015.csv,2015,0.0,1.0
7441,Another Woman,1712086,0,1712086,2019.csv,2019,0.0,1.0
7442,Long Long Time Ago 2,1711647,0,1711647,2016.csv,2016,0.0,1.0
7443,3 Million Euros,1711435,0,1711435,2017.csv,2017,0.0,1.0
7444,A Special Lady,1710852,0,1710852,2017.csv,2017,0.0,1.0
7445,Agente Ñero Ñero 7,1709359,0,1709359,2016.csv,2016,0.0,1.0
7446,"To Joey, with Love",1709073,1709073,0,2016.csv,2016,1.0,0.0
7447,Paradise: Love,1709036,24267,1684769,2012.csv,2012,0.01419923278386178,0.9858007672161382
7448,GazGolder,1708631,0,1708631,2014.csv,2014,0.0,1.0
7449,Ne-beu-en-ding-seu-to-ri,1707723,0,1707723,2012.csv,2012,0.0,1.0
7450,Night Shift,1707184,534,1706650,2020.csv,2020,0.00031279580877046644,0.9996872041912296
7451,Ni ruo an hao,1706807,0,1706807,2017.csv,2017,0.0,1.0
7452,Our Struggles,1706329,0,1706329,2018.csv,2018,0.0,1.0
7453,"Men, Women & Children",1705908,705908,1000000,2014.csv,2014,0.4138019166332534,0.5861980833667466
7454,The Three Exclamation Marks,1705811,0,1705811,2019.csv,2019,0.0,1.0
7455,Notre Dame,1705268,0,1705268,2019.csv,2019,0.0,1.0
7456,A Spicy Kraut,1705152,0,1705152,2014.csv,2014,0.0,1.0
7457,Nobel's Last Will,1704964,0,1704964,2012.csv,2012,0.0,1.0
7458,Balas & Bolinhos: O Último Capítulo,1704467,0,1704467,2012.csv,2012,0.0,1.0
7459,The Oscar Nominated Short Films 2012: Live Action,1702415,1702415,0,2012.csv,2012,1.0,0.0
7460,Mao Zedong 1949,1701951,0,1701951,2019.csv,2019,0.0,1.0
7461,For the Good of Others,1701921,0,1701921,2010.csv,2010,0.0,1.0
7462,Distance,1701658,0,1701658,2016.csv,2016,0.0,1.0
7463,Meet the Patels,1700681,1700681,0,2015.csv,2015,1.0,0.0
7464,Seven Dinners,1700268,0,1700268,2019.csv,2019,0.0,1.0
7465,Black School Rules,1699916,0,1699916,2019.csv,2019,0.0,1.0
7466,Bécassine!,1698442,0,1698442,2018.csv,2018,0.0,1.0
7467,Josée,1697922,0,1697922,2020.csv,2020,0.0,1.0
7468,My First Wedding,1697883,0,1697883,2011.csv,2011,0.0,1.0
7469,Tekken,1697207,0,1697207,2010.csv,2010,0.0,1.0
7470,Escape Room,1696568,0,1696568,2017.csv,2017,0.0,1.0
7471,Aftermath,1696330,0,1696330,2012.csv,2012,0.0,1.0
7472,The Wild Pear Tree,1696258,34014,1662244,2018.csv,2018,0.020052374108184015,0.9799476258918159
7473,All About Eve,1696238,0,1696238,2019.csv,2019,0.0,1.0
7474,Penny's Shadow,1696199,0,1696199,2011.csv,2011,0.0,1.0
7475,Paw Patrol: Jet to the Rescue,1695576,0,1695576,2020.csv,2020,0.0,1.0
7476,Dunkirk 2017 Re-release,1695119,1695119,0,2017.csv,2017,1.0,0.0
7477,Sammen om drømmen,1695072,0,1695072,2017.csv,2017,0.0,1.0
7478,Viejos amigos,1695006,0,1695006,2014.csv,2014,0.0,1.0
7479,Maman,1694740,0,1694740,2012.csv,2012,0.0,1.0
7480,Saranae hen phi,1694232,0,1694232,2010.csv,2010,0.0,1.0
7481,Km 31-2,1693944,0,1693944,2016.csv,2016,0.0,1.0
7482,Colors in the Dark,1692948,0,1692948,2011.csv,2011,0.0,1.0
7483,Black,1692776,0,1692776,2015.csv,2015,0.0,1.0
7484,Sabea El Boromba,1692762,0,1692762,2019.csv,2019,0.0,1.0
7485,Survival Family 2018 Re-release,1692719,0,1692719,2018.csv,2018,0.0,1.0
7486,De Zevende Hemel,1691161,0,1691161,2016.csv,2016,0.0,1.0
7487,Woozle & Pip in Search of the Scallywagger!,1691144,0,1691144,2016.csv,2016,0.0,1.0
7488,Do Not Use,1691069,0,1691069,2014.csv,2014,0.0,1.0
7489,The Chrysalis,1690000,0,1690000,2013.csv,2013,0.0,1.0
7490,Three Changes,1689967,0,1689967,2017.csv,2017,0.0,1.0
7491,All Good Things 2010 Re-release,1689646,582024,1107622,2010.csv,2010,0.34446505362661767,0.6555349463733824
7492,Betibú,1687797,0,1687797,2014.csv,2014,0.0,1.0
7493,Detention,1687554,0,1687554,2019.csv,2019,0.0,1.0
7494,Slamma Jamma,1687000,1687000,0,2017.csv,2017,1.0,0.0
7495,Tim's Vermeer,1686917,1671377,15540,2014.csv,2014,0.9907879285110056,0.00921207148899442
7496,The Legacy of the Sun,1685267,0,1685267,2011.csv,2011,0.0,1.0
7497,Gekijouban Tenisu no oujisama: Eikokushiki teikyujou kessen!,1685127,0,1685127,2011.csv,2011,0.0,1.0
7498,Tomme tønner,1683895,0,1683895,2010.csv,2010,0.0,1.0
7499,Janis: Little Girl Blue,1683166,410465,1272701,2015.csv,2015,0.2438648356727738,0.7561351643272262
7500,The Bride,1682689,0,1682689,2015.csv,2015,0.0,1.0
7501,Sodak Sodak,1682279,0,1682279,2018.csv,2018,0.0,1.0
7502,Detachment,1681521,72689,1608832,2012.csv,2012,0.04322812501300906,0.9567718749869909
7503,Looking for Ioannis Varvakis,1680901,0,1680901,2012.csv,2012,0.0,1.0
7504,The Hunter,1680778,176669,1504109,2011.csv,2011,0.10511144243915616,0.8948885575608438
7505,In Between,1679952,107977,1571975,2016.csv,2016,0.06427386020552968,0.9357261397944703
7506,Sunstroke,1679843,0,1679843,2014.csv,2014,0.0,1.0
7507,The Man Behind the Courtyard House,1679389,0,1679389,2011.csv,2011,0.0,1.0
7508,Ma Dai,1679081,0,1679081,2015.csv,2015,0.0,1.0
7509,Final Portrait,1677835,461972,1215863,2017.csv,2017,0.275338158996564,0.724661841003436
7510,Bentornato presidente,1677301,0,1677301,2019.csv,2019,0.0,1.0
7511,Lourdes 2019 Re-release,1676475,0,1676475,2019.csv,2019,0.0,1.0
7512,Nothing Left to Fear,1675381,7886,1667495,2013.csv,2013,0.0047069890371205115,0.9952930109628795
7513,Bo,1675160,0,1675160,2010.csv,2010,0.0,1.0
7514,Ginger & Rosa,1674776,1012973,661803,2012.csv,2012,0.6048408861841822,0.39515911381581775
7515,Mr. Nice,1673840,0,1673840,2010.csv,2010,0.0,1.0
7516,Tia Tui La Cao Thu,1673793,0,1673793,2016.csv,2016,0.0,1.0
7517,Dormant Beauty,1673235,0,1673235,2012.csv,2012,0.0,1.0
7518,Garibaldi's Lovers,1673004,0,1673004,2012.csv,2012,0.0,1.0
7519,Equity,1672306,1605463,66843,2016.csv,2016,0.9600294443720229,0.039970555627977175
7520,A Brother's Love,1671969,539524,1132445,2019.csv,2019,0.32268780102980377,0.6773121989701962
7521,My Original Dream,1671957,0,1671957,2015.csv,2015,0.0,1.0
7522,The Perfect Ones,1671700,0,1671700,2018.csv,2018,0.0,1.0
7523,Vanishing on 7th Street,1671196,22729,1648467,2011.csv,2011,0.013600439445762197,0.9863995605542378
7524,El-Cin,1670763,0,1670763,2012.csv,2012,0.0,1.0
7525,"Kiss Him, Not Me",1669719,0,1669719,2020.csv,2020,0.0,1.0
7526,Ao: The Last Hunter,1669603,0,1669603,2010.csv,2010,0.0,1.0
7527,Unthinkable,1669100,0,1669100,2010.csv,2010,0.0,1.0
7528,How I Became Russian,1668824,0,1668824,2020.csv,2020,0.0,1.0
7529,The Last Point,1668811,0,1668811,2017.csv,2017,0.0,1.0
7530,Love and Bullets,1668753,0,1668753,2017.csv,2017,0.0,1.0
7531,The Lion Men,1668382,0,1668382,2014.csv,2014,0.0,1.0
7532,The Whole Truth,1667849,0,1667849,2016.csv,2016,0.0,1.0
7533,Chaar Sahibzaade,1667784,0,1667784,2014.csv,2014,0.0,1.0
7534,Morning Princess,1667311,0,1667311,2019.csv,2019,0.0,1.0
7535,Mantikora,1666597,0,1666597,2011.csv,2011,0.0,1.0
7536,Tirza,1666437,0,1666437,2010.csv,2010,0.0,1.0
7537,Ekspedisjon Knerten,1663530,0,1663530,2017.csv,2017,0.0,1.0
7538,The Double,1662515,200406,1462109,2014.csv,2014,0.12054387479210714,0.8794561252078928
7539,The Cartel,1662191,0,1662191,2014.csv,2014,0.0,1.0
7540,Kabi,1662082,0,1662082,2012.csv,2012,0.0,1.0
7541,Memoirs of a Teenage Amnesiac,1660886,0,1660886,2010.csv,2010,0.0,1.0
7542,Un prince (presque) charmant,1660637,0,1660637,2013.csv,2013,0.0,1.0
7543,Bread of Happiness,1659800,0,1659800,2012.csv,2012,0.0,1.0
7544,The Comedian,1659002,1659002,0,2016.csv,2016,1.0,0.0
7545,Rustom,1658594,1087419,571175,2016.csv,2016,0.6556269949125585,0.3443730050874415
7546,Perfect Nanny,1657117,0,1657117,2019.csv,2019,0.0,1.0
7547,Wrestling Queens,1656743,0,1656743,2013.csv,2013,0.0,1.0
7548,Goddess,1656399,0,1656399,2013.csv,2013,0.0,1.0
7549,Drunk Parents,1656325,0,1656325,2019.csv,2019,0.0,1.0
7550,Lost in Siberia,1656237,0,1656237,2012.csv,2012,0.0,1.0
7551,The Compassion in Between,1655606,0,1655606,2019.csv,2019,0.0,1.0
7552,Thalaivaa,1654633,0,1654633,2013.csv,2013,0.0,1.0
7553,Budapest,1654611,0,1654611,2018.csv,2018,0.0,1.0
7554,Kayamkulam Kochunni,1654495,0,1654495,2018.csv,2018,0.0,1.0
7555,Crazy Wedding 2,1654040,0,1654040,2019.csv,2019,0.0,1.0
7556,Gulu Mermaid 2,1653264,0,1653264,2017.csv,2017,0.0,1.0
7557,Ghost Rituals,1653042,0,1653042,2014.csv,2014,0.0,1.0
7558,Usted No Sabe Quien Soy Yo?,1653020,0,1653020,2016.csv,2016,0.0,1.0
7559,Deerskin,1652843,0,1652843,2019.csv,2019,0.0,1.0
7560,Rockstar,1651601,986697,664904,2011.csv,2011,0.5974185048325836,0.40258149516741637
7561,Namaste England,1649863,104156,1545707,2018.csv,2018,0.06313009019536774,0.9368699098046323
7562,Two Lives,1649260,22620,1626640,2012.csv,2012,0.013715241987315524,0.9862847580126844
7563,Elias and the Treasure of the Sea,1648328,0,1648328,2010.csv,2010,0.0,1.0
7564,Dough,1647429,1148304,499125,2016.csv,2016,0.6970279144048089,0.30297208559519107
7565,The Letters,1647416,1647416,0,2015.csv,2015,1.0,0.0
7566,Vernost,1647393,0,1647393,2019.csv,2019,0.0,1.0
7567,The Little Hours,1647175,1647175,0,2017.csv,2017,1.0,0.0
7568,Two Rabbits,1647168,0,1647168,2012.csv,2012,0.0,1.0
7569,Sunset at Chaophraya,1646962,0,1646962,2013.csv,2013,0.0,1.0
7570,The Magic Quill,1646704,0,1646704,2018.csv,2018,0.0,1.0
7571,Het geheim,1646227,0,1646227,2010.csv,2010,0.0,1.0
7572,Fatman,1646155,278378,1367777,2020.csv,2020,0.169108012307468,0.830891987692532
7573,Happy Burnout,1645234,0,1645234,2017.csv,2017,0.0,1.0
7574,Short Term 12,1645164,1013100,632064,2013.csv,2013,0.6158048680860996,0.38419513191390037
7575,The Mansion,1644818,0,1644818,2017.csv,2017,0.0,1.0
7576,Break Up 100,1644559,0,1644559,2014.csv,2014,0.0,1.0
7577,Kak poymat pero Zhar-Ptitsy,1644198,0,1644198,2013.csv,2013,0.0,1.0
7578,Kooky,1643592,0,1643592,2010.csv,2010,0.0,1.0
7579,Hotel Lux,1643414,0,1643414,2011.csv,2011,0.0,1.0
7580,No Thank You,1642615,0,1642615,2014.csv,2014,0.0,1.0
7581,Everybody's Talking About Jamie,1642412,0,1642412,2018.csv,2018,0.0,1.0
7582,A Family Man,1641235,0,1641235,2017.csv,2017,0.0,1.0
7583,The Wedding Diary,1640549,0,1640549,2012.csv,2012,0.0,1.0
7584,Tender Waves,1639927,0,1639927,2014.csv,2014,0.0,1.0
7585,Variações: Guardian Angel,1638712,0,1638712,2019.csv,2019,0.0,1.0
7586,Dream Girl,1638032,0,1638032,2019.csv,2019,0.0,1.0
7587,Klases susitikimas. Berniukai sugrizta!,1637947,0,1637947,2017.csv,2017,0.0,1.0
7588,China Salesman,1637776,0,1637776,2017.csv,2017,0.0,1.0
7589,Run Sister Run!,1636669,0,1636669,2010.csv,2010,0.0,1.0
7590,Sorry Angel,1636273,30628,1605645,2018.csv,2018,0.018718147888524713,0.9812818521114753
7591,Student of the Year 2,1635907,778566,857341,2019.csv,2019,0.47592314233021804,0.524076857669782
7592,Únos,1633936,0,1633936,2017.csv,2017,0.0,1.0
7593,Avantyuristy,1632301,0,1632301,2014.csv,2014,0.0,1.0
7594,Zombillénium,1631090,0,1631090,2017.csv,2017,0.0,1.0
7595,The Faithful,1630917,0,1630917,2018.csv,2018,0.0,1.0
7596,Mohenjo Daro,1630231,1264339,365892,2016.csv,2016,0.7755581877660283,0.22444181223397175
7597,Me Late Chocolate,1630053,0,1630053,2013.csv,2013,0.0,1.0
7598,The Grow,1630000,0,1630000,2012.csv,2012,0.0,1.0
7599,The Strange House,1630000,0,1630000,2015.csv,2015,0.0,1.0
7600,The Con-Heartist,1629745,0,1629745,2021.csv,2021,0.0,1.0
7601,Sansimi Seveyim,1629485,0,1629485,2017.csv,2017,0.0,1.0
7602,Queen of the Night,1628465,0,1628465,2013.csv,2013,0.0,1.0
7603,The Reunion,1628221,0,1628221,2011.csv,2011,0.0,1.0
7604,"National Theatre Live: One Man, Two Guvnors",1626908,0,1626908,2019.csv,2019,0.0,1.0
7605,Hoe duur was de suiker,1625240,0,1625240,2013.csv,2013,0.0,1.0
7606,Home Sweet Home,1624955,0,1624955,2019.csv,2019,0.0,1.0
7607,Perfect Days - I zeny maji sve dny,1624375,0,1624375,2011.csv,2011,0.0,1.0
7608,The Eternal Road,1622834,0,1622834,2017.csv,2017,0.0,1.0
7609,One Day,1622005,0,1622005,2018.csv,2018,0.0,1.0
7610,"My Tyrano: Together, Forever",1621569,0,1621569,2019.csv,2019,0.0,1.0
7611,Pure Devilry,1620743,0,1620743,2018.csv,2018,0.0,1.0
7612,Iris,1620708,1310678,310030,2015.csv,2015,0.8087070588903121,0.19129294110968786
7613,All You Need Is Love,1620654,0,1620654,2014.csv,2014,0.0,1.0
7614,I Still See You,1620637,1359,1619278,2018.csv,2018,0.0008385591591454472,0.9991614408408546
7615,"Maria, Leonora, Teresa",1620491,0,1620491,2014.csv,2014,0.0,1.0
7616,Utomlennye solntsem 2,1620323,0,1620323,2011.csv,2011,0.0,1.0
7617,Rammstein: Paris,1619505,0,1619505,2017.csv,2017,0.0,1.0
7618,R.I.F.,1619422,0,1619422,2011.csv,2011,0.0,1.0
7619,Secreto Matusita,1619054,0,1619054,2014.csv,2014,0.0,1.0
7620,Frits & Franky,1618520,0,1618520,2013.csv,2013,0.0,1.0
7621,Son of Sardaar,1618361,771789,846572,2012.csv,2012,0.4768954516328557,0.5231045483671443
7622,Mo Er Zhuang Yuan 3: Mo Huan Lie Che Da Mao Xian,1618159,0,1618159,2016.csv,2016,0.0,1.0
7623,Grand Piano,1618085,22555,1595530,2013.csv,2013,0.013939317155773645,0.9860606828442263
7624,Superpai,1617090,0,1617090,2015.csv,2015,0.0,1.0
7625,Just Another Pandora's Box,1616705,0,1616705,2010.csv,2010,0.0,1.0
7626,Casanova's,1616489,0,1616489,2020.csv,2020,0.0,1.0
7627,Foolish Plans,1616270,0,1616270,2016.csv,2016,0.0,1.0
7628,The Oddsockeaters,1616077,0,1616077,2016.csv,2016,0.0,1.0
7629,Marauders,1616004,0,1616004,2016.csv,2016,0.0,1.0
7630,Best Before,1614996,0,1614996,2013.csv,2013,0.0,1.0
7631,V8 - Du willst der Beste sein,1614831,0,1614831,2013.csv,2013,0.0,1.0
7632,Han Gong-ju,1614237,0,1614237,2014.csv,2014,0.0,1.0
7633,Detective Conan: Jolly Roger in the Deep Azure 2018 Re-release,1613781,0,1613781,2018.csv,2018,0.0,1.0
7634,Iron Lord,1612861,0,1612861,2010.csv,2010,0.0,1.0
7635,Batman Begins 2012 Re-release,1612434,1508658,103776,2012.csv,2012,0.9356401564343099,0.06435984356569013
7636,Qing Yan,1611944,0,1611944,2012.csv,2012,0.0,1.0
7637,Gun City,1611770,0,1611770,2018.csv,2018,0.0,1.0
7638,Singin' in the Rain 2012 Re-release,1609789,1608925,864,2012.csv,2012,0.9994632836974287,0.0005367163025713307
7639,Walk With Me,1606705,726726,879979,2017.csv,2017,0.4523082955489651,0.5476917044510349
7640,More Than Honey,1604609,79772,1524837,2012.csv,2012,0.049714291768275014,0.950285708231725
7641,We Are the Best!,1604273,180590,1423683,2013.csv,2013,0.11256812275716166,0.8874318772428383
7642,Jeokkwayi Dongcham,1603979,0,1603979,2011.csv,2011,0.0,1.0
7643,L'esprit de famille,1602914,0,1602914,2020.csv,2020,0.0,1.0
7644,Boris - Il film,1602252,0,1602252,2011.csv,2011,0.0,1.0
7645,Kolaigaran,1601618,0,1601618,2019.csv,2019,0.0,1.0
7646,Monos,1601199,406473,1194726,2019.csv,2019,0.25385539211553343,0.7461446078844666
7647,Pyatnitsa,1601041,0,1601041,2016.csv,2016,0.0,1.0
7648,Maktub,1600139,0,1600139,2011.csv,2011,0.0,1.0
7649,Que Pena Tu Vida 2016 Re-release,1599851,0,1599851,2016.csv,2016,0.0,1.0
7650,"Ron Goossens, Low Budget Stuntman",1598966,0,1598966,2017.csv,2017,0.0,1.0
7651,The Discloser,1597848,0,1597848,2018.csv,2018,0.0,1.0
7652,The Wedding Diary 2,1597734,0,1597734,2013.csv,2013,0.0,1.0
7653,Little Vampire,1597517,0,1597517,2020.csv,2020,0.0,1.0
7654,The Curse of Chopsticks,1597463,0,1597463,2016.csv,2016,0.0,1.0
7655,Crazy Mad Lover,1597269,993031,604238,2011.csv,2011,0.6217055486583662,0.37829445134163375
7656,Husband to Rent,1596777,0,1596777,2014.csv,2014,0.0,1.0
7657,The Metropolitan Opera HD Live: Verdi: Aida,1595902,1595902,0,2018.csv,2018,1.0,0.0
7658,Kalashnikov,1593464,0,1593464,2020.csv,2020,0.0,1.0
7659,Queen of the Desert,1592853,0,1592853,2015.csv,2015,0.0,1.0
7660,Bad Cat,1592506,0,1592506,2016.csv,2016,0.0,1.0
7661,Beanpole,1591621,196258,1395363,2019.csv,2019,0.12330699331059342,0.8766930066894066
7662,I Am,1591034,1591034,0,2011.csv,2011,1.0,0.0
7663,DJ Cinderella,1590843,0,1590843,2019.csv,2019,0.0,1.0
7664,Morangos com Açúcar - O Filme,1590312,0,1590312,2012.csv,2012,0.0,1.0
7665,The Accused,1589812,0,1589812,2018.csv,2018,0.0,1.0
7666,Tanks for Stalin,1589743,0,1589743,2018.csv,2018,0.0,1.0
7667,Troppo napoletano,1589621,0,1589621,2016.csv,2016,0.0,1.0
7668,The Crossing,1589212,90896,1498316,2019.csv,2019,0.05719564161357956,0.9428043583864204
7669,A Moment in Time,1588999,0,1588999,2013.csv,2013,0.0,1.0
7670,Plan B,1588246,0,1588246,2018.csv,2018,0.0,1.0
7671,The Kirishima Thing,1588242,0,1588242,2012.csv,2012,0.0,1.0
7672,Come Away,1587529,184477,1403052,2020.csv,2020,0.1162038614727668,0.8837961385272332
7673,Old Aunt,1587354,0,1587354,2016.csv,2016,0.0,1.0
7674,Ask Kirmizi,1587269,0,1587269,2013.csv,2013,0.0,1.0
7675,Dance Academy: The Movie,1586858,0,1586858,2017.csv,2017,0.0,1.0
7676,Internet: O Filme,1586793,0,1586793,2017.csv,2017,0.0,1.0
7677,Lovelace,1585583,356582,1229001,2013.csv,2013,0.22489015081518912,0.7751098491848109
7678,"Bruc, the Manhunt",1584719,0,1584719,2010.csv,2010,0.0,1.0
7679,Hasta Que La Muerte Nos Separe,1583807,0,1583807,2015.csv,2015,0.0,1.0
7680,Make Your Move,1583687,125106,1458581,2012.csv,2012,0.07899667042793178,0.9210033295720682
7681,Untangle,1583482,0,1583482,2011.csv,2011,0.0,1.0
7682,The Bay,1581252,30668,1550584,2012.csv,2012,0.019394758077776346,0.9806052419222236
7683,Lou!,1581125,287,1580838,2014.csv,2014,0.00018151632540121747,0.9998184836745988
7684,Rodencia y el Diente de la Princesa,1580303,0,1580303,2012.csv,2012,0.0,1.0
7685,Home from Home: Chronicle of a Vision,1580251,0,1580251,2013.csv,2013,0.0,1.0
7686,The Stray,1579440,1579440,0,2017.csv,2017,1.0,0.0
7687,Brother,1579248,0,1579248,2010.csv,2010,0.0,1.0
7688,Echte Wiener 2 - Die Deppat'n und die Gspritzt'n,1578791,0,1578791,2010.csv,2010,0.0,1.0
7689,The Invisible Boy: Second Generation,1576821,0,1576821,2018.csv,2018,0.0,1.0
7690,Lay the Favorite,1576687,20998,1555689,2012.csv,2012,0.013317798649953985,0.986682201350046
7691,Summertime,1576262,0,1576262,2014.csv,2014,0.0,1.0
7692,Adore,1575749,318982,1256767,2013.csv,2013,0.2024319863125409,0.7975680136874591
7693,El tamaño sí importa,1575662,0,1575662,2017.csv,2017,0.0,1.0
7694,Timeline,1575135,0,1575135,2014.csv,2014,0.0,1.0
7695,Lan Kwai Fong 2,1575101,0,1575101,2012.csv,2012,0.0,1.0
7696,Genesis: Paradise Lost,1575000,1575000,0,2017.csv,2017,1.0,0.0
7697,Teri Meri Kahaani,1574703,781196,793507,2012.csv,2012,0.49609100890771146,0.5039089910922885
7698,Loufa kai parallagi: Seirines sti steria,1573762,0,1573762,2011.csv,2011,0.0,1.0
7699,Teen Spirit,1573601,441366,1132235,2019.csv,2019,0.2804815197753433,0.7195184802246567
7700,Time of My Life,1573052,0,1573052,2012.csv,2012,0.0,1.0
7701,Big Big Man,1572519,0,1572519,2011.csv,2011,0.0,1.0
7702,All or Nothing 2017 Re-release,1572288,0,1572288,2017.csv,2017,0.0,1.0
7703,O Filme dos Espíritos,1570179,0,1570179,2011.csv,2011,0.0,1.0
7704,Como si fuera la primera vez,1569850,0,1569850,2019.csv,2019,0.0,1.0
7705,Vice,1568954,0,1568954,2014.csv,2014,0.0,1.0
7706,Il colore nascosto delle cose,1567686,0,1567686,2017.csv,2017,0.0,1.0
7707,Caesar Must Die,1567339,76908,1490431,2012.csv,2012,0.04906915479038038,0.9509308452096196
7708,GlassTiger 3,1566800,0,1566800,2010.csv,2010,0.0,1.0
7709,Road to Mars,1566627,0,1566627,2017.csv,2017,0.0,1.0
7710,Wasp Network,1566104,0,1566104,2020.csv,2020,0.0,1.0
7711,Full Strike,1565697,0,1565697,2015.csv,2015,0.0,1.0
7712,Inception 2013 Re-release,1565477,0,1565477,2013.csv,2013,0.0,1.0
7713,Stranger in My Pocket,1564969,0,1564969,2018.csv,2018,0.0,1.0
7714,Svensson Svensson ...i nöd & lust,1564932,0,1564932,2011.csv,2011,0.0,1.0
7715,Blackbird,1564866,0,1564866,2020.csv,2020,0.0,1.0
7716,"SOS, Ded Moroz, ili Vsyo sbudetsya!",1564526,0,1564526,2015.csv,2015,0.0,1.0
7717,#Iamhere,1563896,0,1563896,2020.csv,2020,0.0,1.0
7718,30 svidaniy,1563249,0,1563249,2016.csv,2016,0.0,1.0
7719,Rinco's Restaurant,1563234,0,1563234,2010.csv,2010,0.0,1.0
7720,Ölümlü Dünya,1562712,0,1562712,2018.csv,2018,0.0,1.0
7721,Soldado,1562508,0,1562508,2018.csv,2018,0.0,1.0
7722,"Bless Me, Ultima",1561962,1561962,0,2013.csv,2013,1.0,0.0
7723,Four Springs,1561731,0,1561731,2019.csv,2019,0.0,1.0
7724,Terrible Jungle,1560874,0,1560874,2020.csv,2020,0.0,1.0
7725,The Rising Hawk,1560697,0,1560697,2019.csv,2019,0.0,1.0
7726,Emma and Santa Claus: The Quest for the Elf Queen's Heart,1560250,0,1560250,2015.csv,2015,0.0,1.0
7727,Persecuted,1558836,1558836,0,2014.csv,2014,1.0,0.0
7728,No Mercy,1558387,0,1558387,2019.csv,2019,0.0,1.0
7729,Magic Journey to Africa,1557590,0,1557590,2010.csv,2010,0.0,1.0
7730,Zhaimer,1557368,0,1557368,2010.csv,2010,0.0,1.0
7731,Remember the Dream,1557311,0,1557311,2019.csv,2019,0.0,1.0
7732,Mi pequeño gran hombre,1557257,0,1557257,2018.csv,2018,0.0,1.0
7733,Ashes in the Snow,1557172,0,1557172,2018.csv,2018,0.0,1.0
7734,Karla & Jonas,1556917,0,1556917,2010.csv,2010,0.0,1.0
7735,Hot Sweet Sour,1556617,0,1556617,2017.csv,2017,0.0,1.0
7736,Fashion Chicks,1555656,0,1555656,2015.csv,2015,0.0,1.0
7737,Paranoia 2018 Re-release,1555621,0,1555621,2018.csv,2018,0.0,1.0
7738,One Second Champion,1555558,0,1555558,2021.csv,2021,0.0,1.0
7739,Jinpa,1555460,0,1555460,2019.csv,2019,0.0,1.0
7740,Mannen van Mars,1555414,0,1555414,2018.csv,2018,0.0,1.0
7741,Sono solo fantasmi,1554631,0,1554631,2019.csv,2019,0.0,1.0
7742,Realnye patsany protiv zombi,1554305,0,1554305,2020.csv,2020,0.0,1.0
7743,Revival,1554057,0,1554057,2013.csv,2013,0.0,1.0
7744,Take That: Live from the O2: Encore,1553608,0,1553608,2015.csv,2015,0.0,1.0
7745,The Kid,1553483,1508593,44890,2019.csv,2019,0.9711036425889437,0.028896357411056315
7746,Adventure Planet,1553168,0,1553168,2012.csv,2012,0.0,1.0
7747,Diary of a Drunk,1552896,0,1552896,2012.csv,2012,0.0,1.0
7748,Still Mine,1552730,1159336,393394,2013.csv,2013,0.7466436534362059,0.2533563465637941
7749,Grave Encounters 2,1552486,0,1552486,2013.csv,2013,0.0,1.0
7750,Yardie,1551163,36012,1515151,2018.csv,2018,0.0232161288014219,0.9767838711985781
7751,The Faith of Anna Waters,1551044,0,1551044,2016.csv,2016,0.0,1.0
7752,Macho,1550804,0,1550804,2016.csv,2016,0.0,1.0
7753,Vay Arkadas,1550505,0,1550505,2010.csv,2010,0.0,1.0
7754,Inference Notes,1550186,0,1550186,2017.csv,2017,0.0,1.0
7755,The Purple House,1549982,0,1549982,2011.csv,2011,0.0,1.0
7756,Defenders,1549782,0,1549782,2017.csv,2017,0.0,1.0
7757,Prince of Legend,1549118,0,1549118,2019.csv,2019,0.0,1.0
7758,Tel Aviv on Fire,1548893,506145,1042748,2019.csv,2019,0.3267785444184976,0.6732214555815024
7759,Modalità aereo,1548450,0,1548450,2019.csv,2019,0.0,1.0
7760,Mylove Lost,1548278,0,1548278,2018.csv,2018,0.0,1.0
7761,Cold in July,1547630,427418,1120212,2014.csv,2014,0.276175830140279,0.723824169859721
7762,Asal,1546838,0,1546838,2010.csv,2010,0.0,1.0
7763,Lost in the Moonlight,1546581,0,1546581,2016.csv,2016,0.0,1.0
7764,Sky Rise,1546530,0,1546530,2018.csv,2018,0.0,1.0
7765,Bicycle Boy,1546402,0,1546402,2015.csv,2015,0.0,1.0
7766,Fed Up,1546229,1538899,7330,2014.csv,2014,0.9952594344046063,0.0047405655953936966
7767,"New York, New York",1545352,92377,1452975,2016.csv,2016,0.059777319342130465,0.9402226806578695
7768,The Lords of Salem,1544989,1165882,379107,2013.csv,2013,0.7546215539398662,0.24537844606013376
7769,Monkey King Reloaded,1544916,0,1544916,2018.csv,2018,0.0,1.0
7770,Intrepido: A Lonely Hero,1544866,0,1544866,2013.csv,2013,0.0,1.0
7771,Hero,1544687,0,1544687,2016.csv,2016,0.0,1.0
7772,Kaybedenler Kulübü Yolda,1544333,0,1544333,2018.csv,2018,0.0,1.0
7773,Rampart,1543613,972512,571101,2012.csv,2012,0.6300231988199114,0.3699768011800885
7774,The Wedding Plan,1542345,1412404,129941,2016.csv,2016,0.9157510154991263,0.08424898450087367
7775,Belzebuth,1541490,0,1541490,2019.csv,2019,0.0,1.0
7776,The Chaperone,1541223,600654,940569,2019.csv,2019,0.38972556210230447,0.6102744378976955
7777,Ma première fois,1541144,0,1541144,2012.csv,2012,0.0,1.0
7778,Bulong,1541139,0,1541139,2011.csv,2011,0.0,1.0
7779,Pup Star,1540986,0,1540986,2018.csv,2018,0.0,1.0
7780,La marche,1540978,0,1540978,2013.csv,2013,0.0,1.0
7781,The Crossing,1540601,0,1540601,2020.csv,2020,0.0,1.0
7782,The Mirror,1540000,0,1540000,2015.csv,2015,0.0,1.0
7783,"Hayflower, Quiltshoe and the Rubens Brothers",1539956,0,1539956,2017.csv,2017,0.0,1.0
7784,Fatal Invitation,1539775,0,1539775,2011.csv,2011,0.0,1.0
7785,Big Fire,1539719,0,1539719,2016.csv,2016,0.0,1.0
7786,Cinar Agaci,1538316,0,1538316,2011.csv,2011,0.0,1.0
7787,Frontier,1537478,0,1537478,2018.csv,2018,0.0,1.0
7788,Desperate Ladies Act Desperately (2018),1536992,0,1536992,2018.csv,2018,0.0,1.0
7789,Four Enchanted Sisters,1535662,0,1535662,2019.csv,2019,0.0,1.0
7790,Siccin 4,1535095,0,1535095,2017.csv,2017,0.0,1.0
7791,Reaching for the Moon,1534391,45502,1488889,2013.csv,2013,0.029654762052175748,0.9703452379478242
7792,One Day,1534329,0,1534329,2017.csv,2017,0.0,1.0
7793,Love,1533874,309200,1224674,2012.csv,2012,0.2015810946661851,0.7984189053338149
7794,Triple Tap,1533527,0,1533527,2010.csv,2010,0.0,1.0
7795,The Congo Murders,1533390,0,1533390,2018.csv,2018,0.0,1.0
7796,Any Questions for Ben?,1533130,0,1533130,2012.csv,2012,0.0,1.0
7797,We Need to Talk,1531866,0,1531866,2016.csv,2016,0.0,1.0
7798,The Bullet Vanishes,1528580,117629,1410951,2012.csv,2012,0.07695311988904735,0.9230468801109526
7799,Gold,1528185,5539,1522646,2017.csv,2017,0.0036245611624247066,0.9963754388375753
7800,Sushi in Suhl,1527960,0,1527960,2012.csv,2012,0.0,1.0
7801,Certain Women,1526698,1087585,439113,2016.csv,2016,0.7123773005532201,0.28762269944677993
7802,Prilichnye lyudi,1525367,0,1525367,2015.csv,2015,0.0,1.0
7803,Pelle Politibil går i vannet,1524396,0,1524396,2010.csv,2010,0.0,1.0
7804,The Lehman Trilogy,1523766,0,1523766,2019.csv,2019,0.0,1.0
7805,Godzilla: The Planet Eater,1523168,0,1523168,2018.csv,2018,0.0,1.0
7806,Mandy,1523052,1214525,308527,2018.csv,2018,0.7974284528696328,0.20257154713036718
7807,Young Ahmed,1522606,21291,1501315,2019.csv,2019,0.013983262905833814,0.9860167370941662
7808,Paddle Pop Adventures,1522092,0,1522092,2012.csv,2012,0.0,1.0
7809,Io c'è,1521937,0,1521937,2018.csv,2018,0.0,1.0
7810,Moron 5 and the Crying Lady,1521892,0,1521892,2012.csv,2012,0.0,1.0
7811,Shaadi Ke Side Effects,1521778,921277,600501,2014.csv,2014,0.605395136478514,0.39460486352148605
7812,Magical Nights,1520738,0,1520738,2018.csv,2018,0.0,1.0
7813,Princess Mononoke 2018 Re-release,1519321,1423877,95444,2018.csv,2018,0.9371798323066686,0.06282016769333143
7814,Sone'a Fee Misr,1518663,0,1518663,2014.csv,2014,0.0,1.0
7815,Everyday Heroes,1517093,0,1517093,2017.csv,2017,0.0,1.0
7816,Love Julinsee,1515707,0,1515707,2011.csv,2011,0.0,1.0
7817,I babysitter,1515576,0,1515576,2016.csv,2016,0.0,1.0
7818,La Dream Team,1515000,0,1515000,2016.csv,2016,0.0,1.0
7819,Divórcio,1514777,0,1514777,2017.csv,2017,0.0,1.0
7820,Due West: Our Sex Journey,1514472,0,1514472,2012.csv,2012,0.0,1.0
7821,Black Venus,1514245,0,1514245,2010.csv,2010,0.0,1.0
7822,His Mother's Eyes,1513304,0,1513304,2011.csv,2011,0.0,1.0
7823,The Dark Knight 2012 Re-release,1513086,1513086,0,2012.csv,2012,1.0,0.0
7824,Norm of the North: King Sized Adventure,1512968,0,1512968,2019.csv,2019,0.0,1.0
7825,The Confession,1512860,0,1512860,2016.csv,2016,0.0,1.0
7826,"Rock, Paper, Scissors",1511190,0,1511190,2012.csv,2012,0.0,1.0
7827,Miles from Anywhere,1510719,0,1510719,2012.csv,2012,0.0,1.0
7828,Siccin,1510589,0,1510589,2014.csv,2014,0.0,1.0
7829,Hartenstrijd,1510128,0,1510128,2016.csv,2016,0.0,1.0
7830,Kaala,1509872,0,1509872,2018.csv,2018,0.0,1.0
7831,My Golden Days,1509773,269144,1240629,2015.csv,2015,0.17826785881056292,0.821732141189437
7832,Dum Maaro Dum,1508912,564489,944423,2011.csv,2011,0.3741033274306255,0.6258966725693745
7833,Midnight Diner,1507352,0,1507352,2015.csv,2015,0.0,1.0
7834,The Scapegoat,1507325,0,1507325,2013.csv,2013,0.0,1.0
7835,Dumas,1507205,0,1507205,2010.csv,2010,0.0,1.0
7836,The Daughter,1505434,26376,1479058,2016.csv,2016,0.01752052896374069,0.9824794710362593
7837,A Tibetan Love Song,1504560,0,1504560,2010.csv,2010,0.0,1.0
7838,Misfit 2,1504342,0,1504342,2019.csv,2019,0.0,1.0
7839,Smuggler,1502434,0,1502434,2011.csv,2011,0.0,1.0
7840,Brugklas: De Tijd van m'n Leven,1502420,0,1502420,2019.csv,2019,0.0,1.0
7841,The Kings of Summer,1501595,1315590,186005,2013.csv,2013,0.8761283834855603,0.12387161651443965
7842,Casper and Emma Go Hiking,1500890,0,1500890,2017.csv,2017,0.0,1.0
7843,Dedictví aneb Kurvaseneríká,1500786,0,1500786,2014.csv,2014,0.0,1.0
7844,Une nuit,1500409,0,1500409,2012.csv,2012,0.0,1.0
7845,Priceless,1499605,1499605,0,2016.csv,2016,1.0,0.0
7846,Sione's 2: Unfinished Business,1498227,0,1498227,2012.csv,2012,0.0,1.0
7847,Azotes De Barrio,1498137,0,1498137,2013.csv,2013,0.0,1.0
7848,Knerten og sjøormen,1496735,0,1496735,2020.csv,2020,0.0,1.0
7849,Persona 3 the Movie: #2 Midsummer Knight's Dream,1496692,0,1496692,2014.csv,2014,0.0,1.0
7850,The Swordsman,1495125,0,1495125,2020.csv,2020,0.0,1.0
7851,Battle of Tortoise and Rabbit,1494779,0,1494779,2018.csv,2018,0.0,1.0
7852,Moka,1493067,129547,1363520,2016.csv,2016,0.0867656977215356,0.9132343022784644
7853,Violette,1492884,0,1492884,2013.csv,2013,0.0,1.0
7854,The Artist and the Model,1492780,127958,1364822,2012.csv,2012,0.08571792226583957,0.9142820777341605
7855,Yeonaeui mat,1492463,0,1492463,2015.csv,2015,0.0,1.0
7856,A One-Way Trip to Antibes,1491653,0,1491653,2011.csv,2011,0.0,1.0
7857,Sint & Diego en de Magische Bron van Myra,1491436,0,1491436,2012.csv,2012,0.0,1.0
7858,A Chinese Odyssey: Part One - Pandora's Box 2014 Re-release,1491271,0,1491271,2014.csv,2014,0.0,1.0
7859,Summer Camp,1490748,0,1490748,2016.csv,2016,0.0,1.0
7860,Klub schastya,1490155,0,1490155,2010.csv,2010,0.0,1.0
7861,Ulterior Motive,1490000,0,1490000,2015.csv,2015,0.0,1.0
7862,Mully,1489771,1489771,0,2017.csv,2017,1.0,0.0
7863,Mama,1489634,0,1489634,2011.csv,2011,0.0,1.0
7864,5Gang,1489573,0,1489573,2019.csv,2019,0.0,1.0
7865,¿Para qué sirve un oso?,1489553,0,1489553,2011.csv,2011,0.0,1.0
7866,Must Be... Love,1489456,0,1489456,2013.csv,2013,0.0,1.0
7867,Haunter,1489366,0,1489366,2013.csv,2013,0.0,1.0
7868,Fachon Models,1489112,0,1489112,2014.csv,2014,0.0,1.0
7869,Magical Girl Lyrical Nanoha: Reflection,1488577,0,1488577,2017.csv,2017,0.0,1.0
7870,The Fierce Wife Final Episode,1488558,0,1488558,2012.csv,2012,0.0,1.0
7871,A Chair on the Plains,1488461,0,1488461,2013.csv,2013,0.0,1.0
7872,Labyrinth,1486738,0,1486738,2011.csv,2011,0.0,1.0
7873,Dream Flight,1486675,0,1486675,2014.csv,2014,0.0,1.0
7874,Veinteañera: Divorciada y Fantástica,1486553,0,1486553,2020.csv,2020,0.0,1.0
7875,Lilly's Bewitched Christmas,1485785,0,1485785,2017.csv,2017,0.0,1.0
7876,Pumpuang,1485095,0,1485095,2011.csv,2011,0.0,1.0
7877,High Rise Life - The Movie,1484924,0,1484924,2012.csv,2012,0.0,1.0
7878,Singam,1484464,0,1484464,2010.csv,2010,0.0,1.0
7879,Chemo,1484357,0,1484357,2015.csv,2015,0.0,1.0
7880,My Pet Dinosaur,1483677,0,1483677,2017.csv,2017,0.0,1.0
7881,No lo llames amor... llámalo X,1482812,0,1482812,2011.csv,2011,0.0,1.0
7882,Ujda Chaman,1482728,0,1482728,2019.csv,2019,0.0,1.0
7883,Patti Cake$,1482356,800148,682208,2017.csv,2017,0.5397812671180202,0.4602187328819798
7884,Out Stealing Horses,1480790,0,1480790,2019.csv,2019,0.0,1.0
7885,Qui m'aime me suive!,1480725,0,1480725,2019.csv,2019,0.0,1.0
7886,Miss Bala,1479964,0,1479964,2011.csv,2011,0.0,1.0
7887,Dance Dance Dragon,1479052,0,1479052,2012.csv,2012,0.0,1.0
7888,Zettl,1478340,0,1478340,2012.csv,2012,0.0,1.0
7889,Oasis: Supersonic,1478119,242867,1235252,2016.csv,2016,0.16430815110285438,0.8356918488971457
7890,4.3.2.1.,1477582,0,1477582,2010.csv,2010,0.0,1.0
7891,Body Language,1477155,0,1477155,2011.csv,2011,0.0,1.0
7892,This Is Me,1477105,0,1477105,2015.csv,2015,0.0,1.0
7893,Alibaba Three Blondes,1476950,0,1476950,2018.csv,2018,0.0,1.0
7894,Leatherface,1476843,0,1476843,2017.csv,2017,0.0,1.0
7895,The Metropolitan Opera HD Live: Puccini: Madama Butterfly,1476435,0,1476435,2019.csv,2019,0.0,1.0
7896,Ari no mama de itai,1476215,0,1476215,2015.csv,2015,0.0,1.0
7897,Tenshi ni I'm Fine,1475956,0,1475956,2016.csv,2016,0.0,1.0
7898,Gut zu Vögeln,1475550,0,1475550,2016.csv,2016,0.0,1.0
7899,El mundo es suyo,1475452,0,1475452,2018.csv,2018,0.0,1.0
7900,Stan Helsing,1475003,0,1475003,2010.csv,2010,0.0,1.0
7901,The Miseducation of Cameron Post,1474577,904703,569874,2018.csv,2018,0.613533915149904,0.386466084850096
7902,Good Kill,1474471,316472,1157999,2015.csv,2015,0.21463426544163974,0.7853657345583602
7903,Freeheld,1474471,573335,901136,2015.csv,2015,0.3888411504871917,0.6111588495128083
7904,Vehicle 19,1473445,0,1473445,2013.csv,2013,0.0,1.0
7905,Mausam,1473341,728316,745025,2011.csv,2011,0.4943295543937215,0.5056704456062785
7906,Taina Princess,1473290,0,1473290,2014.csv,2014,0.0,1.0
7907,De De Pyaar De,1473116,425934,1047182,2019.csv,2019,0.28913812625753843,0.7108618737424616
7908,Hidden 3D,1472872,0,1472872,2011.csv,2011,0.0,1.0
7909,Final Score,1472770,0,1472770,2018.csv,2018,0.0,1.0
7910,A Pigeon Sat on a Branch Reflecting on Existence,1472431,222989,1249442,2014.csv,2014,0.15144275011868127,0.8485572498813188
7911,Gene Waltz,1471596,0,1471596,2011.csv,2011,0.0,1.0
7912,Wish You Were Here,1471571,0,1471571,2012.csv,2012,0.0,1.0
7913,Coming In,1470932,0,1470932,2014.csv,2014,0.0,1.0
7914,Jimmy P: Psychotherapy Of A Plains Indian,1470582,30283,1440299,2013.csv,2013,0.020592527312315805,0.9794074726876842
7915,Messengers 2: The Scarecrow,1470299,0,1470299,2010.csv,2010,0.0,1.0
7916,Fantastic Return to Oz,1469171,0,1469171,2019.csv,2019,0.0,1.0
7917,Trùm Co,1469074,0,1469074,2015.csv,2015,0.0,1.0
7918,Yurigokoro,1468983,0,1468983,2017.csv,2017,0.0,1.0
7919,St. Agatha,1468454,0,1468454,2018.csv,2018,0.0,1.0
7920,Sabit Kanca,1468033,0,1468033,2013.csv,2013,0.0,1.0
7921,Glukhar v kino,1467643,0,1467643,2010.csv,2010,0.0,1.0
7922,Ahwak,1466491,0,1466491,2015.csv,2015,0.0,1.0
7923,Violeta Went to Heaven,1466032,21496,1444536,2011.csv,2011,0.014662708590262696,0.9853372914097374
7924,The Endless Trench,1465965,0,1465965,2019.csv,2019,0.0,1.0
7925,Versus,1465048,0,1465048,2016.csv,2016,0.0,1.0
7926,Thelma,1463727,147391,1316336,2017.csv,2017,0.10069568983833733,0.8993043101616627
7927,Jungle,1463441,0,1463441,2012.csv,2012,0.0,1.0
7928,Our Departures,1461487,0,1461487,2018.csv,2018,0.0,1.0
7929,The Money,1460493,0,1460493,2019.csv,2019,0.0,1.0
7930,Greed,1460431,355308,1105123,2020.csv,2020,0.24328982334666957,0.7567101766533304
7931,Synchronic,1460112,636673,823439,2020.csv,2020,0.4360439473136307,0.5639560526863693
7932,Tale of the Rally,1460000,0,1460000,2014.csv,2014,0.0,1.0
7933,Monster Mayhem,1459015,0,1459015,2017.csv,2017,0.0,1.0
7934,The Lunnis and the Great Fairy Tales Adventure,1458051,0,1458051,2019.csv,2019,0.0,1.0
7935,Barmen,1457685,0,1457685,2015.csv,2015,0.0,1.0
7936,Arbut,1457610,0,1457610,2015.csv,2015,0.0,1.0
7937,Bara to samurai,1457535,0,1457535,2011.csv,2011,0.0,1.0
7938,Life of Crime,1456675,265452,1191223,2014.csv,2014,0.1822314517651501,0.8177685482348499
7939,La La Land 2020 Re-release,1456649,0,1456649,2021.csv,2021,0.0,1.0
7940,Frog Prince Adventures,1456558,0,1456558,2019.csv,2019,0.0,1.0
7941,You Shall Not Sleep,1456151,0,1456151,2018.csv,2018,0.0,1.0
7942,Okan no yomeiri,1455939,0,1455939,2010.csv,2010,0.0,1.0
7943,National Theatre Live: All My Sons,1455301,0,1455301,2019.csv,2019,0.0,1.0
7944,Scribe,1455120,0,1455120,2017.csv,2017,0.0,1.0
7945,The Treatment,1454682,0,1454682,2014.csv,2014,0.0,1.0
7946,The First Beautiful Thing 2011 Re-release,1453513,0,1453513,2011.csv,2011,0.0,1.0
7947,Père fils thérapie!,1453270,0,1453270,2016.csv,2016,0.0,1.0
7948,Huat Ah! Huat Ah! Huat!,1452325,0,1452325,2014.csv,2014,0.0,1.0
7949,Olur Olur,1452157,0,1452157,2014.csv,2014,0.0,1.0
7950,Her Sey Asktan,1452072,0,1452072,2016.csv,2016,0.0,1.0
7951,Chasing Great,1452039,0,1452039,2016.csv,2016,0.0,1.0
7952,Extinction,1451864,0,1451864,2020.csv,2020,0.0,1.0
7953,The Firemen,1451496,0,1451496,2017.csv,2017,0.0,1.0
7954,The Other Woman,1451343,25423,1425920,2010.csv,2010,0.017516879193960354,0.9824831208060396
7955,L'ex de ma vie,1451330,0,1451330,2014.csv,2014,0.0,1.0
7956,Khelein Hum Jee Jaan Sey,1450514,0,1450514,2010.csv,2010,0.0,1.0
7957,Konwój,1450486,0,1450486,2017.csv,2017,0.0,1.0
7958,Trio - Jakten på Olavsskrinet,1450201,0,1450201,2017.csv,2017,0.0,1.0
7959,Problemos,1450028,0,1450028,2017.csv,2017,0.0,1.0
7960,Ethics with Anger,1449039,0,1449039,2013.csv,2013,0.0,1.0
7961,Wild Mountain Thyme,1448931,213440,1235491,2020.csv,2020,0.1473086019969205,0.8526913980030795
7962,The Disappearance of Eleanor Rigby: Them,1448076,587774,860302,2014.csv,2014,0.4058999665763399,0.5941000334236601
7963,Bala,1447766,0,1447766,2019.csv,2019,0.0,1.0
7964,Karak,1445461,0,1445461,2011.csv,2011,0.0,1.0
7965,The Summer House,1445460,0,1445460,2019.csv,2019,0.0,1.0
7966,4N1K,1444474,0,1444474,2017.csv,2017,0.0,1.0
7967,The City of Your Final Destination,1444401,493296,951105,2010.csv,2010,0.34152288734222697,0.658477112657773
7968,12 mesyatsev,1444235,0,1444235,2013.csv,2013,0.0,1.0
7969,Special Encounter,1443658,0,1443658,2017.csv,2017,0.0,1.0
7970,Besharam,1443479,679866,763613,2013.csv,2013,0.4709912648538704,0.5290087351461296
7971,Wolf,1442653,0,1442653,2018.csv,2018,0.0,1.0
7972,The Dawn Wall 2018 Re-release,1442013,970032,471981,2018.csv,2018,0.6726929646265325,0.3273070353734675
7973,Why Cheat India,1441893,0,1441893,2019.csv,2019,0.0,1.0
7974,Ainoat oikeat,1441699,0,1441699,2013.csv,2013,0.0,1.0
7975,The Cornered Mouse Dreams of Cheese,1441478,0,1441478,2020.csv,2020,0.0,1.0
7976,Gangsterboys,1441099,0,1441099,2010.csv,2010,0.0,1.0
7977,Soccer Killer,1440968,0,1440968,2017.csv,2017,0.0,1.0
7978,Alfie Atkins,1440284,0,1440284,2013.csv,2013,0.0,1.0
7979,Lighting Dindin,1440189,0,1440189,2017.csv,2017,0.0,1.0
7980,Muhammad: The Messenger of God,1440044,0,1440044,2016.csv,2016,0.0,1.0
7981,Vox Lux,1439539,727119,712420,2018.csv,2018,0.5051054538987829,0.49489454610121714
7982,Nordvest,1438385,0,1438385,2013.csv,2013,0.0,1.0
7983,Sons of Norway,1437987,0,1437987,2011.csv,2011,0.0,1.0
7984,Out of the Dark,1437650,0,1437650,2015.csv,2015,0.0,1.0
7985,Tomboy,1437501,129834,1307667,2011.csv,2011,0.09031924151704938,0.9096807584829506
7986,13 Semester,1437224,0,1437224,2010.csv,2010,0.0,1.0
7987,In Your Eyes,1436836,0,1436836,2010.csv,2010,0.0,1.0
7988,My Friend Dahmer,1436751,1361611,75140,2017.csv,2017,0.947701445831602,0.052298554168398
7989,Restrepo,1436391,1330894,105497,2010.csv,2010,0.9265541207094725,0.07344587929052744
7990,Spiral,1436158,0,1436158,2014.csv,2014,0.0,1.0
7991,Life Feels Good,1436077,0,1436077,2013.csv,2013,0.0,1.0
7992,Kai Po Che,1435272,1122527,312745,2013.csv,2013,0.7821005356475985,0.21789946435240148
7993,Perfect Foreign,1434809,0,1434809,2016.csv,2016,0.0,1.0
7994,Brother of the Year,1434355,0,1434355,2018.csv,2018,0.0,1.0
7995,Arrhythmia,1433366,0,1433366,2017.csv,2017,0.0,1.0
7996,The Operative,1431904,0,1431904,2019.csv,2019,0.0,1.0
7997,Chef,1431593,0,1431593,2017.csv,2017,0.0,1.0
7998,Born to Be Wild: The Graduation Trip,1431283,0,1431283,2018.csv,2018,0.0,1.0
7999,Taxi to Treasure Rock,1431052,0,1431052,2019.csv,2019,0.0,1.0
8000,Zero 2018 Re-release,1430734,0,1430734,2018.csv,2018,0.0,1.0
8001,I am NeZha,1430427,0,1430427,2016.csv,2016,0.0,1.0
8002,The Ideal,1429162,0,1429162,2016.csv,2016,0.0,1.0
8003,The Dazzled,1428582,0,1428582,2019.csv,2019,0.0,1.0
8004,The Devil's Hand,1428494,5746,1422748,2014.csv,2014,0.004022418015056416,0.9959775819849436
8005,The Zero Theorem,1428362,257706,1170656,2014.csv,2014,0.18042064966724122,0.8195793503327587
8006,Time Trip App,1427256,0,1427256,2014.csv,2014,0.0,1.0
8007,Regresa,1427256,0,1427256,2010.csv,2010,0.0,1.0
8008,Tattah,1427136,0,1427136,2013.csv,2013,0.0,1.0
8009,Eternal Wave,1427082,0,1427082,2017.csv,2017,0.0,1.0
8010,Baby Bump(s),1426900,0,1426900,2017.csv,2017,0.0,1.0
8011,Temptation Island,1426751,0,1426751,2011.csv,2011,0.0,1.0
8012,La vida inesperada,1426349,0,1426349,2014.csv,2014,0.0,1.0
8013,Palm Springs,1425774,164000,1261774,2020.csv,2020,0.1150252424297259,0.8849747575702741
8014,BÚÉK,1425325,0,1425325,2018.csv,2018,0.0,1.0
8015,Torneranno i prati,1424898,0,1424898,2014.csv,2014,0.0,1.0
8016,Brothers,1424520,0,1424520,2016.csv,2016,0.0,1.0
8017,My First Client,1424100,0,1424100,2019.csv,2019,0.0,1.0
8018,Touch of the Light,1423127,0,1423127,2013.csv,2013,0.0,1.0
8019,Reborn,1422565,0,1422565,2018.csv,2018,0.0,1.0
8020,Ay Lav Yu,1422457,0,1422457,2010.csv,2010,0.0,1.0
8021,Sokrovishcha O.K.,1421842,0,1421842,2013.csv,2013,0.0,1.0
8022,Kommissarie Späck,1421333,0,1421333,2010.csv,2010,0.0,1.0
8023,Yellow Rose,1420636,0,1420636,2019.csv,2019,0.0,1.0
8024,Fairy Tail: Dragon Cry,1420035,519461,900574,2017.csv,2017,0.3658085892249135,0.6341914107750866
8025,Nam-gwa yeo,1419313,0,1419313,2016.csv,2016,0.0,1.0
8026,Gek van Geluk,1418659,0,1418659,2017.csv,2017,0.0,1.0
8027,All or Nothing 2018 Re-release,1418457,0,1418457,2018.csv,2018,0.0,1.0
8028,Torno indietro e cambio vita,1418274,0,1418274,2015.csv,2015,0.0,1.0
8029,The Valdemar Legacy,1417882,0,1417882,2010.csv,2010,0.0,1.0
8030,Discount,1417767,0,1417767,2015.csv,2015,0.0,1.0
8031,Possessions,1417706,0,1417706,2011.csv,2011,0.0,1.0
8032,Fly Away,1417455,0,1417455,2012.csv,2012,0.0,1.0
8033,The Priest's Children,1417453,0,1417453,2013.csv,2013,0.0,1.0
8034,The Monitor,1417397,0,1417397,2011.csv,2011,0.0,1.0
8035,Sometimes Always Never,1417047,39191,1377856,2018.csv,2018,0.027656810254000044,0.972343189746
8036,Black Butterflies,1416573,0,1416573,2011.csv,2011,0.0,1.0
8037,Good Luck Algeria,1416050,0,1416050,2016.csv,2016,0.0,1.0
8038,Chal Mera Putt,1415786,0,1415786,2019.csv,2019,0.0,1.0
8039,Cumali Ceber,1415773,0,1415773,2017.csv,2017,0.0,1.0
8040,Mist & the Maiden,1415750,0,1415750,2017.csv,2017,0.0,1.0
8041,It 2019 Re-release,1414696,1347126,67570,2019.csv,2019,0.9522370883921352,0.04776291160786487
8042,Superstar,1414522,0,1414522,2012.csv,2012,0.0,1.0
8043,Tales of an Immoral Couple,1414463,0,1414463,2016.csv,2016,0.0,1.0
8044,The Wolfpack,1414140,1301696,112444,2015.csv,2015,0.9204859490573777,0.07951405094262237
8045,Romancing in Thin Air,1414049,0,1414049,2012.csv,2012,0.0,1.0
8046,Eeswaran,1413760,0,1413760,2021.csv,2021,0.0,1.0
8047,Yakiniku Dragon,1412942,0,1412942,2018.csv,2018,0.0,1.0
8048,Parkland,1412181,653651,758530,2013.csv,2013,0.4628663039652849,0.5371336960347151
8049,Türkler Geliyor: Adaletin Kilici,1412062,0,1412062,2020.csv,2020,0.0,1.0
8050,The Lady Terrorist,1411402,0,1411402,2019.csv,2019,0.0,1.0
8051,"Idainaru, Shurarabon",1410949,0,1410949,2014.csv,2014,0.0,1.0
8052,Cosmoball,1409892,0,1409892,2020.csv,2020,0.0,1.0
8053,Women at the Peak,1408985,0,1408985,2019.csv,2019,0.0,1.0
8054,Animal,1408623,0,1408623,2018.csv,2018,0.0,1.0
8055,Pataakha,1407588,0,1407588,2018.csv,2018,0.0,1.0
8056,New Order,1406926,0,1406926,2020.csv,2020,0.0,1.0
8057,Legiony,1406771,0,1406771,2019.csv,2019,0.0,1.0
8058,Lazer Team,1406538,1186426,220112,2016.csv,2016,0.8435079606807637,0.1564920393192363
8059,Just a Sigh,1406331,75531,1330800,2013.csv,2013,0.053707839761763056,0.9462921602382369
8060,Those Were the Days,1406102,0,1406102,2014.csv,2014,0.0,1.0
8061,El Chicano,1404646,1400603,4043,2019.csv,2019,0.9971216947188117,0.002878305281188285
8062,Haider,1404307,1048143,356164,2014.csv,2014,0.7463773946864894,0.2536226053135105
8063,Bling,1404291,0,1404291,2016.csv,2016,0.0,1.0
8064,Lara,1402471,0,1402471,2019.csv,2019,0.0,1.0
8065,Universal Soldier: Day of Reckoning,1402307,5460,1396847,2012.csv,2012,0.0038935839299097845,0.9961064160700902
8066,Saheb Biwi Aur Gangster 3,1401894,0,1401894,2018.csv,2018,0.0,1.0
8067,Bir Ask Iki Hayat,1401422,0,1401422,2019.csv,2019,0.0,1.0
8068,Born to Be Blue 2016 Re-release,1401411,678203,723208,2016.csv,2016,0.4839429689077651,0.5160570310922349
8069,Rzhev,1401156,0,1401156,2019.csv,2019,0.0,1.0
8070,L'amour flou,1399479,0,1399479,2018.csv,2018,0.0,1.0
8071,Turning Point 2,1399257,0,1399257,2011.csv,2011,0.0,1.0
8072,Pale Moon,1399222,0,1399222,2014.csv,2014,0.0,1.0
8073,Late Bloomers,1399101,0,1399101,2011.csv,2011,0.0,1.0
8074,Nang 3: Loi Hua Cua Cha,1398976,0,1398976,2020.csv,2020,0.0,1.0
8075,The Tenants,1398352,0,1398352,2018.csv,2018,0.0,1.0
8076,Leonie,1397773,0,1397773,2010.csv,2010,0.0,1.0
8077,Finalmente sposi,1397645,0,1397645,2018.csv,2018,0.0,1.0
8078,For Sama,1397546,43796,1353750,2019.csv,2019,0.03133778780805784,0.9686622121919422
8079,On My Dead Body,1397103,0,1397103,2013.csv,2013,0.0,1.0
8080,My Wife Is 18 2012 Re-release,1396860,0,1396860,2012.csv,2012,0.0,1.0
8081,The Distance Between Me and Me,1395871,0,1395871,2019.csv,2019,0.0,1.0
8082,Superagente Makey,1395217,0,1395217,2020.csv,2020,0.0,1.0
8083,Shodô Girls!!,1394986,0,1394986,2010.csv,2010,0.0,1.0
8084,Maggie,1394052,187112,1206940,2015.csv,2015,0.1342216789617604,0.8657783210382396
8085,Call Center Girl,1393773,0,1393773,2013.csv,2013,0.0,1.0
8086,Pats Sau Milijonierius,1393328,0,1393328,2019.csv,2019,0.0,1.0
8087,Brother in Love,1393085,0,1393085,2019.csv,2019,0.0,1.0
8088,Light of My Life,1392898,20056,1372842,2019.csv,2019,0.014398757123637194,0.9856012428763629
8089,Yohan - Barnevandrer,1392847,0,1392847,2010.csv,2010,0.0,1.0
8090,White Material,1392434,304020,1088414,2010.csv,2010,0.21833709892174422,0.7816629010782558
8091,No et moi,1391946,0,1391946,2010.csv,2010,0.0,1.0
8092,You're Killing Me Susana,1391292,0,1391292,2016.csv,2016,0.0,1.0
8093,Wednesday Disappears,1390871,0,1390871,2020.csv,2020,0.0,1.0
8094,Plop wordt kabouterkoning,1390262,0,1390262,2012.csv,2012,0.0,1.0
8095,Made in China,1390229,0,1390229,2019.csv,2019,0.0,1.0
8096,Holiday: A Soldier is Never Off Duty,1390054,706893,683161,2014.csv,2014,0.5085363590191461,0.491463640980854
8097,Itinéraire bis,1389978,0,1389978,2011.csv,2011,0.0,1.0
8098,Poh Tak,1389571,0,1389571,2010.csv,2010,0.0,1.0
8099,Journey to the Christmas Star 2013 Re-release,1388423,0,1388423,2013.csv,2013,0.0,1.0
8100,Crô em Família,1388359,0,1388359,2018.csv,2018,0.0,1.0
8101,Puli,1387272,0,1387272,2015.csv,2015,0.0,1.0
8102,Housos vs. Authority,1386692,0,1386692,2012.csv,2012,0.0,1.0
8103,Till My Heartaches End,1386444,0,1386444,2010.csv,2010,0.0,1.0
8104,"Oslo, August 31st",1386378,101475,1284903,2011.csv,2011,0.07319432362602407,0.9268056763739759
8105,"For a Good Time, Call...",1386088,1251749,134339,2012.csv,2012,0.9030804681953816,0.09691953180461847
8106,"My Granpa, the Bankrobber",1385970,0,1385970,2011.csv,2011,0.0,1.0
8107,The Billionaire,1385882,0,1385882,2011.csv,2011,0.0,1.0
8108,Alien 2019 Re-release,1385671,833658,552013,2014.csv,2014,0.6016276590907943,0.3983723409092057
8109,National Lampoon's Christmas Vacation 2019 Re-release,1385620,1385620,0,2019.csv,2019,1.0,0.0
8110,Dou Kyu Sei: Classmates,1385351,0,1385351,2016.csv,2016,0.0,1.0
8111,The Tunnel,1385270,0,1385270,2017.csv,2017,0.0,1.0
8112,House of Tolerance,1384443,19327,1365116,2011.csv,2011,0.013960126924691013,0.9860398730753089
8113,Parched,1384433,0,1384433,2016.csv,2016,0.0,1.0
8114,Chi m'ha visto,1384070,0,1384070,2017.csv,2017,0.0,1.0
8115,Saint Maud,1383868,0,1383868,2020.csv,2020,0.0,1.0
8116,Ctyrlístek ve sluzbách krále,1383366,0,1383366,2013.csv,2013,0.0,1.0
8117,"Nu, zdravstvuy, Oksana Sokolova!",1383204,0,1383204,2018.csv,2018,0.0,1.0
8118,A Dynamite Family,1382282,0,1382282,2014.csv,2014,0.0,1.0
8119,Max und die wilde 7,1382005,0,1382005,2020.csv,2020,0.0,1.0
8120,Honey,1381730,0,1381730,2010.csv,2010,0.0,1.0
8121,Death Ouija,1380000,0,1380000,2014.csv,2014,0.0,1.0
8122,Voyagers,1379988,1379988,0,2021.csv,2021,1.0,0.0
8123,100% Coco,1379738,0,1379738,2017.csv,2017,0.0,1.0
8124,Stick Man,1378503,0,1378503,2016.csv,2016,0.0,1.0
8125,Can You Keep a Secret?,1378160,0,1378160,2019.csv,2019,0.0,1.0
8126,Swimming with Men,1377748,24708,1353040,2018.csv,2018,0.0179336134039026,0.9820663865960974
8127,Ma ma,1375709,47258,1328451,2015.csv,2015,0.03435174153836313,0.9656482584616368
8128,Barbie: Spy Squad,1375679,0,1375679,2015.csv,2015,0.0,1.0
8129,Khoobsurat,1375623,710508,665115,2014.csv,2014,0.5164990698759762,0.4835009301240238
8130,Les invincibles,1375474,0,1375474,2013.csv,2013,0.0,1.0
8131,Made in China,1374609,0,1374609,2014.csv,2014,0.0,1.0
8132,Idol,1374225,0,1374225,2019.csv,2019,0.0,1.0
8133,Pas très normales activités,1374020,0,1374020,2013.csv,2013,0.0,1.0
8134,Josep,1373465,0,1373465,2020.csv,2020,0.0,1.0
8135,Mankatha,1373444,0,1373444,2011.csv,2011,0.0,1.0
8136,Lessons of a Dream,1373312,0,1373312,2011.csv,2011,0.0,1.0
8137,Almost Che,1371808,0,1371808,2012.csv,2012,0.0,1.0
8138,Miffy the Movie,1371484,0,1371484,2013.csv,2013,0.0,1.0
8139,Running to the Spring,1371255,0,1371255,2018.csv,2018,0.0,1.0
8140,What Is Love?,1371101,0,1371101,2019.csv,2019,0.0,1.0
8141,Stefan Zweig: Farewell to Europe,1370772,78372,1292400,2016.csv,2016,0.057173621871470966,0.942826378128529
8142,Max Pinlig 2 - sidste skrig,1370187,0,1370187,2011.csv,2011,0.0,1.0
8143,Yuma,1369780,0,1369780,2012.csv,2012,0.0,1.0
8144,Edge of Innocence,1369687,0,1369687,2017.csv,2017,0.0,1.0
8145,Sacro Gra,1369486,0,1369486,2013.csv,2013,0.0,1.0
8146,A Good Old Fashioned Orgy,1369485,200227,1169258,2011.csv,2011,0.14620605556103206,0.8537939444389679
8147,I Wake Up Yesterday,1368712,0,1368712,2012.csv,2012,0.0,1.0
8148,The Jewel,1368586,0,1368586,2011.csv,2011,0.0,1.0
8149,Smoorverliefd,1368490,0,1368490,2010.csv,2010,0.0,1.0
8150,Mutiny of the Worker Bees,1368432,0,1368432,2020.csv,2020,0.0,1.0
8151,An Almost Ordinary Summer,1368198,0,1368198,2019.csv,2019,0.0,1.0
8152,(Girl)Friend,1368056,0,1368056,2018.csv,2018,0.0,1.0
8153,Five Minutes to Tomorrow,1368015,0,1368015,2014.csv,2014,0.0,1.0
8154,"Trenk, the Little Knight",1367928,0,1367928,2015.csv,2015,0.0,1.0
8155,A Second Childhood,1367507,0,1367507,2010.csv,2010,0.0,1.0
8156,The Goonies 2020 Re-release,1367152,825000,542152,2020.csv,2020,0.6034442402893021,0.39655575971069784
8157,Tere Bin Laden,1366926,0,1366926,2010.csv,2010,0.0,1.0
8158,The Ardennes,1366879,5638,1361241,2015.csv,2015,0.004124725012235904,0.9958752749877641
8159,Boss Level,1366080,0,1366080,2021.csv,2021,0.0,1.0
8160,Quel bravo ragazzo,1365822,0,1365822,2016.csv,2016,0.0,1.0
8161,Varg Veum - I mørket er alle ulver grå,1365236,0,1365236,2011.csv,2011,0.0,1.0
8162,Vlad the Impaler,1365229,0,1365229,2018.csv,2018,0.0,1.0
8163,Secrets of War,1364391,0,1364391,2014.csv,2014,0.0,1.0
8164,The Devil's Path,1364339,0,1364339,2013.csv,2013,0.0,1.0
8165,The Salvation,1363964,44903,1319061,2014.csv,2014,0.03292095685809889,0.9670790431419011
8166,2040,1363654,0,1363654,2019.csv,2019,0.0,1.0
8167,National Theater Live: Cyrano de Bergerac 2020 Re-release,1363212,198352,1164860,2020.csv,2020,0.14550341399576883,0.8544965860042312
8168,Life Is Life,1363161,0,1363161,2015.csv,2015,0.0,1.0
8169,Na bank sie uda,1362924,0,1362924,2019.csv,2019,0.0,1.0
8170,Little Italy,1362536,990230,372306,2018.csv,2018,0.726755109589765,0.27324489041023503
8171,Gimme Shelter,1362018,1359910,2108,2014.csv,2014,0.9984522965188419,0.0015477034811581052
8172,The Longest Distance,1361408,0,1361408,2014.csv,2014,0.0,1.0
8173,El Bosque de Karadima,1360942,0,1360942,2015.csv,2015,0.0,1.0
8174,Karakomik Filmler: Emanet,1360837,0,1360837,2020.csv,2020,0.0,1.0
8175,"Turu, the Wacky Hen",1360825,0,1360825,2020.csv,2020,0.0,1.0
8176,Apocalypse,1359257,0,1359257,2011.csv,2011,0.0,1.0
8177,Tokyo Tribe,1359031,0,1359031,2014.csv,2014,0.0,1.0
8178,Bon appétit,1358896,0,1358896,2010.csv,2010,0.0,1.0
8179,Jan Dara: The Beginning,1358865,0,1358865,2012.csv,2012,0.0,1.0
8180,Chasing Ice,1358668,1328467,30201,2012.csv,2012,0.9777716116078394,0.022228388392160556
8181,A Ruined House,1358381,0,1358381,2010.csv,2010,0.0,1.0
8182,Gangsta,1358208,0,1358208,2018.csv,2018,0.0,1.0
8183,Kandasamys: The Wedding,1356548,0,1356548,2019.csv,2019,0.0,1.0
8184,Raavan,1356461,708726,647735,2010.csv,2010,0.5224816636821847,0.47751833631781526
8185,Foxtrot,1356159,618883,737276,2018.csv,2018,0.45634988227781553,0.5436501177221845
8186,Hep Yek 3,1356113,0,1356113,2019.csv,2019,0.0,1.0
8187,Papa,1356033,26677,1329356,2016.csv,2016,0.019672825071366258,0.9803271749286337
8188,A Grain of Truth,1354957,0,1354957,2015.csv,2015,0.0,1.0
8189,Bil Nesbeh La Bokra Chou,1352492,0,1352492,2016.csv,2016,0.0,1.0
8190,The Oscar Nominated Short Films 2011: Live Action,1352152,1352152,0,2011.csv,2011,1.0,0.0
8191,Hustlers,1351732,0,1351732,2010.csv,2010,0.0,1.0
8192,You Can't Kiss the Bride,1351302,0,1351302,2019.csv,2019,0.0,1.0
8193,Unforgivable,1351146,154189,1196957,2011.csv,2011,0.11411720124990193,0.885882798750098
8194,The Teacher,1350426,64437,1285989,2016.csv,2016,0.04771605404516797,0.952283945954832
8195,In the City of Dawn,1349462,0,1349462,2011.csv,2011,0.0,1.0
8196,The Snowtown Murders,1349387,8452,1340935,2011.csv,2011,0.006263584872241989,0.993736415127758
8197,2 Hearts,1349286,1349286,0,2020.csv,2020,1.0,0.0
8198,Abdel et la comtesse,1348863,0,1348863,2018.csv,2018,0.0,1.0
8199,The Cokeville Miracle,1348456,1348456,0,2015.csv,2015,1.0,0.0
8200,Berserk: The Golden Age Arc I - The Egg of the King,1348352,0,1348352,2012.csv,2012,0.0,1.0
8201,Who's That Girl?,1348109,0,1348109,2011.csv,2011,0.0,1.0
8202,Karsten og Petra lager teater,1347300,0,1347300,2017.csv,2017,0.0,1.0
8203,RYTMUS sídliskový sen,1347006,0,1347006,2015.csv,2015,0.0,1.0
8204,Muse,1346352,0,1346352,2017.csv,2017,0.0,1.0
8205,New Year Blues,1344633,0,1344633,2021.csv,2021,0.0,1.0
8206,Ice Kacang Puppy Love,1344496,0,1344496,2010.csv,2010,0.0,1.0
8207,Odessa,1344070,0,1344070,2019.csv,2019,0.0,1.0
8208,Cinco,1343554,0,1343554,2010.csv,2010,0.0,1.0
8209,The Prodigies,1343411,0,1343411,2011.csv,2011,0.0,1.0
8210,"Moskva, ya lyublyu tebya!",1342584,0,1342584,2010.csv,2010,0.0,1.0
8211,Party Girl,1341430,0,1341430,2014.csv,2014,0.0,1.0
8212,Treasure Inn,1341356,0,1341356,2011.csv,2011,0.0,1.0
8213,Finding Altamira,1341205,0,1341205,2016.csv,2016,0.0,1.0
8214,Game Therapy,1341185,0,1341185,2014.csv,2014,0.0,1.0
8215,Wheely,1340799,0,1340799,2018.csv,2018,0.0,1.0
8216,Morgana,1340446,0,1340446,2012.csv,2012,0.0,1.0
8217,As Luck Would Have It,1340269,0,1340269,2012.csv,2012,0.0,1.0
8218,Best Suspects,1340000,0,1340000,2014.csv,2014,0.0,1.0
8219,Oflu Hoca'nin Sifresi 2,1339502,0,1339502,2016.csv,2016,0.0,1.0
8220,A Smile from the Mountain,1339004,0,1339004,2018.csv,2018,0.0,1.0
8221,The Assistant,1338881,1100313,238568,2020.csv,2020,0.8218153816507965,0.17818461834920354
8222,Quill: The Life of a Guide Dog 2010 Re-release,1337576,0,1337576,2010.csv,2010,0.0,1.0
8223,Student of the Year,1337281,670086,667195,2012.csv,2012,0.5010809246523356,0.4989190753476644
8224,Norm of the North: Keys to the Kingdom,1336956,0,1336956,2018.csv,2018,0.0,1.0
8225,It Happened in Saint-Tropez,1336832,0,1336832,2013.csv,2013,0.0,1.0
8226,Sinterklaas en de pepernoten chaos,1336791,0,1336791,2013.csv,2013,0.0,1.0
8227,Infrarouge: À voix haute - La force de la parole,1336298,0,1336298,2017.csv,2017,0.0,1.0
8228,Barney Thomson,1336254,0,1336254,2015.csv,2015,0.0,1.0
8229,Sonja: The White Swan,1334497,0,1334497,2018.csv,2018,0.0,1.0
8230,The Beast,1333830,0,1333830,2019.csv,2019,0.0,1.0
8231,The Metropolitan Opera HD Live: Rossini: Semiramide,1332900,1033651,299249,2018.csv,2018,0.7754902843424113,0.2245097156575887
8232,Chinese Wine,1332514,0,1332514,2016.csv,2016,0.0,1.0
8233,Ghost in the Shell: The New Movie,1332311,101203,1231108,2015.csv,2015,0.0759604927077837,0.9240395072922163
8234,Godard Mon Amour,1332204,82264,1249940,2017.csv,2017,0.06175030250622277,0.9382496974937772
8235,Dishoom,1331922,812737,519185,2016.csv,2016,0.6101986452660141,0.3898013547339859
8236,Ajami,1331651,622403,709248,2010.csv,2010,0.4673919818330779,0.5326080181669222
8237,We Are Pregnant,1331227,0,1331227,2016.csv,2016,0.0,1.0
8238,The Dark Knight 2020 Re-release,1330612,0,1330612,2020.csv,2020,0.0,1.0
8239,Cattle Hill,1330576,0,1330576,2018.csv,2018,0.0,1.0
8240,Rebuilding,1330193,0,1330193,2019.csv,2019,0.0,1.0
8241,Territory,1330063,0,1330063,2015.csv,2015,0.0,1.0
8242,13 Minutes,1328233,161531,1166702,2015.csv,2015,0.1216134518567149,0.8783865481432851
8243,Todo Mal,1327899,0,1327899,2018.csv,2018,0.0,1.0
8244,The Ultimate Life,1327841,1327841,0,2013.csv,2013,1.0,0.0
8245,Fat and Fame,1327225,0,1327225,2018.csv,2018,0.0,1.0
8246,Break Up Club,1327201,0,1327201,2010.csv,2010,0.0,1.0
8247,Maattrraan,1327035,0,1327035,2012.csv,2012,0.0,1.0
8248,Catch the Dream,1326418,0,1326418,2013.csv,2013,0.0,1.0
8249,Mother Water,1325794,0,1325794,2010.csv,2010,0.0,1.0
8250,The Tax Collector,1325781,1044212,281569,2020.csv,2020,0.787620278160571,0.212379721839429
8251,The Hater,1325591,0,1325591,2020.csv,2020,0.0,1.0
8252,Under the Bed 3,1325507,0,1325507,2016.csv,2016,0.0,1.0
8253,St. Nicholas and the Flight Through the Sky,1325280,0,1325280,2018.csv,2018,0.0,1.0
8254,The Disappearance of Conan Edogawa: The Worst Two Days in History,1324979,0,1324979,2015.csv,2015,0.0,1.0
8255,Playing It Cool,1323415,0,1323415,2015.csv,2015,0.0,1.0
8256,Larisa empisteftiko,1323261,0,1323261,2012.csv,2012,0.0,1.0
8257,St. Nicholas & the Golden Horseshoe,1323126,0,1323126,2017.csv,2017,0.0,1.0
8258,Pigeons on the Roof,1323109,0,1323109,2011.csv,2011,0.0,1.0
8259,10 Rules,1323065,0,1323065,2014.csv,2014,0.0,1.0
8260,Spirited Away 2019 Re-release,1322927,1322927,0,2019.csv,2019,1.0,0.0
8261,Player,1322650,0,1322650,2013.csv,2013,0.0,1.0
8262,Mad World,1322500,0,1322500,2017.csv,2017,0.0,1.0
8263,It's a Wonderful Afterlife,1321438,0,1321438,2010.csv,2010,0.0,1.0
8264,Festival,1321413,0,1321413,2010.csv,2010,0.0,1.0
8265,Another Shot,1321360,0,1321360,2017.csv,2017,0.0,1.0
8266,Cingoz Recai,1320501,0,1320501,2017.csv,2017,0.0,1.0
8267,Die Friedensmission,1319938,0,1319938,2012.csv,2012,0.0,1.0
8268,The Man Next Door,1319924,0,1319924,2010.csv,2010,0.0,1.0
8269,Oflu Hoca'nin Sifresi,1319694,0,1319694,2014.csv,2014,0.0,1.0
8270,La vérité si je mens! Les débuts,1319366,0,1319366,2019.csv,2019,0.0,1.0
8271,Thailand's Love,1318983,0,1318983,2016.csv,2016,0.0,1.0
8272,The Look of Love,1318468,21252,1297216,2013.csv,2013,0.016118707469578327,0.9838812925304217
8273,Gundermann,1315845,0,1315845,2018.csv,2018,0.0,1.0
8274,National Theatre Live: Hansard,1315564,0,1315564,2019.csv,2019,0.0,1.0
8275,Klyuch salamandry,1314843,0,1314843,2011.csv,2011,0.0,1.0
8276,Angel Face,1314753,0,1314753,2018.csv,2018,0.0,1.0
8277,Erased,1314735,0,1314735,2012.csv,2012,0.0,1.0
8278,Damsels in Distress,1314358,1008455,305903,2012.csv,2012,0.7672605180628109,0.2327394819371891
8279,Curious George 3: Back to the Jungle,1313940,0,1313940,2015.csv,2015,0.0,1.0
8280,Temporary Difficulties,1312189,0,1312189,2020.csv,2020,0.0,1.0
8281,Lo más sencillo es complicarlo todo,1312188,0,1312188,2017.csv,2017,0.0,1.0
8282,Kumbalangi Nights,1312005,0,1312005,2019.csv,2019,0.0,1.0
8283,The Little Comedian,1311519,0,1311519,2010.csv,2010,0.0,1.0
8284,72. Kogus,1311277,0,1311277,2011.csv,2011,0.0,1.0
8285,Mrs. Carey's Concert,1310276,0,1310276,2011.csv,2011,0.0,1.0
8286,Air Racers,1309987,1309987,0,2012.csv,2012,1.0,0.0
8287,Come What May,1309818,37766,1272052,2015.csv,2015,0.02883301344156211,0.9711669865584379
8288,Fred: The Movie,1309580,0,1309580,2010.csv,2010,0.0,1.0
8289,One Night,1309473,0,1309473,2012.csv,2012,0.0,1.0
8290,Ludwig II,1307807,0,1307807,2012.csv,2012,0.0,1.0
8291,Dom Hemingway,1307599,523511,784088,2013.csv,2013,0.40036050807625273,0.5996394919237472
8292,Fade Away Pastoral,1307365,0,1307365,2018.csv,2018,0.0,1.0
8293,Men on the Dragon,1306358,0,1306358,2018.csv,2018,0.0,1.0
8294,Something in the Air,1305473,85154,1220319,2012.csv,2012,0.06522846508506878,0.9347715349149313
8295,Nobody's Perfect,1303993,0,1303993,2013.csv,2013,0.0,1.0
8296,Jungle Shuffle,1303920,0,1303920,2014.csv,2014,0.0,1.0
8297,Gambler Husband Vs. Gambler Wife,1303794,0,1303794,2012.csv,2012,0.0,1.0
8298,The Metropolitan Opera HD Live: Mozart: Così fan tutte,1302949,1302949,0,2018.csv,2018,1.0,0.0
8299,Pee Nak 2,1302777,0,1302777,2020.csv,2020,0.0,1.0
8300,Revenge Girl,1302754,0,1302754,2017.csv,2017,0.0,1.0
8301,Only the Wind Knows,1302670,0,1302670,2017.csv,2017,0.0,1.0
8302,Lærkevej - til døden os skiller,1302638,0,1302638,2012.csv,2012,0.0,1.0
8303,Les Cowboys,1302493,73725,1228768,2015.csv,2015,0.056602991340452505,0.9433970086595475
8304,Sunset Song,1302482,159714,1142768,2015.csv,2015,0.12262280783918703,0.877377192160813
8305,Waiting for Spring,1302229,0,1302229,2018.csv,2018,0.0,1.0
8306,Beck: Levande begravd,1301617,0,1301617,2010.csv,2010,0.0,1.0
8307,Doubutsu Sentai Zyuohger vs. Ninninger the Movie: Super Sentai's Message from the Future,1301471,0,1301471,2017.csv,2017,0.0,1.0
8308,Angrezi Medium,1301330,0,1301330,2020.csv,2020,0.0,1.0
8309,The Room 2017 Re-release,1301103,549602,751501,2017.csv,2017,0.4224123685826564,0.5775876314173436
8310,Boxhagener Platz,1300406,0,1300406,2010.csv,2010,0.0,1.0
8311,Saranae Osekai,1300181,0,1300181,2012.csv,2012,0.0,1.0
8312,Hard to Be a God,1299035,28608,1270427,2014.csv,2014,0.022022501318286265,0.9779774986817137
8313,Piece of Cake,1298944,0,1298944,2015.csv,2015,0.0,1.0
8314,J'veux du soleil,1297191,0,1297191,2019.csv,2019,0.0,1.0
8315,A Story of Yonosuke,1297047,0,1297047,2013.csv,2013,0.0,1.0
8316,Kesari,1296688,0,1296688,2019.csv,2019,0.0,1.0
8317,"Mu-hyeon, Du Do-si I-ya-gi",1296433,0,1296433,2016.csv,2016,0.0,1.0
8318,All That Divides Us,1295900,0,1295900,2017.csv,2017,0.0,1.0
8319,Toohon,1295731,0,1295731,2011.csv,2011,0.0,1.0
8320,Slow West,1295574,229094,1066480,2015.csv,2015,0.17682818580798934,0.8231718141920107
8321,Roger Waters - Us + Them,1294480,611644,682836,2019.csv,2019,0.47250169952413323,0.5274983004758668
8322,The Day I Was Not Born,1294340,0,1294340,2011.csv,2011,0.0,1.0
8323,Divaldo: O Mensageiro da Paz,1294315,0,1294315,2019.csv,2019,0.0,1.0
8324,Maichur Tongloblu,1294310,0,1294310,2013.csv,2013,0.0,1.0
8325,Much Loved,1293716,0,1293716,2015.csv,2015,0.0,1.0
8326,4x4,1292773,0,1292773,2019.csv,2019,0.0,1.0
8327,The Gang of Oss,1292646,0,1292646,2011.csv,2011,0.0,1.0
8328,Enes Batur 2,1292474,0,1292474,2019.csv,2019,0.0,1.0
8329,No Safe Spaces,1291514,1291514,0,2019.csv,2019,1.0,0.0
8330,Same Same But Different,1291356,0,1291356,2010.csv,2010,0.0,1.0
8331,Switch 2013 Re-release,1291136,0,1291136,2013.csv,2013,0.0,1.0
8332,PiraMMMida,1290637,0,1290637,2011.csv,2011,0.0,1.0
8333,Close Enemies,1290258,0,1290258,2018.csv,2018,0.0,1.0
8334,Young and Dangerous: Reloaded,1290173,0,1290173,2013.csv,2013,0.0,1.0
8335,Savage,1289813,0,1289813,2020.csv,2020,0.0,1.0
8336,The Prince,1289595,0,1289595,2014.csv,2014,0.0,1.0
8337,Turkish Ice-Cream,1289283,0,1289283,2019.csv,2019,0.0,1.0
8338,Honeyland,1289107,815082,474025,2019.csv,2019,0.6322842091463315,0.36771579085366846
8339,Tisbah ala Khair,1287673,0,1287673,2017.csv,2017,0.0,1.0
8340,The Cakemaker,1287568,875751,411817,2018.csv,2018,0.6801590284940291,0.31984097150597096
8341,Home for Christmas,1286825,0,1286825,2010.csv,2010,0.0,1.0
8342,I Travel Alone,1286350,0,1286350,2011.csv,2011,0.0,1.0
8343,Glory Day,1285916,0,1285916,2016.csv,2016,0.0,1.0
8344,Raspberry Boat Refugee,1284591,0,1284591,2014.csv,2014,0.0,1.0
8345,Akira 2017 Re-release,1284376,0,1284376,2017.csv,2017,0.0,1.0
8346,Momzillas,1284220,0,1284220,2013.csv,2013,0.0,1.0
8347,Los numeros,1283764,0,1283764,2011.csv,2011,0.0,1.0
8348,Siccin 5,1283684,0,1283684,2018.csv,2018,0.0,1.0
8349,Filmistaan,1282717,45406,1237311,2014.csv,2014,0.035398299079220125,0.9646017009207799
8350,La verità sta in cielo,1282273,0,1282273,2016.csv,2016,0.0,1.0
8351,The Girl Who Believes in Miracles,1282225,1282225,0,2021.csv,2021,1.0,0.0
8352,Off the Map,1280130,0,1280130,2016.csv,2016,0.0,1.0
8353,Un giorno devi andare,1279336,0,1279336,2013.csv,2013,0.0,1.0
8354,First Growth,1279267,0,1279267,2015.csv,2015,0.0,1.0
8355,Te juro que yo no fui,1279083,0,1279083,2018.csv,2018,0.0,1.0
8356,Kajillionaire,1278913,531430,747483,2020.csv,2020,0.4155325655458972,0.5844674344541029
8357,I Spit on Your Grave,1278650,93051,1185599,2010.csv,2010,0.07277284636139679,0.9272271536386032
8358,Howl,1278390,617334,661056,2010.csv,2010,0.4828995846337972,0.5171004153662028
8359,Black Souls,1278360,101088,1177272,2014.csv,2014,0.07907631653055477,0.9209236834694452
8360,Michael Jackson Commemorated,1278263,0,1278263,2010.csv,2010,0.0,1.0
8361,The Villain,1278108,730530,547578,2014.csv,2014,0.5715714165000141,0.4284285834999859
8362,Shed Skin Papa,1278065,13331,1264734,2018.csv,2018,0.0104306119015856,0.9895693880984144
8363,Running Man,1277897,0,1277897,2018.csv,2018,0.0,1.0
8364,Çakallarla Dans,1277220,0,1277220,2010.csv,2010,0.0,1.0
8365,An Ordinary Execution,1276892,0,1276892,2010.csv,2010,0.0,1.0
8366,Barbie in Princess Power,1276765,0,1276765,2015.csv,2015,0.0,1.0
8367,The Little Gangster,1276194,0,1276194,2015.csv,2015,0.0,1.0
8368,Eva,1276051,0,1276051,2011.csv,2011,0.0,1.0
8369,I Care a Lot,1274561,0,1274561,2021.csv,2021,0.0,1.0
8370,Mr. & Mrs. Player,1273719,0,1273719,2013.csv,2013,0.0,1.0
8371,Solo en casa,1273291,0,1273291,2012.csv,2012,0.0,1.0
8372,Yellow Submarine,1273261,992305,280956,2018.csv,2018,0.7793413919062941,0.22065860809370585
8373,The Women's Balcony,1272517,1200885,71632,2017.csv,2017,0.94370841411156,0.05629158588844
8374,Beautifully Broken,1271572,1209645,61927,2018.csv,2018,0.9512988647123403,0.04870113528765969
8375,Tai ji 1: Cong ling kai shi,1271521,212094,1059427,2012.csv,2012,0.16680337957454106,0.833196620425459
8376,Texas Killing Fields,1271319,45469,1225850,2011.csv,2011,0.03576521706983062,0.9642347829301694
8377,PriPara: Everyone's Yearning Let's Go PriPari,1270688,0,1270688,2016.csv,2016,0.0,1.0
8378,Zebraman 2: Attack on Zebra City,1270219,0,1270219,2010.csv,2010,0.0,1.0
8379,The Perfect Candidate,1270023,0,1270023,2020.csv,2020,0.0,1.0
8380,Delhi Safari 2014 Re-release,1270000,0,1270000,2014.csv,2014,0.0,1.0
8381,Being Human,1269821,0,1269821,2010.csv,2010,0.0,1.0
8382,Welcome Aboard,1269299,0,1269299,2012.csv,2012,0.0,1.0
8383,Higanjima: Escape from Vampire Island,1269260,0,1269260,2010.csv,2010,0.0,1.0
8384,Pro lyuboff,1268793,0,1268793,2010.csv,2010,0.0,1.0
8385,Roda tsanta kai kopana,1268767,0,1268767,2011.csv,2011,0.0,1.0
8386,Furious,1267946,0,1267946,2011.csv,2011,0.0,1.0
8387,Briefgeheim,1267723,0,1267723,2010.csv,2010,0.0,1.0
8388,Fagara,1265949,43417,1222532,2019.csv,2019,0.03429601034480852,0.9657039896551914
8389,Why Don't You Play in Hell?,1265872,28534,1237338,2013.csv,2013,0.022540983606557378,0.9774590163934426
8390,Fruity Robo the Great Escape,1264723,0,1264723,2016.csv,2016,0.0,1.0
8391,Batla House,1264337,493180,771157,2019.csv,2019,0.39007005252555293,0.6099299474744471
8392,Valley of Love,1264277,28648,1235629,2015.csv,2015,0.02265959121300158,0.9773404087869985
8393,In the Beginning There Was Light,1263814,0,1263814,2010.csv,2010,0.0,1.0
8394,Avatar 2020 Re-release,1263659,0,1263659,2020.csv,2020,0.0,1.0
8395,Jailbirds,1263389,0,1263389,2016.csv,2016,0.0,1.0
8396,So Help Me God,1262984,0,1262984,2018.csv,2018,0.0,1.0
8397,De Club van Sinterklaas & Geblaf op de Pakjesboot,1262972,0,1262972,2016.csv,2016,0.0,1.0
8398,Lyubov s ogranicheniyami,1262696,0,1262696,2017.csv,2017,0.0,1.0
8399,A Family,1262623,0,1262623,2010.csv,2010,0.0,1.0
8400,Codename: Jackal,1261947,0,1261947,2012.csv,2012,0.0,1.0
8401,Suddenly It's Magic,1261484,0,1261484,2012.csv,2012,0.0,1.0
8402,Vares: The Sheriff,1261483,0,1261483,2015.csv,2015,0.0,1.0
8403,Beauty Water,1261400,0,1261400,2020.csv,2020,0.0,1.0
8404,Super Salaryman/Yod-Manut-Ngen-Duen,1260885,0,1260885,2012.csv,2012,0.0,1.0
8405,Chonda Pierce: Enough,1260116,1260116,0,2017.csv,2017,1.0,0.0
8406,Meerkats,1259616,777595,482021,2012.csv,2012,0.6173270266493915,0.38267297335060846
8407,The Music of Strangers: Yo-Yo Ma and the Silk Road Ensemble,1259588,1176781,82807,2016.csv,2016,0.9342586623562625,0.06574133764373748
8408,The Trial,1259221,0,1259221,2014.csv,2014,0.0,1.0
8409,Gett,1259160,988150,271010,2014.csv,2014,0.7847692112201785,0.21523078877982146
8410,Plan V,1258520,0,1258520,2018.csv,2018,0.0,1.0
8411,Guy,1257937,1319,1256618,2018.csv,2018,0.0010485421765954893,0.9989514578234046
8412,Anna,1257142,4288,1252854,2014.csv,2014,0.0034109114165305114,0.9965890885834695
8413,Chaar Sahibzaade 2: Rise of Banda Singh Bahadur,1256852,700723,556129,2016.csv,2016,0.5575222858379507,0.4424777141620493
8414,Kidnapper,1256321,0,1256321,2010.csv,2010,0.0,1.0
8415,The Book of Fish,1256271,0,1256271,2021.csv,2021,0.0,1.0
8416,The Adopted,1255727,0,1255727,2011.csv,2011,0.0,1.0
8417,La colle,1255399,0,1255399,2017.csv,2017,0.0,1.0
8418,Kiki's Delivery Service,1254030,0,1254030,2014.csv,2014,0.0,1.0
8419,Last Summer,1253865,0,1253865,2013.csv,2013,0.0,1.0
8420,Plan de fuga,1253363,0,1253363,2017.csv,2017,0.0,1.0
8421,Lucia's Grace,1253103,0,1253103,2018.csv,2018,0.0,1.0
8422,Accused,1252924,0,1252924,2014.csv,2014,0.0,1.0
8423,For a Woman,1252416,32286,1220130,2013.csv,2013,0.025778974398283,0.974221025601717
8424,Kaçma Birader,1252169,0,1252169,2016.csv,2016,0.0,1.0
8425,Right Here Right Now,1251878,0,1251878,2016.csv,2016,0.0,1.0
8426,Demi-soeur,1251642,943,1250699,2013.csv,2013,0.0007534103202033809,0.9992465896797966
8427,Xiao wu yi da po tong wang zhen,1251378,0,1251378,2017.csv,2017,0.0,1.0
8428,Hans Kloss: More Than Death at Stake,1250686,0,1250686,2012.csv,2012,0.0,1.0
8429,The Ledge,1247188,9216,1237972,2011.csv,2011,0.007389423246535406,0.9926105767534646
8430,Happy Together: All About My Dog,1245388,0,1245388,2011.csv,2011,0.0,1.0
8431,One Way Trip,1244165,0,1244165,2011.csv,2011,0.0,1.0
8432,Midnight's Children,1243980,190022,1053958,2012.csv,2012,0.15275325969870898,0.847246740301291
8433,Slumber,1243832,0,1243832,2017.csv,2017,0.0,1.0
8434,Scappo a casa,1243388,0,1243388,2019.csv,2019,0.0,1.0
8435,Zombie Reddy,1242321,0,1242321,2021.csv,2021,0.0,1.0
8436,Stanley Ka Dabba,1241102,0,1241102,2011.csv,2011,0.0,1.0
8437,Kolysanka,1240743,0,1240743,2010.csv,2010,0.0,1.0
8438,1945,1240663,1006193,234470,2017.csv,2017,0.811012337758118,0.18898766224188196
8439,205: Room of Fear,1239888,0,1239888,2012.csv,2012,0.0,1.0
8440,Victoria,1239475,0,1239475,2013.csv,2013,0.0,1.0
8441,Crying Out Love in the Center of the World 2016 Re-release,1238018,0,1238018,2016.csv,2016,0.0,1.0
8442,Geuk-jang-pan Po-ket-mon-seu-teo DP - Di-a-ru-ga VS Peol-gi-a VS Da-keu-ra-i,1237731,0,1237731,2018.csv,2018,0.0,1.0
8443,Good Boy,1237319,0,1237319,2016.csv,2016,0.0,1.0
8444,Painkillers,1236772,0,1236772,2014.csv,2014,0.0,1.0
8445,The Queen of Spain,1236731,0,1236731,2016.csv,2016,0.0,1.0
8446,Swinging Safari,1236408,0,1236408,2018.csv,2018,0.0,1.0
8447,Beyond the Mask,1236094,1236094,0,2015.csv,2015,1.0,0.0
8448,Track Aduowan,1235110,0,1235110,2010.csv,2010,0.0,1.0
8449,Dang ngo oi nei,1235086,0,1235086,2012.csv,2012,0.0,1.0
8450,Veerappan,1234745,0,1234745,2016.csv,2016,0.0,1.0
8451,Si saben cómo me pongo ¿pa' qué me invitan?,1234141,0,1234141,2018.csv,2018,0.0,1.0
8452,Studio illegale,1233681,0,1233681,2013.csv,2013,0.0,1.0
8453,Keeping Up with the Kandasamys,1233315,0,1233315,2017.csv,2017,0.0,1.0
8454,The Silent Revolution,1233064,0,1233064,2018.csv,2018,0.0,1.0
8455,The Nest,1232927,137886,1095041,2020.csv,2020,0.11183630498804877,0.8881636950119512
8456,The Blue Room,1232900,254666,978234,2014.csv,2014,0.2065585205612783,0.7934414794387217
8457,The Cut,1232140,28066,1204074,2014.csv,2014,0.02277825571769442,0.9772217442823056
8458,Life,1231606,0,1231606,2015.csv,2015,0.0,1.0
8459,True to the Game,1231040,1231040,0,2017.csv,2017,1.0,0.0
8460,WTF,1230890,0,1230890,2014.csv,2014,0.0,1.0
8461,Taht el-Tarabizah,1230555,0,1230555,2016.csv,2016,0.0,1.0
8462,Hodja fra Pjort,1230407,0,1230407,2018.csv,2018,0.0,1.0
8463,Baba Yaga: Terror of the Dark Forest,1230184,0,1230184,2020.csv,2020,0.0,1.0
8464,Mi rifaccio vivo,1230130,0,1230130,2013.csv,2013,0.0,1.0
8465,In Family I Trust,1229880,0,1229880,2019.csv,2019,0.0,1.0
8466,A Suprema Felicidade,1229806,0,1229806,2010.csv,2010,0.0,1.0
8467,Steve McQueen: American Icon,1229782,1229782,0,2017.csv,2017,1.0,0.0
8468,Kryptonite!,1229609,0,1229609,2011.csv,2011,0.0,1.0
8469,Mishima: The Last Debate,1229264,0,1229264,2020.csv,2020,0.0,1.0
8470,City Lights,1229108,0,1229108,2014.csv,2014,0.0,1.0
8471,Tony 10,1228599,0,1228599,2012.csv,2012,0.0,1.0
8472,Cut Off,1228051,0,1228051,2018.csv,2018,0.0,1.0
8473,Boutchou,1227428,0,1227428,2020.csv,2020,0.0,1.0
8474,Café de flore,1227259,0,1227259,2012.csv,2012,0.0,1.0
8475,Cementerio General,1227140,0,1227140,2013.csv,2013,0.0,1.0
8476,Casablanca 2011 Re-release,1226808,1155330,71478,2011.csv,2011,0.9417366042608134,0.05826339573918657
8477,Tamako Love Story,1226623,0,1226623,2014.csv,2014,0.0,1.0
8478,BTS World Tour 'Love Yourself: Speak Yourself' (The Final) Seoul Live Viewing,1226552,1226552,0,2019.csv,2019,1.0,0.0
8479,That Sugar Film,1226399,3500,1222899,2015.csv,2015,0.0028538836055802394,0.9971461163944197
8480,Raoul Taburin,1225993,0,1225993,2019.csv,2019,0.0,1.0
8481,Elementary,1225280,0,1225280,2017.csv,2017,0.0,1.0
8482,The Surprise,1224452,0,1224452,2015.csv,2015,0.0,1.0
8483,A Bun in the Oven,1223583,0,1223583,2016.csv,2016,0.0,1.0
8484,Satyagraha,1223419,738525,484894,2013.csv,2013,0.6036566376686973,0.3963433623313027
8485,Jaanu,1221813,0,1221813,2020.csv,2020,0.0,1.0
8486,The Taste of Apple Seeds,1220549,0,1220549,2013.csv,2013,0.0,1.0
8487,Themis,1220249,0,1220249,2012.csv,2012,0.0,1.0
8488,Jungle Master,1220000,0,1220000,2013.csv,2013,0.0,1.0
8489,My Boyfriends,1220000,0,1220000,2013.csv,2013,0.0,1.0
8490,K.O.,1219858,0,1219858,2017.csv,2017,0.0,1.0
8491,Golkeri,1219801,0,1219801,2020.csv,2020,0.0,1.0
8492,Marche avec les loups,1219228,0,1219228,2020.csv,2020,0.0,1.0
8493,The Final Stand,1218682,0,1218682,2020.csv,2020,0.0,1.0
8494,Sister,1218174,154659,1063515,2012.csv,2012,0.12695969541297056,0.8730403045870294
8495,Hedgehogs,1218173,0,1218173,2016.csv,2016,0.0,1.0
8496,The Adventures of Huck Finn,1217451,0,1217451,2012.csv,2012,0.0,1.0
8497,Reza a Lenda,1217201,0,1217201,2016.csv,2016,0.0,1.0
8498,Fabrizio De Andrè & PFM - Il concerto ritrovato,1216390,0,1216390,2020.csv,2020,0.0,1.0
8499,Omae umasoudana,1216304,0,1216304,2010.csv,2010,0.0,1.0
8500,Barbie: Star Light Adventure,1216246,0,1216246,2016.csv,2016,0.0,1.0
8501,Ilo Ilo,1216181,56773,1159408,2013.csv,2013,0.04668137390733781,0.9533186260926622
8502,The Charlemagne Code,1215851,0,1215851,2010.csv,2010,0.0,1.0
8503,The Mark of the Angels - Miserere,1215557,0,1215557,2013.csv,2013,0.0,1.0
8504,A Yeti Adventure,1215413,0,1215413,2018.csv,2018,0.0,1.0
8505,After the Flowers,1215412,0,1215412,2010.csv,2010,0.0,1.0
8506,Al posto tuo,1215311,0,1215311,2016.csv,2016,0.0,1.0
8507,Nikka Zaildar 3,1215304,0,1215304,2019.csv,2019,0.0,1.0
8508,The Three Musketeers,1214919,0,1214919,2013.csv,2013,0.0,1.0
8509,Jan Dara: The Finale,1214517,0,1214517,2013.csv,2013,0.0,1.0
8510,The Best Things in the World,1214499,0,1214499,2010.csv,2010,0.0,1.0
8511,When We Leave,1214076,19631,1194445,2010.csv,2010,0.016169498449849926,0.9838305015501501
8512,Surf's Up 2: WaveMania,1213943,0,1213943,2017.csv,2017,0.0,1.0
8513,Chicuarotes,1213841,0,1213841,2019.csv,2019,0.0,1.0
8514,The Door,1213654,0,1213654,2017.csv,2017,0.0,1.0
8515,Alla Pugachyova. Tot Samyi Kontsert,1213396,0,1213396,2020.csv,2020,0.0,1.0
8516,Woman Thou Art Loosed: On the 7th Day,1213128,1213128,0,2012.csv,2012,1.0,0.0
8517,The Two Deaths of Quincas Wateryell,1212639,0,1212639,2010.csv,2010,0.0,1.0
8518,Empire State,1212500,0,1212500,2013.csv,2013,0.0,1.0
8519,Clandestine Childhood,1212354,9017,1203337,2012.csv,2012,0.007437596609571132,0.9925624033904289
8520,Corazon: Ang unang aswang,1212269,0,1212269,2012.csv,2012,0.0,1.0
8521,Uncle Boonmee Who Can Recall His Past Lives,1212206,184292,1027914,2010.csv,2010,0.15203026548292947,0.8479697345170706
8522,The Jews,1211744,0,1211744,2016.csv,2016,0.0,1.0
8523,The Conductor,1211394,0,1211394,2018.csv,2018,0.0,1.0
8524,Bad Fucking,1211256,0,1211256,2013.csv,2013,0.0,1.0
8525,Kochadaiiyaan,1210580,817192,393388,2014.csv,2014,0.6750417155413108,0.32495828445868924
8526,Casino Jack,1209709,1042959,166750,2010.csv,2010,0.862156931956363,0.13784306804363694
8527,23:59,1208479,0,1208479,2011.csv,2011,0.0,1.0
8528,Those Who Work,1208371,0,1208371,2019.csv,2019,0.0,1.0
8529,Escobar: Paradise Lost 2016 Re-release,1208035,0,1208035,2016.csv,2016,0.0,1.0
8530,The Way He Looks,1207841,101451,1106390,2014.csv,2014,0.08399367135243795,0.916006328647562
8531,Africa United,1207592,0,1207592,2010.csv,2010,0.0,1.0
8532,Noble 2014 Re-release,1207386,347321,860065,2014.csv,2014,0.2876635972257422,0.7123364027742578
8533,Fast Girls,1207241,0,1207241,2012.csv,2012,0.0,1.0
8534,1812. Ulanskaya ballada,1206794,0,1206794,2012.csv,2012,0.0,1.0
8535,The Holy Man III,1205719,0,1205719,2010.csv,2010,0.0,1.0
8536,Alone in Berlin,1205598,33125,1172473,2016.csv,2016,0.02747599116786856,0.9725240088321314
8537,Inequality for All,1205273,1205273,0,2013.csv,2013,1.0,0.0
8538,Meek's Cutoff,1205257,977772,227485,2011.csv,2011,0.8112560225744385,0.1887439774255615
8539,In the Hood,1204844,0,1204844,2018.csv,2018,0.0,1.0
8540,Free! Timeless Medley: The Promise,1204708,0,1204708,2017.csv,2017,0.0,1.0
8541,Serengeti,1204519,0,1204519,2011.csv,2011,0.0,1.0
8542,Malicious,1204393,0,1204393,2018.csv,2018,0.0,1.0
8543,Life Without Principle,1203873,0,1203873,2011.csv,2011,0.0,1.0
8544,In the Land of Blood and Honey,1203699,303877,899822,2011.csv,2011,0.25245264804573236,0.7475473519542677
8545,Jag saknar dig,1203153,0,1203153,2011.csv,2011,0.0,1.0
8546,In the Shadow,1202940,0,1202940,2012.csv,2012,0.0,1.0
8547,Little Buddho,1202777,0,1202777,2014.csv,2014,0.0,1.0
8548,The Vanishing,1202522,0,1202522,2019.csv,2019,0.0,1.0
8549,"Oh, Ramona!",1200582,0,1200582,2019.csv,2019,0.0,1.0
8550,Mohammed Hussain,1200438,0,1200438,2019.csv,2019,0.0,1.0
8551,"Mektoub, My Love: Canto Uno",1200387,0,1200387,2018.csv,2018,0.0,1.0
8552,"Beats, Rhymes & Life: The Travels of A Tribe Called Quest",1200326,1200326,0,2011.csv,2011,1.0,0.0
8553,Ghoul,1200097,0,1200097,2015.csv,2015,0.0,1.0
8554,Westlife - The Twenty Tour Live,1200076,0,1200076,2019.csv,2019,0.0,1.0
8555,Tong que tai,1199568,0,1199568,2012.csv,2012,0.0,1.0
8556,Vejska,1198449,0,1198449,2014.csv,2014,0.0,1.0
8557,Seal Team Six: The Raid on Osama Bin Laden,1198120,0,1198120,2012.csv,2012,0.0,1.0
8558,Kung Food,1197984,0,1197984,2018.csv,2018,0.0,1.0
8559,Phantom,1197759,1034589,163170,2013.csv,2013,0.8637705915797752,0.13622940842022477
8560,Anon,1197741,0,1197741,2018.csv,2018,0.0,1.0
8561,Oteki Taraf,1197507,0,1197507,2017.csv,2017,0.0,1.0
8562,Spirited Away 2017 Re-release,1196791,1196791,0,2017.csv,2017,1.0,0.0
8563,The Captain,1196669,109226,1087443,2018.csv,2018,0.09127503094005109,0.9087249690599489
8564,Starups,1196360,0,1196360,2019.csv,2019,0.0,1.0
8565,The Metropolitan Opera HD Live: Saint-Saëns: Samson et Dalila,1195758,1195758,0,2018.csv,2018,1.0,0.0
8566,Lan Kwai Fong 3,1195656,0,1195656,2014.csv,2014,0.0,1.0
8567,The Contest: To the Stars and Back,1195034,0,1195034,2013.csv,2013,0.0,1.0
8568,Repentance,1194961,1189612,5349,2014.csv,2014,0.9955237032840403,0.0044762967159597674
8569,The First Grader,1194710,332000,862710,2011.csv,2011,0.27789170593700563,0.7221082940629944
8570,I See You,1194369,0,1194369,2019.csv,2019,0.0,1.0
8571,When You're Strange,1194182,246078,948104,2010.csv,2010,0.20606406728622606,0.7939359327137739
8572,The Culprit,1193935,0,1193935,2019.csv,2019,0.0,1.0
8573,Free Men,1192651,53810,1138841,2011.csv,2011,0.04511797667549015,0.9548820233245099
8574,Tutto l'amore del mondo,1192420,0,1192420,2010.csv,2010,0.0,1.0
8575,Godless Youth,1192197,0,1192197,2017.csv,2017,0.0,1.0
8576,Storyteller,1191413,0,1191413,2014.csv,2014,0.0,1.0
8577,Tutto quello che vuoi,1191233,0,1191233,2017.csv,2017,0.0,1.0
8578,Black Snake: La légende du serpent noir,1190994,0,1190994,2019.csv,2019,0.0,1.0
8579,Tarapaty,1189638,0,1189638,2017.csv,2017,0.0,1.0
8580,Attila Marcel,1189463,0,1189463,2013.csv,2013,0.0,1.0
8581,Kingdom Men Rising,1188936,1188936,0,2019.csv,2019,1.0,0.0
8582,Patisserie Coin De Rue,1188611,0,1188611,2011.csv,2011,0.0,1.0
8583,Shubh Mangal Savdhan,1188541,689874,498667,2017.csv,2017,0.5804376963016,0.4195623036984
8584,Tada's Do-It-All House,1188356,0,1188356,2011.csv,2011,0.0,1.0
8585,Kill the Irishman,1188194,1188194,0,2011.csv,2011,1.0,0.0
8586,Il signor Diavolo,1188159,0,1188159,2019.csv,2019,0.0,1.0
8587,Como matar a un esposo muerto,1187935,0,1187935,2017.csv,2017,0.0,1.0
8588,Dead Snow 2: Red vs. Dead,1187477,37473,1150004,2014.csv,2014,0.03155682173212618,0.9684431782678738
8589,Los Domirriqueños 2,1187280,1187280,0,2019.csv,2019,1.0,0.0
8590,Rise,1187034,0,1187034,2014.csv,2014,0.0,1.0
8591,The Prize,1186734,0,1186734,2017.csv,2017,0.0,1.0
8592,Code Name: K.O.Z.,1186730,0,1186730,2015.csv,2015,0.0,1.0
8593,Deli Ask,1185579,0,1185579,2017.csv,2017,0.0,1.0
8594,Marcianos vs. Mexicanos,1185285,0,1185285,2018.csv,2018,0.0,1.0
8595,Mt. Zion,1185102,0,1185102,2013.csv,2013,0.0,1.0
8596,Sconnessi,1185054,0,1185054,2018.csv,2018,0.0,1.0
8597,The Great Vazquez,1184521,0,1184521,2010.csv,2010,0.0,1.0
8598,Kac Wawa,1184471,0,1184471,2012.csv,2012,0.0,1.0
8599,Eva,1184348,0,1184348,2017.csv,2017,0.0,1.0
8600,In the Hero,1183855,0,1183855,2014.csv,2014,0.0,1.0
8601,Billi Pig,1183281,0,1183281,2012.csv,2012,0.0,1.0
8602,The Princess and the Magic Mirror,1183105,0,1183105,2015.csv,2015,0.0,1.0
8603,Bikers,1182035,0,1182035,2017.csv,2017,0.0,1.0
8604,True to the Game 2,1181823,1181823,0,2020.csv,2020,1.0,0.0
8605,Who Killed Bambi?,1181040,0,1181040,2013.csv,2013,0.0,1.0
8606,Remember 2016 Re-release,1181023,637555,543468,2016.csv,2016,0.5398328398346179,0.46016716016538206
8607,The Champion,1180367,0,1180367,2019.csv,2019,0.0,1.0
8608,National Theatre Live: Small Island,1180303,0,1180303,2019.csv,2019,0.0,1.0
8609,Kamenák 4,1180139,0,1180139,2013.csv,2013,0.0,1.0
8610,The Next Generation Patoreibâ: Shuto kessen,1179682,0,1179682,2015.csv,2015,0.0,1.0
8611,Woo Hoo!,1178693,0,1178693,2010.csv,2010,0.0,1.0
8612,Fire at Sea,1178377,120933,1057444,2016.csv,2016,0.10262674848541681,0.8973732515145832
8613,Itsi Bitsi,1178027,0,1178027,2015.csv,2015,0.0,1.0
8614,Na Quebrada,1177863,0,1177863,2014.csv,2014,0.0,1.0
8615,Het Verlangen,1177262,0,1177262,2017.csv,2017,0.0,1.0
8616,Any Body Can Dance 2,1176958,892133,284825,2015.csv,2015,0.7579990110097387,0.24200098899026135
8617,Ivan's Dream,1174290,0,1174290,2011.csv,2011,0.0,1.0
8618,The Audience,1174182,0,1174182,2013.csv,2013,0.0,1.0
8619,Marie's Story,1173514,11720,1161794,2014.csv,2014,0.009987098577434952,0.990012901422565
8620,Number One,1173243,0,1173243,2017.csv,2017,0.0,1.0
8621,Padrenostro,1173102,0,1173102,2020.csv,2020,0.0,1.0
8622,March Comes in Like a Lion,1172600,0,1172600,2017.csv,2017,0.0,1.0
8623,Heaven Blessing,1172039,0,1172039,2016.csv,2016,0.0,1.0
8624,Raanjhanaa,1171761,903232,268529,2013.csv,2013,0.7708329599636786,0.2291670400363214
8625,My Devilish Good Friend,1171012,0,1171012,2018.csv,2018,0.0,1.0
8626,The Nursery,1170030,0,1170030,2016.csv,2016,0.0,1.0
8627,L-O-V-E. 2011 Re-release,1169956,0,1169956,2011.csv,2011,0.0,1.0
8628,Zavtrak u papy,1169771,0,1169771,2016.csv,2016,0.0,1.0
8629,The Innkeepers,1169750,78396,1091354,2012.csv,2012,0.06701944860012823,0.9329805513998718
8630,Bu Iste Bir Yalnizlik Var,1168197,0,1168197,2013.csv,2013,0.0,1.0
8631,Dark Tide,1167612,0,1167612,2012.csv,2012,0.0,1.0
8632,I am a Doctor,1167451,0,1167451,2017.csv,2017,0.0,1.0
8633,The Metropolitan Opera HD Live: Verdi: Luisa Miller,1166858,1166858,0,2018.csv,2018,1.0,0.0
8634,Ki & Ka,1166781,857986,308795,2016.csv,2016,0.7353445076668201,0.2646554923331799
8635,You Ain't Seen Nothin' Yet,1166740,18929,1147811,2012.csv,2012,0.01622383735879459,0.9837761626412054
8636,Neon Flesh,1166432,0,1166432,2011.csv,2011,0.0,1.0
8637,The Way We Are,1166324,0,1166324,2020.csv,2020,0.0,1.0
8638,Mr. No Problem,1164932,0,1164932,2017.csv,2017,0.0,1.0
8639,Over Your Dead Body,1164010,0,1164010,2014.csv,2014,0.0,1.0
8640,Vaxxed: From Cover-Up to Catastrophe,1163265,1163265,0,2016.csv,2016,1.0,0.0
8641,Farewell: Comedy of Life Begins with A Lie,1162920,0,1162920,2020.csv,2020,0.0,1.0
8642,The Great Detective,1162914,0,1162914,2019.csv,2019,0.0,1.0
8643,If I were a boy,1162912,0,1162912,2017.csv,2017,0.0,1.0
8644,The Last Face,1161751,0,1161751,2017.csv,2017,0.0,1.0
8645,Of Love and Shadows 2011 Re-release,1161472,0,1161472,2011.csv,2011,0.0,1.0
8646,Louder Than Bombs,1160724,163807,996917,2015.csv,2015,0.14112484966279668,0.8588751503372033
8647,Break,1160525,0,1160525,2018.csv,2018,0.0,1.0
8648,Cherry on the Cake,1160375,0,1160375,2012.csv,2012,0.0,1.0
8649,Spangas in Action,1160300,0,1160300,2015.csv,2015,0.0,1.0
8650,Natalie,1159749,0,1159749,2010.csv,2010,0.0,1.0
8651,Secret Fruit,1159373,0,1159373,2017.csv,2017,0.0,1.0
8652,Where Hope Grows,1159072,1156000,3072,2015.csv,2015,0.9973496038209878,0.002650396179012175
8653,Breathe,1158695,42297,1116398,2014.csv,2014,0.03650399803226906,0.9634960019677309
8654,Every Breath You Take,1158457,0,1158457,2012.csv,2012,0.0,1.0
8655,Ci vuole un gran fisico,1158451,0,1158451,2013.csv,2013,0.0,1.0
8656,The Light of My Eyes,1158353,0,1158353,2010.csv,2010,0.0,1.0
8657,Schuks! Pay Back the Money!,1158333,0,1158333,2015.csv,2015,0.0,1.0
8658,The Vigil,1158267,50439,1107828,2020.csv,2020,0.04354695419967935,0.9564530458003206
8659,Clean Hands,1157963,0,1157963,2015.csv,2015,0.0,1.0
8660,Darling Companion,1157257,793815,363442,2012.csv,2012,0.6859452999636209,0.31405470003637914
8661,Oblawa,1157078,0,1157078,2012.csv,2012,0.0,1.0
8662,Perdida,1157057,0,1157057,2018.csv,2018,0.0,1.0
8663,Ella and Friends,1156973,0,1156973,2012.csv,2012,0.0,1.0
8664,Napping Princess,1156847,48198,1108649,2017.csv,2017,0.041663245009927845,0.9583367549900722
8665,Hep Yek 2,1156461,0,1156461,2017.csv,2017,0.0,1.0
8666,Billa 2,1155290,0,1155290,2012.csv,2012,0.0,1.0
8667,Embrace: The Documentary,1155263,629126,526137,2016.csv,2016,0.5445738329713667,0.4554261670286333
8668,Jagga Jasoos,1154862,861740,293122,2017.csv,2017,0.7461843925940935,0.25381560740590653
8669,96 heures,1154310,0,1154310,2014.csv,2014,0.0,1.0
8670,Pr' Hostar,1154075,0,1154075,2016.csv,2016,0.0,1.0
8671,Shrew's Nest,1152968,0,1152968,2014.csv,2014,0.0,1.0
8672,Step,1152839,1146292,6547,2017.csv,2017,0.9943209763028489,0.00567902369715112
8673,The German Lesson,1152502,0,1152502,2019.csv,2019,0.0,1.0
8674,Still/Born,1152247,0,1152247,2018.csv,2018,0.0,1.0
8675,Vivegam,1151913,0,1151913,2017.csv,2017,0.0,1.0
8676,Voice of the Nation,1151637,0,1151637,2019.csv,2019,0.0,1.0
8677,De Club van Sinterklaas & het Grote Pietenfeest,1151632,0,1151632,2020.csv,2020,0.0,1.0
8678,Razzia,1151580,0,1151580,2018.csv,2018,0.0,1.0
8679,Only Yours,1151277,0,1151277,2010.csv,2010,0.0,1.0
8680,Voor elkaar gemaakt,1151240,0,1151240,2017.csv,2017,0.0,1.0
8681,Murder at Honeymoon Hotel,1151187,0,1151187,2016.csv,2016,0.0,1.0
8682,The Preparation,1151120,0,1151120,2017.csv,2017,0.0,1.0
8683,Monster Strike the Movie: Lucifer - Zetsubou no Yoake,1150799,0,1150799,2020.csv,2020,0.0,1.0
8684,At the End of the Tunnel 2019 Re-release,1150756,0,1150756,2019.csv,2019,0.0,1.0
8685,Road to High & Low,1150725,0,1150725,2016.csv,2016,0.0,1.0
8686,Liberal Arts,1150681,327345,823336,2012.csv,2012,0.28447936482830605,0.715520635171694
8687,Tarp musy berniuky,1150013,0,1150013,2016.csv,2016,0.0,1.0
8688,"El que busca, encuentra",1149667,0,1149667,2017.csv,2017,0.0,1.0
8689,The Silent House,1149327,0,1149327,2011.csv,2011,0.0,1.0
8690,High School Musical: O Desafio,1149290,0,1149290,2010.csv,2010,0.0,1.0
8691,An American in Paris - The Musical,1149077,0,1149077,2018.csv,2018,0.0,1.0
8692,Hor taew tak 3,1148780,0,1148780,2011.csv,2011,0.0,1.0
8693,Kötü Çocuk,1147845,0,1147845,2017.csv,2017,0.0,1.0
8694,Eternity,1147578,0,1147578,2010.csv,2010,0.0,1.0
8695,Bicycle King Uhm Bok-Dong,1147171,0,1147171,2019.csv,2019,0.0,1.0
8696,Baahubali: The Beginning 2016 Re-release,1146932,0,1146932,2016.csv,2016,0.0,1.0
8697,Growing Pains,1145984,0,1145984,2017.csv,2017,0.0,1.0
8698,Cartel Land,1145923,704352,441571,2015.csv,2015,0.6146591001315097,0.3853408998684903
8699,What's Left of You,1145814,0,1145814,2015.csv,2015,0.0,1.0
8700,Vares: The Path of the Righteous Men,1145111,0,1145111,2012.csv,2012,0.0,1.0
8701,Bobby and the Ghost Hunters,1144556,0,1144556,2013.csv,2013,0.0,1.0
8702,Burn Out,1144435,0,1144435,2018.csv,2018,0.0,1.0
8703,Hinatazaka46 Documentary Movie: Debut After 3 Years,1143074,0,1143074,2020.csv,2020,0.0,1.0
8704,La scelta,1142974,0,1142974,2015.csv,2015,0.0,1.0
8705,Zero 3,1142638,0,1142638,2017.csv,2017,0.0,1.0
8706,National Theatre Live: King Lear,1142561,185305,957256,2018.csv,2018,0.16218390090332158,0.8378160990966784
8707,Where Is St. Nicholas' Big Book?,1142400,0,1142400,2019.csv,2019,0.0,1.0
8708,Storm,1142262,0,1142262,2014.csv,2014,0.0,1.0
8709,For the Hopeless Romantic,1141502,0,1141502,2015.csv,2015,0.0,1.0
8710,The Longest Shot,1140966,0,1140966,2019.csv,2019,0.0,1.0
8711,Roma,1140769,0,1140769,2018.csv,2018,0.0,1.0
8712,Rebellion,1140744,0,1140744,2011.csv,2011,0.0,1.0
8713,Adult Camp,1140091,0,1140091,2015.csv,2015,0.0,1.0
8714,The Song of Names,1138962,1077584,61378,2019.csv,2019,0.9461105813890192,0.05388941861098088
8715,The Hollars,1138609,1016985,121624,2016.csv,2016,0.8931819439333433,0.10681805606665677
8716,O Leão da Estrela,1137318,0,1137318,2015.csv,2015,0.0,1.0
8717,The White Knights,1137260,0,1137260,2016.csv,2016,0.0,1.0
8718,Peppa Pig: The Golden Boots 2016 Re-release,1137221,0,1137221,2016.csv,2016,0.0,1.0
8719,MILF,1136887,0,1136887,2018.csv,2018,0.0,1.0
8720,I Lost My Body,1136431,0,1136431,2019.csv,2019,0.0,1.0
8721,Hope Gap,1136167,104732,1031435,2020.csv,2020,0.09218011084638086,0.9078198891536191
8722,Steel Butterfly,1135569,0,1135569,2012.csv,2012,0.0,1.0
8723,Fathom Premieres 6 Below: Miracle on the Mountain,1135531,14838,1120693,2017.csv,2017,0.01306701446283721,0.9869329855371628
8724,Drift,1135498,0,1135498,2013.csv,2013,0.0,1.0
8725,Yok Artik,1135216,0,1135216,2015.csv,2015,0.0,1.0
8726,Pyaar Impossible!,1135177,0,1135177,2010.csv,2010,0.0,1.0
8727,Feuten: Het Feestje,1134795,0,1134795,2013.csv,2013,0.0,1.0
8728,Nomui Yukseup,1134562,0,1134562,2011.csv,2011,0.0,1.0
8729,The Perfect Wedding,1134146,0,1134146,2019.csv,2019,0.0,1.0
8730,Ali Kundilli 2,1133086,0,1133086,2016.csv,2016,0.0,1.0
8731,Cell,1133031,0,1133031,2016.csv,2016,0.0,1.0
8732,Miral,1132843,373420,759423,2010.csv,2010,0.3296308491114832,0.6703691508885168
8733,Summerland,1132620,58498,1074122,2020.csv,2020,0.051648390457523265,0.9483516095424768
8734,Bavaria - Traumreise durch Bayern,1131936,0,1131936,2012.csv,2012,0.0,1.0
8735,Dancer,1131649,71917,1059732,2016.csv,2016,0.06355062391253825,0.9364493760874617
8736,Stranger by the Lake,1131241,325196,806045,2013.csv,2013,0.2874683643891974,0.7125316356108027
8737,All About Men,1130610,0,1130610,2016.csv,2016,0.0,1.0
8738,Sailor Moon Eternal,1130225,0,1130225,2021.csv,2021,0.0,1.0
8739,Aura Star: Attack of the Temple,1130000,0,1130000,2015.csv,2015,0.0,1.0
8740,Smart Ass,1129817,0,1129817,2014.csv,2014,0.0,1.0
8741,Kim Bok-nam salinsageonui jeonmal,1129687,0,1129687,2010.csv,2010,0.0,1.0
8742,Born in Heinola,1128746,0,1128746,2016.csv,2016,0.0,1.0
8743,In Gold We Trust,1128544,0,1128544,2010.csv,2010,0.0,1.0
8744,Weekend,1128477,484592,643885,2011.csv,2011,0.4294212465118917,0.5705787534881083
8745,In the Name Of,1127938,9883,1118055,2013.csv,2013,0.008762006422338816,0.9912379935776612
8746,Tonio,1127097,0,1127097,2016.csv,2016,0.0,1.0
8747,Semi-Soet,1127059,0,1127059,2012.csv,2012,0.0,1.0
8748,Schastya! Zdorovya!,1126533,0,1126533,2018.csv,2018,0.0,1.0
8749,Borderline,1126107,0,1126107,2011.csv,2011,0.0,1.0
8750,Secret Sunday,1125867,0,1125867,2010.csv,2010,0.0,1.0
8751,The Time of Their Lives,1125526,0,1125526,2017.csv,2017,0.0,1.0
8752,Darr @ the Mall,1124893,0,1124893,2014.csv,2014,0.0,1.0
8753,Marionette,1124500,0,1124500,2018.csv,2018,0.0,1.0
8754,The Stagg Do,1124399,0,1124399,2014.csv,2014,0.0,1.0
8755,The Girl with Nine Wigs,1123902,0,1123902,2013.csv,2013,0.0,1.0
8756,Keep a Lid On It,1123818,0,1123818,2019.csv,2019,0.0,1.0
8757,Mother,1123459,0,1123459,2020.csv,2020,0.0,1.0
8758,"Goodbye, America",1123335,0,1123335,2020.csv,2020,0.0,1.0
8759,Gagarin. Pervyy v kosmose,1121976,0,1121976,2013.csv,2013,0.0,1.0
8760,La suerte en tus manos,1121331,0,1121331,2012.csv,2012,0.0,1.0
8761,Look Away,1119537,0,1119537,2018.csv,2018,0.0,1.0
8762,The Detective 2,1119052,0,1119052,2011.csv,2011,0.0,1.0
8763,Ma Xiaole and His Toys,1118780,0,1118780,2016.csv,2016,0.0,1.0
8764,Bebe,1118572,0,1118572,2013.csv,2013,0.0,1.0
8765,Fate/kaleid liner Prisma Illya,1118410,0,1118410,2017.csv,2017,0.0,1.0
8766,David Loman 2 2017 Re-release,1118155,0,1118155,2017.csv,2017,0.0,1.0
8767,The Circle,1117789,0,1117789,2015.csv,2015,0.0,1.0
8768,Papa Hemingway in Cuba,1117399,1115615,1784,2016.csv,2016,0.9984034351203106,0.00159656487968935
8769,The Crypt of Count Dracoola,1116184,0,1116184,2011.csv,2011,0.0,1.0
8770,The Mill and the Cross,1116180,312187,803993,2011.csv,2011,0.2796923435288215,0.7203076564711784
8771,Bloody House,1115856,0,1115856,2016.csv,2016,0.0,1.0
8772,The Metropolitan Opera HD Live: Donizetti: L'Elisir d'Amore,1115018,1115018,0,2018.csv,2018,1.0,0.0
8773,A War,1114663,122902,991761,2015.csv,2015,0.11025933398704361,0.8897406660129564
8774,The Movie of My Life,1114594,0,1114594,2017.csv,2017,0.0,1.0
8775,The Selfish Giant,1114027,12189,1101838,2013.csv,2013,0.01094138651935725,0.9890586134806427
8776,Max Three,1113235,0,1113235,2013.csv,2013,0.0,1.0
8777,Der letzte schöne Herbsttag,1113031,0,1113031,2010.csv,2010,0.0,1.0
8778,Juega Conmigo,1112703,0,1112703,2021.csv,2021,0.0,1.0
8779,Walking with the Enemy,1112592,1112592,0,2014.csv,2014,1.0,0.0
8780,Super Player,1112230,0,1112230,2010.csv,2010,0.0,1.0
8781,Hart Beat,1112059,0,1112059,2016.csv,2016,0.0,1.0
8782,Prezident Blaník,1111601,0,1111601,2018.csv,2018,0.0,1.0
8783,The Turning,1110918,0,1110918,2013.csv,2013,0.0,1.0
8784,Crash Test Aglaé,1110613,0,1110613,2017.csv,2017,0.0,1.0
8785,The Overnight,1110522,1110522,0,2015.csv,2015,1.0,0.0
8786,Qui c'est les plus forts?,1109649,0,1109649,2015.csv,2015,0.0,1.0
8787,Shikara,1109387,0,1109387,2020.csv,2020,0.0,1.0
8788,The Road Less Traveled,1109120,0,1109120,2010.csv,2010,0.0,1.0
8789,Printsessa i drakon,1108819,0,1108819,2018.csv,2018,0.0,1.0
8790,The Swimsuit Issue 2010 Re-release,1108616,0,1108616,2010.csv,2010,0.0,1.0
8791,Tabu,1108473,0,1108473,2012.csv,2012,0.0,1.0
8792,Askin ikinci yarisi,1108231,0,1108231,2010.csv,2010,0.0,1.0
8793,The Lion Standing in the Wind,1108162,0,1108162,2015.csv,2015,0.0,1.0
8794,Naked Harbour,1107210,0,1107210,2012.csv,2012,0.0,1.0
8795,Un jour mon père viendra,1107131,0,1107131,2012.csv,2012,0.0,1.0
8796,"Santiago, Italia",1106820,0,1106820,2018.csv,2018,0.0,1.0
8797,Robo,1106307,0,1106307,2019.csv,2019,0.0,1.0
8798,Anjaam Pathiraa,1106211,0,1106211,2020.csv,2020,0.0,1.0
8799,Desire Game,1106083,0,1106083,2019.csv,2019,0.0,1.0
8800,Psychobitch,1106069,0,1106069,2019.csv,2019,0.0,1.0
8801,Road to your Heart,1106034,0,1106034,2014.csv,2014,0.0,1.0
8802,My Neighbor Totoro 2019 Re-release,1105564,1105564,0,2019.csv,2019,1.0,0.0
8803,"Peace, Love & Misunderstanding",1105020,590700,514320,2012.csv,2012,0.5345604604441548,0.46543953955584516
8804,LOVEhunt,1104915,0,1104915,2019.csv,2019,0.0,1.0
8805,Dodgeball,1104245,0,1104245,2015.csv,2015,0.0,1.0
8806,Thanneermathan Dinangal,1103987,0,1103987,2019.csv,2019,0.0,1.0
8807,The Outlaw,1103960,0,1103960,2010.csv,2010,0.0,1.0
8808,Legend of Kung Fu Rabbit,1103780,0,1103780,2011.csv,2011,0.0,1.0
8809,The Magic Brush 2016 Re-release,1103646,0,1103646,2016.csv,2016,0.0,1.0
8810,"Tuya, mía... te la apuesto",1103585,0,1103585,2018.csv,2018,0.0,1.0
8811,The Heart Specialist,1103037,1103037,0,2011.csv,2011,1.0,0.0
8812,Game of Truth,1102806,0,1102806,2013.csv,2013,0.0,1.0
8813,Mon pote,1102650,0,1102650,2010.csv,2010,0.0,1.0
8814,The Insanity of God,1102525,1102525,0,2016.csv,2016,1.0,0.0
8815,We Were Young,1102453,0,1102453,2015.csv,2015,0.0,1.0
8816,Innocence,1102022,0,1102022,2011.csv,2011,0.0,1.0
8817,El Coyote,1101470,1101470,0,2019.csv,2019,1.0,0.0
8818,The Precipice Game,1100481,0,1100481,2016.csv,2016,0.0,1.0
8819,Beyond the Reach,1100432,45895,1054537,2015.csv,2015,0.04170634805240124,0.9582936519475987
8820,The Basement,1100000,0,1100000,2012.csv,2012,0.0,1.0
8821,The Secret Men Club,1099982,0,1099982,2019.csv,2019,0.0,1.0
8822,Los Marziano,1099767,0,1099767,2011.csv,2011,0.0,1.0
8823,Babovresky 3,1099482,0,1099482,2015.csv,2015,0.0,1.0
8824,Fast Convoy,1099000,0,1099000,2016.csv,2016,0.0,1.0
8825,A Chaster Marriage,1096103,0,1096103,2016.csv,2016,0.0,1.0
8826,Magika,1095239,0,1095239,2010.csv,2010,0.0,1.0
8827,Hokus pokus Albert Åberg,1094765,0,1094765,2013.csv,2013,0.0,1.0
8828,Men Suddenly in Love,1094277,0,1094277,2011.csv,2011,0.0,1.0
8829,Columbus,1093077,1017107,75970,2017.csv,2017,0.9304989492963441,0.06950105070365582
8830,Northern Soul,1092359,8886,1083473,2014.csv,2014,0.008134688321330259,0.9918653116786698
8831,Bombshell: The Hedy Lamarr Story,1092277,820300,271977,2017.csv,2017,0.7509999752809956,0.24900002471900443
8832,El Coco 2,1091959,0,1091959,2017.csv,2017,0.0,1.0
8833,Happy 140,1091902,0,1091902,2015.csv,2015,0.0,1.0
8834,The Lion Men: Ultimate Showdown,1091666,0,1091666,2014.csv,2014,0.0,1.0
8835,On the Edge,1091203,0,1091203,2020.csv,2020,0.0,1.0
8836,The Son of No One,1091132,30680,1060452,2011.csv,2011,0.028117587972857547,0.9718824120271424
8837,Maryline,1090283,0,1090283,2017.csv,2017,0.0,1.0
8838,Three Wise Cousins,1090194,0,1090194,2016.csv,2016,0.0,1.0
8839,National Theatre Live: Les Liaisons Dangereuses,1090137,0,1090137,2016.csv,2016,0.0,1.0
8840,The Platform,1090116,0,1090116,2019.csv,2019,0.0,1.0
8841,Bábovky,1089817,0,1089817,2020.csv,2020,0.0,1.0
8842,V3: Road Bully,1089691,0,1089691,2010.csv,2010,0.0,1.0
8843,"Hello, Love, Goodbye",1089515,0,1089515,2019.csv,2019,0.0,1.0
8844,The Goonies 2019 Re-release,1089463,864378,225085,2019.csv,2019,0.7933982154510983,0.2066017845489016
8845,The Sky Is Pink,1088641,652592,436049,2019.csv,2019,0.5994556515876216,0.40054434841237835
8846,Iwane: Sword of Serenity,1088355,0,1088355,2019.csv,2019,0.0,1.0
8847,Michelangelo - Infinito,1087874,0,1087874,2018.csv,2018,0.0,1.0
8848,Haikyu! Owari to Hajimari Part 1,1087732,0,1087732,2015.csv,2015,0.0,1.0
8849,Our Lady of Apareceda,1087591,0,1087591,2010.csv,2010,0.0,1.0
8850,Aria the Crepuscolo,1087319,0,1087319,2021.csv,2021,0.0,1.0
8851,Sons of Rizk 2,1087227,0,1087227,2019.csv,2019,0.0,1.0
8852,The Missing Lynx 2010 Re-release,1087197,0,1087197,2010.csv,2010,0.0,1.0
8853,The Very Private Life of Mister Sim,1087025,0,1087025,2015.csv,2015,0.0,1.0
8854,The Bare Necessity,1086757,0,1086757,2019.csv,2019,0.0,1.0
8855,Genomu hazâdo: Aru tensai kagakusha no 5-kakan,1086459,0,1086459,2014.csv,2014,0.0,1.0
8856,Wat Mannen Willen,1086352,0,1086352,2015.csv,2015,0.0,1.0
8857,Sen Benim HerSeyimsin,1085674,0,1085674,2016.csv,2016,0.0,1.0
8858,Return to Nim's Island,1084695,0,1084695,2013.csv,2013,0.0,1.0
8859,Recuperando a mi Ex,1083688,0,1083688,2018.csv,2018,0.0,1.0
8860,Hidden Moon,1083489,0,1083489,2012.csv,2012,0.0,1.0
8861,Sunset,1083299,164906,918393,2018.csv,2018,0.15222574746215034,0.8477742525378497
8862,K3 Love Cruise,1082936,0,1082936,2017.csv,2017,0.0,1.0
8863,Luv Ka the End,1082818,0,1082818,2011.csv,2011,0.0,1.0
8864,Jesus Is King,1082629,973000,109629,2019.csv,2019,0.8987381642280042,0.10126183577199577
8865,Toys' War,1082496,0,1082496,2016.csv,2016,0.0,1.0
8866,The Class 4,1082463,0,1082463,2015.csv,2015,0.0,1.0
8867,Mystify: Michael Hutchence,1082456,289573,792883,2019.csv,2019,0.2675147996777698,0.7324852003222302
8868,It's a Wonderful Life,1081304,0,1081304,2018.csv,2018,0.0,1.0
8869,Troll: The Tale of a Tail,1080895,0,1080895,2018.csv,2018,0.0,1.0
8870,"Welcome Home, Hayabusa",1080837,0,1080837,2012.csv,2012,0.0,1.0
8871,Godbeast Megazord: Return of Green Dragon,1080518,0,1080518,2016.csv,2016,0.0,1.0
8872,To eteron imisy,1080124,0,1080124,2011.csv,2011,0.0,1.0
8873,Krepost,1079753,0,1079753,2015.csv,2015,0.0,1.0
8874,The Road Not Taken,1079373,0,1079373,2018.csv,2018,0.0,1.0
8875,Oglum bak git,1079172,0,1079172,2012.csv,2012,0.0,1.0
8876,How to Steal a Dog,1079054,0,1079054,2014.csv,2014,0.0,1.0
8877,Summer's Desire,1078906,0,1078906,2016.csv,2016,0.0,1.0
8878,24 Days,1078520,0,1078520,2014.csv,2014,0.0,1.0
8879,Andra sidan,1078376,0,1078376,2020.csv,2020,0.0,1.0
8880,Swiety interes,1078062,0,1078062,2010.csv,2010,0.0,1.0
8881,Page One: Inside the New York Times,1077982,1067028,10954,2011.csv,2011,0.9898384203075747,0.010161579692425291
8882,Jackpot,1077778,0,1077778,2011.csv,2011,0.0,1.0
8883,Munthirivallikal Thalirkkumbol,1077480,0,1077480,2017.csv,2017,0.0,1.0
8884,The Orheim Company,1076947,0,1076947,2012.csv,2012,0.0,1.0
8885,Mural,1076726,0,1076726,2011.csv,2011,0.0,1.0
8886,In the Shadow of Naga,1075849,0,1075849,2010.csv,2010,0.0,1.0
8887,Big Love,1075830,0,1075830,2012.csv,2012,0.0,1.0
8888,The Last Diamond,1075450,0,1075450,2014.csv,2014,0.0,1.0
8889,On the Milky Road,1075258,0,1075258,2016.csv,2016,0.0,1.0
8890,The Way We Keep Dancing,1074644,0,1074644,2021.csv,2021,0.0,1.0
8891,Seven Souls in the Skull Castle,1074459,0,1074459,2012.csv,2012,0.0,1.0
8892,À coup sûr,1074329,0,1074329,2014.csv,2014,0.0,1.0
8893,Enchanted Princess,1074294,0,1074294,2018.csv,2018,0.0,1.0
8894,Merci pour tout,1073969,1073969,0,2019.csv,2019,1.0,0.0
8895,Neurotic Quest for Serenity,1073608,0,1073608,2017.csv,2017,0.0,1.0
8896,It Was the Son,1073326,0,1073326,2012.csv,2012,0.0,1.0
8897,To Fool a Thief,1073290,0,1073290,2013.csv,2013,0.0,1.0
8898,Sifu vs. Vampire,1072968,0,1072968,2014.csv,2014,0.0,1.0
8899,The First Monday in May,1072943,527474,545469,2016.csv,2016,0.4916141864013279,0.5083858135986721
8900,Fanny's Journey,1072710,0,1072710,2016.csv,2016,0.0,1.0
8901,Lady Daddy,1072598,0,1072598,2010.csv,2010,0.0,1.0
8902,Marriage with a Liar,1072505,0,1072505,2010.csv,2010,0.0,1.0
8903,Killing Season,1071322,39881,1031441,2013.csv,2013,0.03722596940975729,0.9627740305902427
8904,Chal Mera Putt 2,1070997,445000,625997,2020.csv,2020,0.4155006970140906,0.5844993029859094
8905,White as Snow,1070755,0,1070755,2010.csv,2010,0.0,1.0
8906,Love and Monsters,1070714,1070714,0,2020.csv,2020,1.0,0.0
8907,Lan Kwai Fong,1069859,0,1069859,2011.csv,2011,0.0,1.0
8908,Platteland,1069699,0,1069699,2011.csv,2011,0.0,1.0
8909,Chhalawa,1069474,0,1069474,2019.csv,2019,0.0,1.0
8910,Crisis,1069110,404738,664372,2021.csv,2021,0.3785747023224925,0.6214252976775074
8911,A Song for Mama,1068979,0,1068979,2013.csv,2013,0.0,1.0
8912,The Poll Diaries,1068745,0,1068745,2010.csv,2010,0.0,1.0
8913,Las ovejas no pierden el tren,1068545,0,1068545,2015.csv,2015,0.0,1.0
8914,My Step Dad: The Hippie,1068128,0,1068128,2018.csv,2018,0.0,1.0
8915,Sararîman neo gekijouban (Warai),1068114,0,1068114,2011.csv,2011,0.0,1.0
8916,Grand Prix,1068035,0,1068035,2010.csv,2010,0.0,1.0
8917,El Psiquiatra,1067654,0,1067654,2014.csv,2014,0.0,1.0
8918,Srochno vyydu zamuzh,1067507,0,1067507,2015.csv,2015,0.0,1.0
8919,Lembi 8 Giga,1066851,0,1066851,2010.csv,2010,0.0,1.0
8920,Au nom de ma fille,1066493,1623,1064870,2016.csv,2016,0.001521810269734541,0.9984781897302655
8921,Victor and the Secret of Crocodile Mansion,1066490,0,1066490,2012.csv,2012,0.0,1.0
8922,Incir Reçeli,1066192,0,1066192,2011.csv,2011,0.0,1.0
8923,Faultless,1065961,0,1065961,2016.csv,2016,0.0,1.0
8924,The Oogieloves in the Big Balloon Adventure,1065907,1065907,0,2012.csv,2012,1.0,0.0
8925,Private Eye Vares 2011 Re-release,1065663,0,1065663,2011.csv,2011,0.0,1.0
8926,The Monuments Men 2015 Re-release,1064988,0,1064988,2015.csv,2015,0.0,1.0
8927,Viaje de generación,1064845,0,1064845,2012.csv,2012,0.0,1.0
8928,Bennett's War,1064783,1056416,8367,2019.csv,2019,0.9921420608706187,0.007857939129381292
8929,Mystery,1064669,0,1064669,2012.csv,2012,0.0,1.0
8930,50 to 1,1064454,1064454,0,2014.csv,2014,1.0,0.0
8931,Truth About Men,1064448,0,1064448,2010.csv,2010,0.0,1.0
8932,The Last Warrior,1062977,0,1062977,2018.csv,2018,0.0,1.0
8933,La Mission,1062941,1062941,0,2010.csv,2010,1.0,0.0
8934,Dangerous Ishq,1062825,0,1062825,2012.csv,2012,0.0,1.0
8935,Santa Claus!,1061955,0,1061955,2014.csv,2014,0.0,1.0
8936,00 Schneider - Im Wendekreis der Eidechse,1061348,0,1061348,2013.csv,2013,0.0,1.0
8937,The Great Actor,1060706,0,1060706,2016.csv,2016,0.0,1.0
8938,Asphalt Playground,1060094,0,1060094,2013.csv,2013,0.0,1.0
8939,The Noble Spirit,1060000,0,1060000,2014.csv,2014,0.0,1.0
8940,Una hora más en Canarias,1059788,0,1059788,2010.csv,2010,0.0,1.0
8941,Top Star,1059692,0,1059692,2013.csv,2013,0.0,1.0
8942,Carlos,1059369,145526,913843,2010.csv,2010,0.1373704535435717,0.8626295464564283
8943,Rendez-vous,1059334,0,1059334,2015.csv,2015,0.0,1.0
8944,Secret Love,1058979,0,1058979,2010.csv,2010,0.0,1.0
8945,Brèves de comptoir,1057384,0,1057384,2014.csv,2014,0.0,1.0
8946,Mug,1056762,0,1056762,2018.csv,2018,0.0,1.0
8947,Mobile Suit Gundam: The Origin I - Blue-Eyed Casval,1056670,0,1056670,2015.csv,2015,0.0,1.0
8948,Already Famous,1055977,0,1055977,2011.csv,2011,0.0,1.0
8949,30° couleur,1055939,0,1055939,2012.csv,2012,0.0,1.0
8950,A Canção de Lisboa,1055809,0,1055809,2016.csv,2016,0.0,1.0
8951,Chef 2018 Re-release,1055627,0,1055627,2015.csv,2015,0.0,1.0
8952,Changing China: Life is Marvelous Because of You,1055035,0,1055035,2019.csv,2019,0.0,1.0
8953,Paulina,1053919,0,1053919,2015.csv,2015,0.0,1.0
8954,Gold Digger,1052730,0,1052730,2016.csv,2016,0.0,1.0
8955,Seytan-i racim,1052403,0,1052403,2013.csv,2013,0.0,1.0
8956,4Some,1052344,0,1052344,2012.csv,2012,0.0,1.0
8957,Extinct,1052320,0,1052320,2021.csv,2021,0.0,1.0
8958,211,1052222,0,1052222,2018.csv,2018,0.0,1.0
8959,Once a Gangster,1052022,0,1052022,2010.csv,2010,0.0,1.0
8960,Borgman,1052010,57474,994536,2013.csv,2013,0.05463256052699119,0.9453674394730088
8961,Questa storia qua,1051919,0,1051919,2011.csv,2011,0.0,1.0
8962,Madhuraraja,1051859,0,1051859,2019.csv,2019,0.0,1.0
8963,Selfie,1051848,0,1051848,2020.csv,2020,0.0,1.0
8964,Hong Kong-Zhuhai-Macao Bridge,1051006,0,1051006,2019.csv,2019,0.0,1.0
8965,10 Rules for Falling in Love,1050875,0,1050875,2012.csv,2012,0.0,1.0
8966,Sir,1050318,0,1050318,2018.csv,2018,0.0,1.0
8967,Forever and a Day,1049218,0,1049218,2011.csv,2011,0.0,1.0
8968,No One Lives,1048704,74918,973786,2013.csv,2013,0.07143865189796167,0.9285613481020383
8969,Sin,1048603,0,1048603,2019.csv,2019,0.0,1.0
8970,What's in the Darkness,1047648,0,1047648,2016.csv,2016,0.0,1.0
8971,Princess Mononoke 2019 Re-release,1046446,1046446,0,2019.csv,2019,1.0,0.0
8972,Lingaa,1046138,0,1046138,2014.csv,2014,0.0,1.0
8973,Becky,1045873,1003700,42173,2020.csv,2020,0.9596767485153551,0.040323251484644884
8974,"Love, Again",1045641,0,1045641,2018.csv,2018,0.0,1.0
8975,Imagine,1045292,0,1045292,2013.csv,2013,0.0,1.0
8976,Above Dark Waters,1045022,0,1045022,2013.csv,2013,0.0,1.0
8977,A Brilliant Young Mind,1043620,171793,871827,2015.csv,2015,0.16461259845537649,0.8353874015446235
8978,Raising Colors,1043269,0,1043269,2018.csv,2018,0.0,1.0
8979,Adorables,1043185,0,1043185,2020.csv,2020,0.0,1.0
8980,Secuestro,1043076,0,1043076,2016.csv,2016,0.0,1.0
8981,Made In Mexico,1042673,151133,891540,2012.csv,2012,0.14494764897527795,0.855052351024722
8982,Fotograf,1042458,0,1042458,2015.csv,2015,0.0,1.0
8983,Omicidio all'italiana,1042265,0,1042265,2017.csv,2017,0.0,1.0
8984,House of Hummingbird,1041948,0,1041948,2019.csv,2019,0.0,1.0
8985,Mortician,1041725,0,1041725,2013.csv,2013,0.0,1.0
8986,Sat2Mon,1041616,0,1041616,2012.csv,2012,0.0,1.0
8987,My So-Called Father,1041599,0,1041599,2014.csv,2014,0.0,1.0
8988,Román pro pokrocilé,1041469,0,1041469,2019.csv,2019,0.0,1.0
8989,Spark: A Space Tail,1040689,196458,844231,2017.csv,2017,0.18877685840822764,0.8112231415917723
8990,Befikre,1040421,498000,542421,2016.csv,2016,0.4786523916760619,0.5213476083239381
8991,Vatertage - Opa über Nacht,1039680,0,1039680,2012.csv,2012,0.0,1.0
8992,Dnyukha!,1039637,0,1039637,2018.csv,2018,0.0,1.0
8993,Come Across Love: Bu Qi Er Yu,1039439,0,1039439,2017.csv,2017,0.0,1.0
8994,Love Sarah,1039214,0,1039214,2020.csv,2020,0.0,1.0
8995,Vir Altyd,1039197,0,1039197,2016.csv,2016,0.0,1.0
8996,Me and Kaminski,1038921,0,1038921,2015.csv,2015,0.0,1.0
8997,Sex & Drugs & Rock & Roll,1038699,0,1038699,2010.csv,2010,0.0,1.0
8998,Righteous Kill 2010 Re-release,1038147,0,1038147,2010.csv,2010,0.0,1.0
8999,Spoor,1037551,0,1037551,2017.csv,2017,0.0,1.0
9000,The Dark Crystal 2018 Re-release,1036956,1036956,0,2018.csv,2018,1.0,0.0
9001,Non c'è 2 senza te,1035832,0,1035832,2015.csv,2015,0.0,1.0
9002,Noah,1035603,1035603,0,2019.csv,2019,1.0,0.0
9003,Our Futures,1035527,0,1035527,2015.csv,2015,0.0,1.0
9004,Close Enemy 2010 Re-release,1035474,0,1035474,2010.csv,2010,0.0,1.0
9005,The Last Shift,1035128,1034467,661,2020.csv,2020,0.9993614316297115,0.0006385683702885054
9006,The Final Lesson,1034905,0,1034905,2015.csv,2015,0.0,1.0
9007,Guns Akimbo,1034769,0,1034769,2020.csv,2020,0.0,1.0
9008,Hong Kong Rescue,1034623,0,1034623,2018.csv,2018,0.0,1.0
9009,Ex,1034580,0,1034580,2010.csv,2010,0.0,1.0
9010,Captain Thunder,1034558,0,1034558,2011.csv,2011,0.0,1.0
9011,Pilsudski,1034548,0,1034548,2019.csv,2019,0.0,1.0
9012,Unconditional,1034448,1005800,28648,2012.csv,2012,0.9723060028150279,0.02769399718497208
9013,Aoki Hagane no Arpeggio: Ars Nova,1034244,0,1034244,2015.csv,2015,0.0,1.0
9014,All the Way to Bloom,1034133,0,1034133,2017.csv,2017,0.0,1.0
9015,Keep Your Hands Off Eizouken!,1034117,0,1034117,2020.csv,2020,0.0,1.0
9016,Ask Tesadüfleri Sever 2,1033730,0,1033730,2020.csv,2020,0.0,1.0
9017,Hep Yek,1033257,0,1033257,2016.csv,2016,0.0,1.0
9018,Varg Veum - Kalde hjerter,1033226,0,1033226,2012.csv,2012,0.0,1.0
9019,Pappa pia,1032951,0,1032951,2017.csv,2017,0.0,1.0
9020,Ambassada,1032822,0,1032822,2013.csv,2013,0.0,1.0
9021,El espejo de los otros,1031578,0,1031578,2015.csv,2015,0.0,1.0
9022,Fjols til Fjells,1031512,0,1031512,2020.csv,2020,0.0,1.0
9023,Sadko,1031256,0,1031256,2018.csv,2018,0.0,1.0
9024,Ain't Them Bodies Saints,1031243,396519,634724,2013.csv,2013,0.38450588270659775,0.6154941172934022
9025,We Are Family,1031070,638144,392926,2010.csv,2010,0.6189143317136567,0.3810856682863433
9026,Little Lucky,1029983,0,1029983,2017.csv,2017,0.0,1.0
9027,Quiet Comes the Dawn,1028949,0,1028949,2019.csv,2019,0.0,1.0
9028,The Promise,1028708,0,1028708,2017.csv,2017,0.0,1.0
9029,Prensesin Uykusu,1028566,0,1028566,2010.csv,2010,0.0,1.0
9030,Sentence Me Guilty,1028343,0,1028343,2016.csv,2016,0.0,1.0
9031,Yom Maloosh Lazmah,1026687,0,1026687,2015.csv,2015,0.0,1.0
9032,Knight of Cups,1026288,566006,460282,2015.csv,2015,0.5515079587796018,0.44849204122039815
9033,I Feel Better,1026212,0,1026212,2018.csv,2018,0.0,1.0
9034,The Attempt Dossier,1025827,0,1025827,2010.csv,2010,0.0,1.0
9035,Firildak Ailesi,1025750,0,1025750,2017.csv,2017,0.0,1.0
9036,Rey Gitano,1025646,0,1025646,2015.csv,2015,0.0,1.0
9037,Shadow in the Cloud,1024767,156932,867835,2021.csv,2021,0.15313920139895215,0.8468607986010478
9038,Havel,1024686,0,1024686,2020.csv,2020,0.0,1.0
9039,Casablanca 2017 Re-release,1024560,1024560,0,2017.csv,2017,1.0,0.0
9040,Legally Declared Dead,1024495,0,1024495,2020.csv,2020,0.0,1.0
9041,The Crimean Bridge. Made with Love!,1024299,0,1024299,2018.csv,2018,0.0,1.0
9042,Bao Mau Sieu Quay,1024278,0,1024278,2015.csv,2015,0.0,1.0
9043,Bachelor Days Are Over,1024166,0,1024166,2011.csv,2011,0.0,1.0
9044,Tangerines,1024132,144501,879631,2015.csv,2015,0.14109606964727203,0.8589039303527279
9045,Dark Country,1024015,0,1024015,2010.csv,2010,0.0,1.0
9046,Color Out of Space,1023510,765561,257949,2020.csv,2020,0.7479760823050092,0.2520239176949908
9047,The Metropolitan Opera HD Live: Puccini: La Fanciulla del West,1023233,1023233,0,2018.csv,2018,1.0,0.0
9048,Maze,1022664,0,1022664,2017.csv,2017,0.0,1.0
9049,David Gilmour: Live At Pompeii,1022648,0,1022648,2017.csv,2017,0.0,1.0
9050,Princess and the Kingdom,1021930,0,1021930,2018.csv,2018,0.0,1.0
9051,Claire Darling,1021454,0,1021454,2019.csv,2019,0.0,1.0
9052,The Golden Dream,1021223,0,1021223,2013.csv,2013,0.0,1.0
9053,Adults in the Room,1021200,0,1021200,2019.csv,2019,0.0,1.0
9054,Mission Pays Basque,1021120,0,1021120,2017.csv,2017,0.0,1.0
9055,Route Irish,1020385,0,1020385,2011.csv,2011,0.0,1.0
9056,Leaves of Grass,1018753,70066,948687,2010.csv,2010,0.06877623918653492,0.9312237608134651
9057,Days of Wrath,1018646,0,1018646,2013.csv,2013,0.0,1.0
9058,The Oscar Nominated Short Films 2010: Live Action,1018169,1018169,0,2010.csv,2010,1.0,0.0
9059,Hallåhallå,1016602,0,1016602,2014.csv,2014,0.0,1.0
9060,Husband Material,1016545,567417,449128,2018.csv,2018,0.5581818807824543,0.4418181192175457
9061,Klassikokkutulek,1016456,0,1016456,2016.csv,2016,0.0,1.0
9062,Król zycia,1015112,0,1015112,2015.csv,2015,0.0,1.0
9063,Deeper!,1014750,0,1014750,2020.csv,2020,0.0,1.0
9064,Raavanan,1013921,0,1013921,2010.csv,2010,0.0,1.0
9065,My Valentine Girls,1013920,0,1013920,2011.csv,2011,0.0,1.0
9066,If I Were You,1013899,0,1013899,2018.csv,2018,0.0,1.0
9067,Visions,1013805,0,1013805,2015.csv,2015,0.0,1.0
9068,Golden Years,1013214,0,1013214,2017.csv,2017,0.0,1.0
9069,Night Hunter,1012932,0,1012932,2019.csv,2019,0.0,1.0
9070,Big Stone Gap,1012804,1009301,3503,2015.csv,2015,0.9965412853819693,0.0034587146180307345
9071,Transit,1012747,815290,197457,2018.csv,2018,0.8050283042062825,0.19497169579371748
9072,Beste Chance,1012611,0,1012611,2014.csv,2014,0.0,1.0
9073,Placa de Acero,1011555,0,1011555,2019.csv,2019,0.0,1.0
9074,Die Mamba,1011515,0,1011515,2014.csv,2014,0.0,1.0
9075,Nakajima Miyuki Live: Utatabi gekijouban,1011181,0,1011181,2012.csv,2012,0.0,1.0
9076,L'attesa,1010766,55804,954962,2015.csv,2015,0.05520961330317799,0.944790386696822
9077,Elvis: The Comeback Special,1010657,1010657,0,2018.csv,2018,1.0,0.0
9078,Sen Kiminle Dans Ediyorsun,1010493,0,1010493,2017.csv,2017,0.0,1.0
9079,Far from Men,1010485,5336,1005149,2015.csv,2015,0.0052806325675294535,0.9947193674324706
9080,Passione sinistra,1010312,0,1010312,2013.csv,2013,0.0,1.0
9081,Cold Blood,1009888,5083,1004805,2019.csv,2019,0.005033231407839285,0.9949667685921607
9082,The Song,1009620,1009620,0,2014.csv,2014,1.0,0.0
9083,#Nerealnaya lyubov,1009585,0,1009585,2014.csv,2014,0.0,1.0
9084,Maya the Bee Movie 2018 Re-release,1009268,0,1009268,2018.csv,2018,0.0,1.0
9085,Now or Never,1008807,0,1008807,2014.csv,2014,0.0,1.0
9086,Francofonia,1008154,307040,701114,2015.csv,2015,0.3045566451157264,0.6954433548842737
9087,Sidewalls,1008116,2377,1005739,2011.csv,2011,0.0023578635791912834,0.9976421364208087
9088,Part-time Spy,1007301,0,1007301,2017.csv,2017,0.0,1.0
9089,The First Man,1006991,0,1006991,2012.csv,2012,0.0,1.0
9090,Dreams 2020 Re-release,1006954,0,1006954,2020.csv,2020,0.0,1.0
9091,Dhay Fe Abu Dhabi,1006388,0,1006388,2016.csv,2016,0.0,1.0
9092,Johan Falk: Kodnamn: Lisa,1005404,0,1005404,2013.csv,2013,0.0,1.0
9093,The Love Clinic,1005275,0,1005275,2010.csv,2010,0.0,1.0
9094,Remember Me?,1005018,0,1005018,2014.csv,2014,0.0,1.0
9095,Sinister Circle,1004914,0,1004914,2015.csv,2015,0.0,1.0
9096,Ghost House,1004155,0,1004155,2017.csv,2017,0.0,1.0
9097,Faith of Our Fathers,1004105,1004105,0,2015.csv,2015,1.0,0.0
9098,Kiki's Delivery Service 2019 Re-release,1004057,1004057,0,2019.csv,2019,1.0,0.0
9099,The North Wind,1003414,0,1003414,2021.csv,2021,0.0,1.0
9100,Julio Sumiu,1002833,0,1002833,2014.csv,2014,0.0,1.0
9101,London River 2010 Re-release,1002486,0,1002486,2010.csv,2010,0.0,1.0
9102,Di Di Hollywood,1002398,0,1002398,2010.csv,2010,0.0,1.0
9103,Comment c'est loin,1001196,0,1001196,2015.csv,2015,0.0,1.0
9104,Onigamiden - Legend of the Millennium Dragon,1000626,0,1000626,2011.csv,2011,0.0,1.0
9105,"Polina, danser sa vie",1000474,165203,835271,2016.csv,2016,0.16512473087756405,0.8348752691224359
9106,The Workshop,1000056,22061,977995,2017.csv,2017,0.022059764653179423,0.9779402353468206
9107,La mossa del pinguino,999593,0,999593,2014.csv,2014,0.0,1.0
9108,A.C.O.R.N.S.: Operation Crackdown,998746,0,998746,2015.csv,2015,0.0,1.0
9109,Frozen 2020 Re-release,998659,215000,783659,2020.csv,2020,0.2152887021495826,0.7847112978504174
9110,Gabbar is Back,998582,534601,463981,2015.csv,2015,0.5353601406794835,0.4646398593205165
9111,All That I Love,998322,0,998322,2010.csv,2010,0.0,1.0
9112,Material,998291,0,998291,2012.csv,2012,0.0,1.0
9113,National Theatre Live: Antony & Cleopatra,998079,83672,914407,2018.csv,2018,0.08383304327613346,0.9161669567238665
9114,Les pépites,998059,0,998059,2016.csv,2016,0.0,1.0
9115,Love in the End,997852,0,997852,2013.csv,2013,0.0,1.0
9116,Pet Pals,997534,0,997534,2010.csv,2010,0.0,1.0
9117,Masha and the Bear 2,997231,0,997231,2018.csv,2018,0.0,1.0
9118,Angélique,996304,0,996304,2013.csv,2013,0.0,1.0
9119,Brasserie Romantiek,996191,0,996191,2012.csv,2012,0.0,1.0
9120,Photograph,996171,344534,651637,2019.csv,2019,0.34585829139776203,0.654141708602238
9121,Burn,996103,996103,0,2012.csv,2012,1.0,0.0
9122,Sherpa,996031,0,996031,2015.csv,2015,0.0,1.0
9123,Rundfunk: Jachterwachter,995992,0,995992,2020.csv,2020,0.0,1.0
9124,Long Live Freedom 2014 Re-release,995990,48541,947449,2014.csv,2014,0.04873643309671784,0.9512635669032822
9125,Dad for Rent,995908,0,995908,2014.csv,2014,0.0,1.0
9126,Golden Brother,995702,0,995702,2014.csv,2014,0.0,1.0
9127,Don't Tell Her,995651,0,995651,2017.csv,2017,0.0,1.0
9128,Tag,995024,0,995024,2015.csv,2015,0.0,1.0
9129,The 101-Year-Old Man Who Skipped Out on the Bill and Disappeared,994901,0,994901,2016.csv,2016,0.0,1.0
9130,Superstar Teacher,994646,0,994646,2019.csv,2019,0.0,1.0
9131,Magallanes,994513,0,994513,2015.csv,2015,0.0,1.0
9132,Erkek tarafi testosteron,994165,0,994165,2013.csv,2013,0.0,1.0
9133,Child's Pose,994126,97170,896956,2013.csv,2013,0.09774414913200137,0.9022558508679986
9134,Rölli and the Secret of All Time,993655,0,993655,2016.csv,2016,0.0,1.0
9135,Usted No Sabe Quien Soy Yo 2,993399,0,993399,2017.csv,2017,0.0,1.0
9136,Labyrinth 2018 Re-release,993336,993336,0,2013.csv,2013,1.0,0.0
9137,Blue Ruin,993313,258384,734929,2014.csv,2014,0.2601234454799243,0.7398765545200757
9138,Dark Impulse,993275,0,993275,2012.csv,2012,0.0,1.0
9139,Underdogs 2016 Re-release,993221,0,993221,2016.csv,2016,0.0,1.0
9140,Ella and Friends 2,992897,0,992897,2013.csv,2013,0.0,1.0
9141,Single Lady,992402,0,992402,2015.csv,2015,0.0,1.0
9142,Nan Ren Ru Yi Fu,992261,0,992261,2012.csv,2012,0.0,1.0
9143,White Vengeance,992195,0,992195,2011.csv,2011,0.0,1.0
9144,Beyond Skyline,992181,0,992181,2017.csv,2017,0.0,1.0
9145,Pat a Mat: Kutilske trampoty,992117,0,992117,2019.csv,2019,0.0,1.0
9146,On the Rocks,992103,0,992103,2020.csv,2020,0.0,1.0
9147,La fuitina sbagliata,992070,0,992070,2018.csv,2018,0.0,1.0
9148,Antboy 3,991603,0,991603,2016.csv,2016,0.0,1.0
9149,Perez.,991494,0,991494,2014.csv,2014,0.0,1.0
9150,Wild Amsterdam,991167,0,991167,2018.csv,2018,0.0,1.0
9151,The Piano in a Factory,989775,0,989775,2011.csv,2011,0.0,1.0
9152,I'm Livin' It,989423,0,989423,2020.csv,2020,0.0,1.0
9153,3 A.M. 3D: Part 2,989366,0,989366,2014.csv,2014,0.0,1.0
9154,Thursday & 12,988820,0,988820,2014.csv,2014,0.0,1.0
9155,The Nightingale,988687,400209,588478,2019.csv,2019,0.4047883708393051,0.5952116291606949
9156,"Pororo, the Snow Fairy Village Adventure",987918,0,987918,2014.csv,2014,0.0,1.0
9157,Blackthorn,987883,200558,787325,2011.csv,2011,0.20301796872706585,0.7969820312729341
9158,Women Without Men,987871,0,987871,2010.csv,2010,0.0,1.0
9159,Ren yue li hun hou,987867,0,987867,2011.csv,2011,0.0,1.0
9160,Big Bang Made the Movie 2017 Re-release,986569,0,986569,2017.csv,2017,0.0,1.0
9161,Kuroko's Basketball: Last Game 2018 Re-release,985710,0,985710,2018.csv,2018,0.0,1.0
9162,Operasjon Mumie,985684,0,985684,2019.csv,2019,0.0,1.0
9163,La última cima,985669,0,985669,2010.csv,2010,0.0,1.0
9164,Oggy and the Cockroaches: The Movie,985463,0,985463,2013.csv,2013,0.0,1.0
9165,I Do,985402,0,985402,2010.csv,2010,0.0,1.0
9166,Gråtass får en ny venn,985392,0,985392,2011.csv,2011,0.0,1.0
9167,Recovery,985197,0,985197,2010.csv,2010,0.0,1.0
9168,The Greatest,985181,114766,870415,2010.csv,2010,0.1164922993845801,0.8835077006154199
9169,Documentary of AKB48: The Time Has Come,984757,0,984757,2014.csv,2014,0.0,1.0
9170,American Masters: Miles Davis: Birth of the Cool,984499,614201,370298,2019.csv,2019,0.6238716342017615,0.3761283657982385
9171,Freedom on Parole,984399,0,984399,2010.csv,2010,0.0,1.0
9172,Imprisoned: Survival Guide for Rich and Prodigal,983794,0,983794,2015.csv,2015,0.0,1.0
9173,Babyteeth,983518,4507,979011,2020.csv,2020,0.004582529247049876,0.9954174707529502
9174,Being Flynn,983124,540152,442972,2012.csv,2012,0.5494240807873676,0.4505759192126324
9175,Ella Bella Bingo,982528,0,982528,2020.csv,2020,0.0,1.0
9176,Achter de wolken,982277,0,982277,2016.csv,2016,0.0,1.0
9177,Schindler's List 2018 Re-release,981489,833050,148439,2018.csv,2018,0.8487614226955167,0.15123857730448328
9178,Kruimeltje,981341,0,981341,2020.csv,2020,0.0,1.0
9179,0.0 Mhz,980593,0,980593,2019.csv,2019,0.0,1.0
9180,Em Nome da Lei,980418,0,980418,2016.csv,2016,0.0,1.0
9181,Nove lune e mezza,979703,0,979703,2017.csv,2017,0.0,1.0
9182,Mr. Pip,977855,1714,976141,2013.csv,2013,0.0017528161128183626,0.9982471838871816
9183,Stuck in Love.,977671,81071,896600,2013.csv,2013,0.08292257824973841,0.9170774217502616
9184,Per Fugelli: Siste resept,977601,0,977601,2018.csv,2018,0.0,1.0
9185,A Busy Night,977392,0,977392,2016.csv,2016,0.0,1.0
9186,Making Family,977337,0,977337,2016.csv,2016,0.0,1.0
9187,The Spy,977318,0,977318,2019.csv,2019,0.0,1.0
9188,Wonderbroeders,977262,0,977262,2014.csv,2014,0.0,1.0
9189,The Troubleshooter,977224,0,977224,2018.csv,2018,0.0,1.0
9190,Trivisa,977033,0,977033,2016.csv,2016,0.0,1.0
9191,Ana y Bruno,976967,0,976967,2018.csv,2018,0.0,1.0
9192,The Mongolian Conspiracy,976882,0,976882,2019.csv,2019,0.0,1.0
9193,Clues,976621,0,976621,2012.csv,2012,0.0,1.0
9194,Life Is Too Long,976620,0,976620,2010.csv,2010,0.0,1.0
9195,Se mi vuoi bene,976473,0,976473,2019.csv,2019,0.0,1.0
9196,Parallel Roads,975795,0,975795,2016.csv,2016,0.0,1.0
9197,Sijjin 6,975782,0,975782,2019.csv,2019,0.0,1.0
9198,Guardians of the Lost Code 3D,975523,0,975523,2010.csv,2010,0.0,1.0
9199,Detyam do 16...,975201,0,975201,2010.csv,2010,0.0,1.0
9200,Jew Suss: Rise and Fall,975007,0,975007,2010.csv,2010,0.0,1.0
9201,Kung Fu Wing Chun,974100,0,974100,2010.csv,2010,0.0,1.0
9202,Tuttapposto,973970,0,973970,2019.csv,2019,0.0,1.0
9203,Sky Smile,972778,0,972778,2012.csv,2012,0.0,1.0
9204,Drama Queen,972116,0,972116,2020.csv,2020,0.0,1.0
9205,Tobot Movie: Attack of Robot Force,971479,0,971479,2017.csv,2017,0.0,1.0
9206,Journey's End,970809,161796,809013,2018.csv,2018,0.166661001288616,0.8333389987113841
9207,Habbet Loulou,970705,0,970705,2013.csv,2013,0.0,1.0
9208,Cool Kids Don't Cry,970242,0,970242,2014.csv,2014,0.0,1.0
9209,One of the Family,969131,0,969131,2018.csv,2018,0.0,1.0
9210,Secuestrados,969024,0,969024,2011.csv,2011,0.0,1.0
9211,The Irishman,968853,0,968853,2019.csv,2019,0.0,1.0
9212,Trishna,967672,240381,727291,2012.csv,2012,0.24841165188204267,0.7515883481179573
9213,Life Must Go On,967318,0,967318,2015.csv,2015,0.0,1.0
9214,Panic 5 Bravo,966427,0,966427,2014.csv,2014,0.0,1.0
9215,Shéhérazade,966225,0,966225,2018.csv,2018,0.0,1.0
9216,Hwajang,965883,0,965883,2015.csv,2015,0.0,1.0
9217,Priest of Evil,965827,0,965827,2010.csv,2010,0.0,1.0
9218,Perfect Proposal,965717,0,965717,2015.csv,2015,0.0,1.0
9219,Doblemente Embarazada,965558,0,965558,2019.csv,2019,0.0,1.0
9220,New Year's Stir,965440,0,965440,2017.csv,2017,0.0,1.0
9221,Çanakkale Çocuklari,964953,0,964953,2012.csv,2012,0.0,1.0
9222,Sijjin 3: Love,963763,0,963763,2016.csv,2016,0.0,1.0
9223,Elvy's Wereld So Ibiza!,963363,0,963363,2018.csv,2018,0.0,1.0
9224,Documentary of Nogizaka 46 Who Is Here Before Me,963285,0,963285,2019.csv,2019,0.0,1.0
9225,Ryuichi Sakamoto: Coda,962850,117460,845390,2018.csv,2018,0.12199200290803344,0.8780079970919665
9226,We Need Your Vote,962342,0,962342,2018.csv,2018,0.0,1.0
9227,Still,961860,0,961860,2010.csv,2010,0.0,1.0
9228,The Greater Father,960748,0,960748,2017.csv,2017,0.0,1.0
9229,Rush: Cinema Strangiato 2019,960073,960073,0,2019.csv,2019,1.0,0.0
9230,Dance with Me,959785,0,959785,2019.csv,2019,0.0,1.0
9231,French Exit,959772,405983,553789,2021.csv,2021,0.4229994206957486,0.5770005793042514
9232,Cambio de ruta,959576,0,959576,2014.csv,2014,0.0,1.0
9233,At Cafe 6,959073,0,959073,2016.csv,2016,0.0,1.0
9234,The Smiles of Sad Men,959056,0,959056,2018.csv,2018,0.0,1.0
9235,A Prayer Before Dawn,958883,14453,944430,2018.csv,2018,0.015072746101453462,0.9849272538985465
9236,My Ex 2: Haunted Lover,958715,0,958715,2010.csv,2010,0.0,1.0
9237,Little Witch on a Broomstick 2011 Re-release,958691,0,958691,2011.csv,2011,0.0,1.0
9238,The Ninth,958558,0,958558,2019.csv,2019,0.0,1.0
9239,Mang long te jiong,958430,0,958430,2015.csv,2015,0.0,1.0
9240,"Was weg is, is weg",957959,0,957959,2012.csv,2012,0.0,1.0
9241,Six-Pack Movie,957694,0,957694,2011.csv,2011,0.0,1.0
9242,In the Shadow of Iris,957465,0,957465,2016.csv,2016,0.0,1.0
9243,La Melodie,957355,0,957355,2017.csv,2017,0.0,1.0
9244,Giovanni Improtta,957190,0,957190,2013.csv,2013,0.0,1.0
9245,No Country for Young Men,957136,0,957136,2017.csv,2017,0.0,1.0
9246,Private Eye Vares 2011 Re-release,957077,0,957077,2011.csv,2011,0.0,1.0
9247,Free! Timeless Medley: The Bond,956904,0,956904,2017.csv,2017,0.0,1.0
9248,The Secret Life of Walter Mitty,956625,0,956625,2010.csv,2010,0.0,1.0
9249,The Endless,956425,272020,684405,2018.csv,2018,0.2844133099824869,0.7155866900175132
9250,"Just Sex, Nothing Personal",956170,0,956170,2018.csv,2018,0.0,1.0
9251,Cigarettes et chocolat chaud,956142,0,956142,2016.csv,2016,0.0,1.0
9252,Tolko ne oni,954696,0,954696,2018.csv,2018,0.0,1.0
9253,The Fighting Preacher,954641,954641,0,2019.csv,2019,1.0,0.0
9254,The Catcher Was a Spy,953953,725223,228730,2018.csv,2018,0.7602292775430236,0.2397707224569764
9255,The New Life of Paul Sneijder,953024,0,953024,2016.csv,2016,0.0,1.0
9256,Off-Key,952860,0,952860,2016.csv,2016,0.0,1.0
9257,Varg Veum - De døde har det godt,952036,0,952036,2012.csv,2012,0.0,1.0
9258,The Farewell Party,951531,172860,778671,2015.csv,2015,0.1816651270426292,0.8183348729573708
9259,Behind the Walls,950758,0,950758,2011.csv,2011,0.0,1.0
9260,A Childhood 2020 Re-release,950606,0,950606,2020.csv,2020,0.0,1.0
9261,Gimme Danger,950040,440627,509413,2016.csv,2016,0.4637983663845733,0.5362016336154267
9262,Night Mail,950000,0,950000,2014.csv,2014,0.0,1.0
9263,Arrête de pleurer Pénélope,949631,0,949631,2012.csv,2012,0.0,1.0
9264,The Demon Inside,949386,0,949386,2020.csv,2020,0.0,1.0
9265,Taxi Blues,949298,0,949298,2019.csv,2019,0.0,1.0
9266,Rise of the Legend,948871,0,948871,2018.csv,2018,0.0,1.0
9267,Görevimiz Tatil,947929,0,947929,2018.csv,2018,0.0,1.0
9268,Ketenpere,947798,0,947798,2017.csv,2017,0.0,1.0
9269,Indu Sarkar,947771,0,947771,2017.csv,2017,0.0,1.0
9270,The Mobfathers,947760,0,947760,2016.csv,2016,0.0,1.0
9271,Tobulas Pasimatymas,947455,0,947455,2020.csv,2020,0.0,1.0
9272,El Santos vs la Tetona Mendoza,946300,0,946300,2012.csv,2012,0.0,1.0
9273,"Nena, saludame al Diego",946279,0,946279,2013.csv,2013,0.0,1.0
9274,Instinct,946056,0,946056,2019.csv,2019,0.0,1.0
9275,Your Mother Should Know,945705,0,945705,2018.csv,2018,0.0,1.0
9276,Under the Tree,944991,67596,877395,2017.csv,2017,0.07153083997625374,0.9284691600237462
9277,Zoya,944885,0,944885,2021.csv,2021,0.0,1.0
9278,Plastic,944828,0,944828,2014.csv,2014,0.0,1.0
9279,The Dinner,944808,7282,937526,2014.csv,2014,0.0077073860509225154,0.9922926139490775
9280,Bewildered Bolbol,944728,0,944728,2010.csv,2010,0.0,1.0
9281,Spy Nation,944558,0,944558,2016.csv,2016,0.0,1.0
9282,Rebel in the Rye,944370,378294,566076,2017.csv,2017,0.4005781632199244,0.5994218367800757
9283,Dark Horse 2016 Re-release,944061,940715,3346,2016.csv,2016,0.9964557375000133,0.0035442624999867593
9284,At the Dacha,944019,0,944019,2020.csv,2020,0.0,1.0
9285,Robot Overlords,943502,0,943502,2015.csv,2015,0.0,1.0
9286,Afterimage,943029,33443,909586,2017.csv,2017,0.03546338447704153,0.9645366155229584
9287,Hella W,942533,0,942533,2011.csv,2011,0.0,1.0
9288,The Road,942041,92476,849565,2011.csv,2011,0.0981655787805414,0.9018344212194586
9289,The Ties,941873,0,941873,2020.csv,2020,0.0,1.0
9290,Becoming Zlatan ...,941777,0,941777,2016.csv,2016,0.0,1.0
9291,Born to Dance,941774,0,941774,2015.csv,2015,0.0,1.0
9292,Rattrapage,940985,0,940985,2017.csv,2017,0.0,1.0
9293,Landline,940854,940854,0,2017.csv,2017,1.0,0.0
9294,David Loman 2,940738,0,940738,2016.csv,2016,0.0,1.0
9295,Romance Out of the Blue,940000,0,940000,2015.csv,2015,0.0,1.0
9296,Gautas Iskvietimas,939797,0,939797,2016.csv,2016,0.0,1.0
9297,La comédie humaine,939249,0,939249,2010.csv,2010,0.0,1.0
9298,Becoming Astrid,938766,120486,818280,2018.csv,2018,0.12834508280018664,0.8716549171998134
9299,Revenge,938055,102091,835964,2018.csv,2018,0.10883263774512156,0.8911673622548785
9300,Lady of Csejte,937955,0,937955,2015.csv,2015,0.0,1.0
9301,Dragon Warrior: Compass of Astral Seal,936612,0,936612,2016.csv,2016,0.0,1.0
9302,Ayla: The Daughter of War,936195,0,936195,2017.csv,2017,0.0,1.0
9303,Honey,935304,0,935304,2013.csv,2013,0.0,1.0
9304,Kaili Blues,935236,32164,903072,2016.csv,2016,0.034391319410287884,0.9656086805897122
9305,Anubis: Het pad der 7 zonden 2012 Re-release,935126,0,935126,2012.csv,2012,0.0,1.0
9306,Brammetje Baas,934363,0,934363,2012.csv,2012,0.0,1.0
9307,Rescue Under Fire,933954,0,933954,2017.csv,2017,0.0,1.0
9308,Barely Lethal,933847,6075,927772,2015.csv,2015,0.006505348306521304,0.9934946516934787
9309,Piggy Bingbing,933589,0,933589,2018.csv,2018,0.0,1.0
9310,Angel Home,933545,0,933545,2013.csv,2013,0.0,1.0
9311,Gone with the Time,933517,0,933517,2015.csv,2015,0.0,1.0
9312,Perfect Sense,933352,2959,930393,2011.csv,2011,0.0031702937369824033,0.9968297062630176
9313,The Ideal City,933259,0,933259,2013.csv,2013,0.0,1.0
9314,Vay basimiza gelenler,932904,0,932904,2013.csv,2013,0.0,1.0
9315,Miss Sixty,932874,0,932874,2014.csv,2014,0.0,1.0
9316,Beyond Suspicion,932360,0,932360,2010.csv,2010,0.0,1.0
9317,Riverdance 25th Anniversary Show,932063,81879,850184,2020.csv,2020,0.08784706613179581,0.9121529338682042
9318,King of Prism by PrettyRhythm,931652,0,931652,2016.csv,2016,0.0,1.0
9319,Love-Carrot 3 2011 Re-release,931077,0,931077,2011.csv,2011,0.0,1.0
9320,A Borrowed Identity,930958,281540,649418,2015.csv,2015,0.30241965802968557,0.6975803419703145
9321,Monster Family 2019 Re-release,930478,0,930478,2019.csv,2019,0.0,1.0
9322,Nøgle hus spejl,930370,0,930370,2015.csv,2015,0.0,1.0
9323,Given,930363,0,930363,2020.csv,2020,0.0,1.0
9324,The Fourth State,930120,0,930120,2012.csv,2012,0.0,1.0
9325,The Perilous Internet Ring,930000,0,930000,2020.csv,2020,0.0,1.0
9326,Golden Men,929433,0,929433,2019.csv,2019,0.0,1.0
9327,Rue Mandar,929109,0,929109,2013.csv,2013,0.0,1.0
9328,I'll Be There,928937,0,928937,2010.csv,2010,0.0,1.0
9329,Masters in Forbidden City,928773,0,928773,2016.csv,2016,0.0,1.0
9330,Enormous,928576,0,928576,2020.csv,2020,0.0,1.0
9331,White Christmas 2018 Re-release,928298,928298,0,2018.csv,2018,1.0,0.0
9332,Like Arrows,928265,817990,110275,2018.csv,2018,0.8812031047168642,0.11879689528313574
9333,De Club van Sinterklaas & Het Geheim van de Speelgoeddokter,928242,0,928242,2012.csv,2012,0.0,1.0
9334,Ali's Wedding,927845,0,927845,2017.csv,2017,0.0,1.0
9335,The Lion King 2020 Re-release,927592,0,927592,2020.csv,2020,0.0,1.0
9336,Meester Kikker,927530,0,927530,2016.csv,2016,0.0,1.0
9337,Toni Morrison: The Pieces I Am,927495,903018,24477,2019.csv,2019,0.9736095612375268,0.026390438762473115
9338,Und Äktschn!,927267,0,927267,2014.csv,2014,0.0,1.0
9339,Amjeon,927025,0,927025,2019.csv,2019,0.0,1.0
9340,Zoku Owarimonogatari,926600,0,926600,2018.csv,2018,0.0,1.0
9341,Destiny Road,926114,0,926114,2012.csv,2012,0.0,1.0
9342,One Night in Oslo,925848,0,925848,2014.csv,2014,0.0,1.0
9343,How I Live Now,925762,60213,865549,2013.csv,2013,0.06504155495688957,0.9349584450431104
9344,Patterns of Evidence: Exodus,925576,925576,0,2015.csv,2015,1.0,0.0
9345,Love.net,925498,0,925498,2011.csv,2011,0.0,1.0
9346,Blood from a Stone,925344,0,925344,2012.csv,2012,0.0,1.0
9347,A Honeymoon in Hell: Mr. & Mrs. Oki's Fabulous Trip,924914,0,924914,2011.csv,2011,0.0,1.0
9348,Tomorrow Is Another Day,924395,0,924395,2018.csv,2018,0.0,1.0
9349,Mack the Knife - Brecht's Threepenny Film,924336,0,924336,2018.csv,2018,0.0,1.0
9350,Paula,924209,0,924209,2016.csv,2016,0.0,1.0
9351,Natural Born Lovers,924039,0,924039,2012.csv,2012,0.0,1.0
9352,Gentleman,923884,897876,26008,2016.csv,2016,0.9718492797797126,0.028150720220287397
9353,Jackie 2013 Re-release,923650,0,923650,2013.csv,2013,0.0,1.0
9354,Germany from Above,923613,0,923613,2012.csv,2012,0.0,1.0
9355,Amador,923507,0,923507,2010.csv,2010,0.0,1.0
9356,Happiness Is a Four-letter Word,923322,0,923322,2016.csv,2016,0.0,1.0
9357,All About Mothers,922351,0,922351,2018.csv,2018,0.0,1.0
9358,ATM,921752,3010,918742,2012.csv,2012,0.003265520443676824,0.9967344795563232
9359,Paradise,921242,14873,906369,2017.csv,2017,0.01614450926032465,0.9838554907396754
9360,Não Se Aceitam Devoluções,919657,0,919657,2018.csv,2018,0.0,1.0
9361,Palo Alto,919591,767732,151859,2014.csv,2014,0.8348624551566947,0.16513754484330534
9362,Horoscope Fortune,919190,0,919190,2015.csv,2015,0.0,1.0
9363,The Prenup,919175,0,919175,2015.csv,2015,0.0,1.0
9364,Viswasam,918734,0,918734,2019.csv,2019,0.0,1.0
9365,Back to 1942,918487,312954,605533,2012.csv,2012,0.3407277402946367,0.6592722597053633
9366,Mad Max: Fury Road 2020 Re-release,918409,0,918409,2020.csv,2020,0.0,1.0
9367,The Frog Kingdom 2: Sub-Zero Mission,918277,0,918277,2016.csv,2016,0.0,1.0
9368,Kirk Cameron: Connect,918127,918127,0,2018.csv,2018,1.0,0.0
9369,Ghost Child,917587,0,917587,2013.csv,2013,0.0,1.0
9370,Job Hunter,917346,0,917346,2017.csv,2017,0.0,1.0
9371,Great Cold,917277,0,917277,2018.csv,2018,0.0,1.0
9372,Gippi,917036,0,917036,2013.csv,2013,0.0,1.0
9373,The Lodgers,916727,7362,909365,2018.csv,2018,0.00803074415829358,0.9919692558417064
9374,The Widow,916556,0,916556,2020.csv,2020,0.0,1.0
9375,Ju-On: The Grudge 2 2015 Re-release,915133,0,915133,2015.csv,2015,0.0,1.0
9376,Eres mi pasión,915126,0,915126,2018.csv,2018,0.0,1.0
9377,A Man of Integrity,915073,0,915073,2017.csv,2017,0.0,1.0
9378,A Lady in Paris,914900,0,914900,2013.csv,2013,0.0,1.0
9379,The Patriarch,914715,0,914715,2016.csv,2016,0.0,1.0
9380,Yowamushi Pedal Re: Ride,914658,0,914658,2014.csv,2014,0.0,1.0
9381,Last Minute,913453,0,913453,2013.csv,2013,0.0,1.0
9382,Beauty and the Beast 2020 Re-release,913399,467000,446399,2020.csv,2020,0.511277108908593,0.48872289109140693
9383,Sealed Lips,912970,0,912970,2019.csv,2019,0.0,1.0
9384,Er relajo der loro,912939,0,912939,2012.csv,2012,0.0,1.0
9385,Classe Z,912713,0,912713,2017.csv,2017,0.0,1.0
9386,If You Love,912617,0,912617,2010.csv,2010,0.0,1.0
9387,La Foquita: El 10 de la calle,912491,0,912491,2020.csv,2020,0.0,1.0
9388,"I, Leonardo",911768,0,911768,2019.csv,2019,0.0,1.0
9389,Fairy Tail: Priestess of the Phoenix,911467,0,911467,2012.csv,2012,0.0,1.0
9390,Horizon Line,910944,0,910944,2020.csv,2020,0.0,1.0
9391,Villads fra Valby,910942,0,910942,2015.csv,2015,0.0,1.0
9392,Kings,910269,274635,635634,2018.csv,2018,0.3017075172284237,0.6982924827715763
9393,Casi leyendas,910005,0,910005,2017.csv,2017,0.0,1.0
9394,Akalyptos,909761,0,909761,2013.csv,2013,0.0,1.0
9395,Possessor,909578,752885,156693,2020.csv,2020,0.8277300022647865,0.17226999773521348
9396,The Gangster,909528,0,909528,2012.csv,2012,0.0,1.0
9397,You and I,909438,0,909438,2011.csv,2011,0.0,1.0
9398,"Raul: O Início, o Fim e o Meio",909369,0,909369,2012.csv,2012,0.0,1.0
9399,Alibaba: Solomon Seal,909149,0,909149,2016.csv,2016,0.0,1.0
9400,Atashin'chi: The 3D Movie,907976,0,907976,2010.csv,2010,0.0,1.0
9401,National Theatre Live: Hangmen,907914,0,907914,2016.csv,2016,0.0,1.0
9402,Backtrack,907786,0,907786,2016.csv,2016,0.0,1.0
9403,Seymour: An Introduction,907742,743541,164201,2015.csv,2015,0.8191104961541936,0.1808895038458064
9404,Hababam Sinifi Yeniden,907382,0,907382,2019.csv,2019,0.0,1.0
9405,Cosa fai a Capodanno?,907330,0,907330,2018.csv,2018,0.0,1.0
9406,Pharaoh's War,907304,0,907304,2019.csv,2019,0.0,1.0
9407,Sholem Aleichem: Laughing in the Darkness,906666,906666,0,2011.csv,2011,1.0,0.0
9408,Project Gio,906649,0,906649,2019.csv,2019,0.0,1.0
9409,The Dead Lands,906158,5240,900918,2014.csv,2014,0.0057826560048026944,0.9942173439951973
9410,The Guide,905985,0,905985,2014.csv,2014,0.0,1.0
9411,Moromete Family: On the Edge of Time,904513,0,904513,2018.csv,2018,0.0,1.0
9412,One More Time with Feeling,904440,0,904440,2016.csv,2016,0.0,1.0
9413,Bitter Harvest,904399,557241,347158,2017.csv,2017,0.6161450864054472,0.38385491359455287
9414,Poi E: The Story of a Song,903779,0,903779,2016.csv,2016,0.0,1.0
9415,Love,903080,0,903080,2015.csv,2015,0.0,1.0
9416,Butt Detective the Movie,902787,0,902787,2019.csv,2019,0.0,1.0
9417,The Myths,902684,0,902684,2017.csv,2017,0.0,1.0
9418,Tutak Tutak Tutiya,902643,0,902643,2016.csv,2016,0.0,1.0
9419,Generation Iron,901649,849521,52128,2013.csv,2013,0.9421859282270595,0.05781407177294047
9420,The Broken Crown,901435,0,901435,2016.csv,2016,0.0,1.0
9421,L'école est finie,901321,0,901321,2018.csv,2018,0.0,1.0
9422,I Hate Love,901128,0,901128,2014.csv,2014,0.0,1.0
9423,Oxygen,900627,0,900627,2010.csv,2010,0.0,1.0
9424,Gardiens de l'ordre,900358,0,900358,2010.csv,2010,0.0,1.0
9425,Una noche de amor,900123,0,900123,2016.csv,2016,0.0,1.0
9426,Secret × Heroine Phantomirage!: Eiga ni Natte Chodaishimasu,899992,0,899992,2020.csv,2020,0.0,1.0
9427,Bingo: The King of the Mornings,899782,0,899782,2017.csv,2017,0.0,1.0
9428,Sardarji,898439,0,898439,2015.csv,2015,0.0,1.0
9429,The Wildest Dream,898137,898137,0,2010.csv,2010,1.0,0.0
9430,The Game Changers,897992,739711,158281,2019.csv,2019,0.8237389642669423,0.17626103573305776
9431,Les rayures du zèbre,897803,0,897803,2014.csv,2014,0.0,1.0
9432,The Nightmare Call,897627,0,897627,2016.csv,2016,0.0,1.0
9433,Sura,897497,0,897497,2010.csv,2010,0.0,1.0
9434,The Club of Ugly Children,897441,0,897441,2019.csv,2019,0.0,1.0
9435,The Antarctica Experience,897279,0,897279,2018.csv,2018,0.0,1.0
9436,House of the Disappeared,897077,0,897077,2017.csv,2017,0.0,1.0
9437,Bill,896929,0,896929,2015.csv,2015,0.0,1.0
9438,The Disappearance of Alice Creed,896919,166980,729939,2010.csv,2010,0.1861706575510163,0.8138293424489836
9439,The Grinch 2020 Re-release,896798,473781,423017,2020.csv,2020,0.528302917713911,0.471697082286089
9440,A Woman's Life,895944,37626,858318,2016.csv,2016,0.04199592831694838,0.9580040716830516
9441,The Legend of Sarila,895128,0,895128,2013.csv,2013,0.0,1.0
9442,Repas de famille,895100,0,895100,2014.csv,2014,0.0,1.0
9443,Tomme tønner 2 - Det brune gullet,895057,0,895057,2011.csv,2011,0.0,1.0
9444,You're Not You,894964,11486,883478,2014.csv,2014,0.01283403578244488,0.9871659642175551
9445,Mythopathy,894783,0,894783,2016.csv,2016,0.0,1.0
9446,English National Opera: The Pirates of Penzance,894691,0,894691,2015.csv,2015,0.0,1.0
9447,Sierpniowe niebo. 63 dni chwaly,892817,0,892817,2013.csv,2013,0.0,1.0
9448,Best of Enemies: Buckley vs. Vidal,892802,892802,0,2015.csv,2015,1.0,0.0
9449,Dünyanin En Güzel Kokusu,892783,0,892783,2016.csv,2016,0.0,1.0
9450,Min & Max,892646,0,892646,2016.csv,2016,0.0,1.0
9451,Cousins,891981,0,891981,2021.csv,2021,0.0,1.0
9452,No Return,891654,0,891654,2010.csv,2010,0.0,1.0
9453,Believe,890303,890303,0,2016.csv,2016,1.0,0.0
9454,The Liverpool Goalie,890189,0,890189,2010.csv,2010,0.0,1.0
9455,Night of the Undead,890148,0,890148,2020.csv,2020,0.0,1.0
9456,Mafia Inc,889863,889863,0,2020.csv,2020,1.0,0.0
9457,Countdown,889807,0,889807,2012.csv,2012,0.0,1.0
9458,National Lampoon's Christmas Vacation 2020 Re-release,889500,871000,18500,2020.csv,2020,0.9792017987633502,0.020798201236649803
9459,Beyond the Mountains,889012,0,889012,2018.csv,2018,0.0,1.0
9460,The Serialist,888734,0,888734,2013.csv,2013,0.0,1.0
9461,Among Us,888041,0,888041,2010.csv,2010,0.0,1.0
9462,Alone Yet Not Alone,887851,887851,0,2013.csv,2013,1.0,0.0
9463,Deadline,887501,0,887501,2010.csv,2010,0.0,1.0
9464,Blithe Spirit,887433,279441,607992,2020.csv,2020,0.31488687033274626,0.6851131296672538
9465,Familieweekend,887242,0,887242,2016.csv,2016,0.0,1.0
9466,The Future,887172,568662,318510,2011.csv,2011,0.6409828082942203,0.3590171917057797
9467,Varg Veum - The Consorts of Death,886719,0,886719,2011.csv,2011,0.0,1.0
9468,Happy Little Submarine: Magic Box of Time 2018 Re-release,886352,0,886352,2018.csv,2018,0.0,1.0
9469,The Grudge,886183,0,886183,2017.csv,2017,0.0,1.0
9470,It's a Wonderful Life 2010 Re-release,886078,0,886078,2010.csv,2010,0.0,1.0
9471,Cerro Torre: A Snowball's Chance in Hell,885430,0,885430,2014.csv,2014,0.0,1.0
9472,Cyborgs: Heroes Never Die,884894,0,884894,2017.csv,2017,0.0,1.0
9473,Always Kabhi Kabhi,884624,21381,863243,2011.csv,2011,0.024169590696160176,0.9758304093038398
9474,Psycho-Pass: Sinners of the System Case.1 Crime and Punishment,884371,0,884371,2019.csv,2019,0.0,1.0
9475,Take Off,884267,0,884267,2017.csv,2017,0.0,1.0
9476,Princess Kaiulani,883887,883887,0,2010.csv,2010,1.0,0.0
9477,Hidden Away,882746,0,882746,2020.csv,2020,0.0,1.0
9478,Afterwards 2010 Re-release,882726,0,882726,2010.csv,2010,0.0,1.0
9479,Fear Is Coming,882680,0,882680,2016.csv,2016,0.0,1.0
9480,The Look of a Killer,882291,0,882291,2016.csv,2016,0.0,1.0
9481,Il permesso - 48 ore fuori,882204,0,882204,2017.csv,2017,0.0,1.0
9482,My Back Pages,882185,0,882185,2011.csv,2011,0.0,1.0
9483,Ai Weiwei: Never Sorry,881661,534100,347561,2012.csv,2012,0.6057883925908031,0.394211607409197
9484,Fatal Frame,881343,0,881343,2014.csv,2014,0.0,1.0
9485,Habermann,880953,0,880953,2010.csv,2010,0.0,1.0
9486,Macadam Stories,880180,0,880180,2015.csv,2015,0.0,1.0
9487,Dreamfactory,880158,0,880158,2019.csv,2019,0.0,1.0
9488,Gorbaciof,879825,0,879825,2010.csv,2010,0.0,1.0
9489,Quando c'era Berlinguer,879758,0,879758,2014.csv,2014,0.0,1.0
9490,Welcome to Beartown,879592,0,879592,2019.csv,2019,0.0,1.0
9491,The Whole Shebang,878778,0,878778,2014.csv,2014,0.0,1.0
9492,Back in Business,878645,0,878645,2017.csv,2017,0.0,1.0
9493,Servant of the People,877783,0,877783,2016.csv,2016,0.0,1.0
9494,Hei se xi ju,877429,0,877429,2014.csv,2014,0.0,1.0
9495,Dwelling in the Fuchun Mountains,877336,0,877336,2020.csv,2020,0.0,1.0
9496,Miami Beach,877095,0,877095,2016.csv,2016,0.0,1.0
9497,The Hummingbird Project,876980,371784,505196,2019.csv,2019,0.423936691828776,0.576063308171224
9498,Unexperienced,876750,0,876750,2015.csv,2015,0.0,1.0
9499,Der kleine Medicus - Geheimnisvolle Mission im Körper,876013,0,876013,2014.csv,2014,0.0,1.0
9500,Retrasado,875915,0,875915,2011.csv,2011,0.0,1.0
9501,Between Me and My Mind,875191,875191,0,2019.csv,2019,1.0,0.0
9502,The Polar Express 2017 IMAX Release,875150,875150,0,2017.csv,2017,1.0,0.0
9503,Hayat Öpücügü,874769,0,874769,2015.csv,2015,0.0,1.0
9504,The SpongeBob SquarePants Movie 2015 Re-release,874134,0,874134,2015.csv,2015,0.0,1.0
9505,9 meses,873641,0,873641,2010.csv,2010,0.0,1.0
9506,Song of Napoli,873402,0,873402,2014.csv,2014,0.0,1.0
9507,Mother's Revenge,872900,0,872900,2016.csv,2016,0.0,1.0
9508,The Door,871494,0,871494,2012.csv,2012,0.0,1.0
9509,André Rieu's 2014 Maastricht Concert,871349,0,871349,2014.csv,2014,0.0,1.0
9510,Dreamfools,871266,0,871266,2018.csv,2018,0.0,1.0
9511,Ay Ramon!,871258,0,871258,2015.csv,2015,0.0,1.0
9512,Love in the Rain,870501,0,870501,2013.csv,2013,0.0,1.0
9513,Particle Fever,869838,869838,0,2014.csv,2014,1.0,0.0
9514,Les gorilles,869815,0,869815,2015.csv,2015,0.0,1.0
9515,Macho Man,869780,0,869780,2015.csv,2015,0.0,1.0
9516,The Illusionauts,869352,0,869352,2012.csv,2012,0.0,1.0
9517,Gaspard at the Wedding,869179,0,869179,2018.csv,2018,0.0,1.0
9518,Operación E,868792,0,868792,2012.csv,2012,0.0,1.0
9519,Las Caras del Diablo 2,868068,0,868068,2014.csv,2014,0.0,1.0
9520,La Niña de la Mina,867983,0,867983,2016.csv,2016,0.0,1.0
9521,D' Kilabots Pogi Brothers Weh?!?,867971,0,867971,2012.csv,2012,0.0,1.0
9522,The Wishmas Tree,867531,0,867531,2020.csv,2020,0.0,1.0
9523,Gråtass: gøy på landet!,867266,0,867266,2016.csv,2016,0.0,1.0
9524,Royal Opera House Live Cinema Season 2019/20: The Sleeping Beauty,867186,0,867186,2020.csv,2020,0.0,1.0
9525,Make Me Shudder 3,866519,0,866519,2015.csv,2015,0.0,1.0
9526,Karisik Kaset,866241,0,866241,2014.csv,2014,0.0,1.0
9527,Bird People,866211,32111,834100,2014.csv,2014,0.037070644450370636,0.9629293555496293
9528,The Monkey and the Mouth,866163,0,866163,2017.csv,2017,0.0,1.0
9529,Howl's Moving Castle 2019 Re-release,865647,865647,0,2019.csv,2019,1.0,0.0
9530,The Metropolitan Opera HD Live: Nico Muhly: Marnie,865551,849710,15841,2018.csv,2018,0.981698363239139,0.018301636760861002
9531,Colours of Passion,865342,0,865342,2014.csv,2014,0.0,1.0
9532,Cómo sobrevivir a una despedida,865119,0,865119,2015.csv,2015,0.0,1.0
9533,The Outrage,864968,0,864968,2011.csv,2011,0.0,1.0
9534,Cut Throat City,864928,855894,9034,2020.csv,2020,0.9895551999704022,0.010444800029597839
9535,Mine de rien,864767,0,864767,2020.csv,2020,0.0,1.0
9536,Comment tuer sa mère,864730,0,864730,2018.csv,2018,0.0,1.0
9537,Sonu Ke Titu Ki Sweety,864301,0,864301,2018.csv,2018,0.0,1.0
9538,In the Mood for Love 2020 Re-release,864284,0,864284,2021.csv,2021,0.0,1.0
9539,Täterätää - Die Kirche bleibt im Dorf 2,864092,0,864092,2015.csv,2015,0.0,1.0
9540,Black Rose,863808,0,863808,2014.csv,2014,0.0,1.0
9541,Mother's Day,863044,0,863044,2011.csv,2011,0.0,1.0
9542,The White-haired Girl,862970,0,862970,2016.csv,2016,0.0,1.0
9543,Paris Pigalle,862888,0,862888,2018.csv,2018,0.0,1.0
9544,Of Love and Lies,861949,0,861949,2019.csv,2019,0.0,1.0
9545,God's Slave,861895,0,861895,2013.csv,2013,0.0,1.0
9546,Veer,861630,527193,334437,2010.csv,2010,0.6118554367884127,0.38814456321158736
9547,Love,861057,249083,611974,2015.csv,2015,0.2892758551408327,0.7107241448591672
9548,Wer,860940,0,860940,2014.csv,2014,0.0,1.0
9549,The Giant,860750,0,860750,2017.csv,2017,0.0,1.0
9550,"Wedding tayo, wedding hindi!",860697,0,860697,2011.csv,2011,0.0,1.0
9551,Las Aparicio,860502,0,860502,2016.csv,2016,0.0,1.0
9552,Future X-Cops,860428,0,860428,2010.csv,2010,0.0,1.0
9553,Abrahams,860055,0,860055,2018.csv,2018,0.0,1.0
9554,Wild Mouse,860046,0,860046,2017.csv,2017,0.0,1.0
9555,Gangster Ka,859338,0,859338,2015.csv,2015,0.0,1.0
9556,The Reservoir Game,858921,0,858921,2017.csv,2017,0.0,1.0
9557,Highway,858783,529136,329647,2014.csv,2014,0.6161463373168775,0.3838536626831225
9558,Night Moves,858513,271755,586758,2014.csv,2014,0.3165415083988245,0.6834584916011756
9559,Capone,858281,0,858281,2020.csv,2020,0.0,1.0
9560,Hor taew tak 4,858219,0,858219,2012.csv,2012,0.0,1.0
9561,Homecoming 2015 Re-release,858097,0,858097,2015.csv,2015,0.0,1.0
9562,Cupid's Balls,857995,0,857995,2011.csv,2011,0.0,1.0
9563,May Allah Bless France!,857921,0,857921,2014.csv,2014,0.0,1.0
9564,Das Hochzeitsvideo,857682,0,857682,2012.csv,2012,0.0,1.0
9565,Pet Pals 2012 Re-release,857407,0,857407,2012.csv,2012,0.0,1.0
9566,Wedding Dress,857199,0,857199,2010.csv,2010,0.0,1.0
9567,Love in a Puff,857176,0,857176,2010.csv,2010,0.0,1.0
9568,Lily Sometimes,857023,0,857023,2010.csv,2010,0.0,1.0
9569,Finding Santa,856607,0,856607,2016.csv,2016,0.0,1.0
9570,Case Closed: Episode One - The Great Detective Turned Small,856088,0,856088,2017.csv,2017,0.0,1.0
9571,Once Upon a Time in Venice,855888,0,855888,2017.csv,2017,0.0,1.0
9572,Vares: Tango of Darkness,855802,0,855802,2012.csv,2012,0.0,1.0
9573,Nightmare 2: The Nightmare Continues,855759,0,855759,2014.csv,2014,0.0,1.0
9574,Steel Magnolias 2019 Re-release,855421,855421,0,2019.csv,2019,1.0,0.0
9575,Chain Letter,855185,138788,716397,2010.csv,2010,0.16229003081204652,0.8377099691879535
9576,A Touch of Sin,854891,154120,700771,2013.csv,2013,0.18028029304320667,0.8197197069567933
9577,Jacky in the Kingdom of Women,854529,0,854529,2014.csv,2014,0.0,1.0
9578,Braven,854319,0,854319,2018.csv,2018,0.0,1.0
9579,In Order of Disappearance,854195,0,854195,2014.csv,2014,0.0,1.0
9580,Buddy Games,853898,405904,447994,2020.csv,2020,0.4753541992134892,0.5246458007865108
9581,Happythankyoumoreplease,853862,216110,637752,2011.csv,2011,0.2530971046843635,0.7469028953156365
9582,Moomins and the Winter Wonderland,853811,0,853811,2017.csv,2017,0.0,1.0
9583,1968,853512,0,853512,2018.csv,2018,0.0,1.0
9584,Black Sheep,852921,0,852921,2011.csv,2011,0.0,1.0
9585,Ventoux,852540,0,852540,2015.csv,2015,0.0,1.0
9586,Submergence,852319,0,852319,2018.csv,2018,0.0,1.0
9587,Buddies,852138,0,852138,2013.csv,2013,0.0,1.0
9588,The Complexity of Happiness,851896,0,851896,2015.csv,2015,0.0,1.0
9589,De Grote Sinterklaasfilm,851503,0,851503,2020.csv,2020,0.0,1.0
9590,Frightening Embroidery Shoes,851257,0,851257,2017.csv,2017,0.0,1.0
9591,Mao Fengmei,851160,0,851160,2016.csv,2016,0.0,1.0
9592,Dog Days,850997,0,850997,2018.csv,2018,0.0,1.0
9593,The Sea of Trees,850985,20444,830541,2016.csv,2016,0.02402392521607314,0.9759760747839269
9594,31,850419,779820,70599,2016.csv,2016,0.9169832753031153,0.08301672469688472
9595,Angry Kid,850000,0,850000,2013.csv,2013,0.0,1.0
9596,The Grow 2,850000,0,850000,2015.csv,2015,0.0,1.0
9597,Armero,849857,0,849857,2017.csv,2017,0.0,1.0
9598,Date,849776,0,849776,2012.csv,2012,0.0,1.0
9599,Sol,849404,327,849077,2020.csv,2020,0.0003849758183385056,0.9996150241816615
9600,Vasco Modena Park,849124,0,849124,2017.csv,2017,0.0,1.0
9601,Wilson,848646,653951,194695,2017.csv,2017,0.7705816088215817,0.22941839117841833
9602,Kids on the Slope,847775,0,847775,2018.csv,2018,0.0,1.0
9603,Pork Pie,847307,0,847307,2017.csv,2017,0.0,1.0
9604,Atlas Shrugged: Who Is John Galt?,846704,846704,0,2014.csv,2014,1.0,0.0
9605,The Polar Express 2015 IMAX Release,846602,846602,0,2015.csv,2015,1.0,0.0
9606,It's All About Karma,846581,0,846581,2017.csv,2017,0.0,1.0
9607,You Got Served: Beat the World,846523,0,846523,2011.csv,2011,0.0,1.0
9608,Deiva Thirumagal,846407,0,846407,2011.csv,2011,0.0,1.0
9609,Endless,846294,0,846294,2020.csv,2020,0.0,1.0
9610,Die Toten Hosen - You Only Live Once,846293,0,846293,2019.csv,2019,0.0,1.0
9611,Blood-C: The Last Dark,846261,0,846261,2012.csv,2012,0.0,1.0
9612,Happy Hour in Paradise,846230,0,846230,2015.csv,2015,0.0,1.0
9613,La vallée des loups,846012,0,846012,2017.csv,2017,0.0,1.0
9614,The Chasing World 2,845286,0,845286,2010.csv,2010,0.0,1.0
9615,Home by Christmas,845199,0,845199,2010.csv,2010,0.0,1.0
9616,Mother,845107,0,845107,2019.csv,2019,0.0,1.0
9617,Xue lu xue lu,844806,0,844806,2017.csv,2017,0.0,1.0
9618,Lizzie,844786,642157,202629,2018.csv,2018,0.7601416216651318,0.23985837833486823
9619,Born a King,844774,0,844774,2019.csv,2019,0.0,1.0
9620,Love in Between,844674,0,844674,2010.csv,2010,0.0,1.0
9621,Universal Soldier: Regeneration,844447,0,844447,2010.csv,2010,0.0,1.0
9622,Room in Rome,844281,0,844281,2010.csv,2010,0.0,1.0
9623,Only the Animals,844130,0,844130,2019.csv,2019,0.0,1.0
9624,The Calculator,844037,0,844037,2014.csv,2014,0.0,1.0
9625,Terminal,843970,0,843970,2018.csv,2018,0.0,1.0
9626,Heartbeats,843423,68723,774700,2010.csv,2010,0.08148105991892561,0.9185189400810744
9627,Higher Ground 2011 Re-release,843370,841733,1637,2011.csv,2011,0.9980589776729075,0.001941022327092498
9628,Gunday,843232,0,843232,2014.csv,2014,0.0,1.0
9629,Yes or No: Come Back to Me,843210,0,843210,2012.csv,2012,0.0,1.0
9630,When the Love Is Gone,843124,0,843124,2013.csv,2013,0.0,1.0
9631,Misbehavior,842596,0,842596,2017.csv,2017,0.0,1.0
9632,Pard 888,842465,0,842465,2016.csv,2016,0.0,1.0
9633,The Pursuit of Unhappiness,841747,0,841747,2012.csv,2012,0.0,1.0
9634,One in A Hundred Thousand,841737,0,841737,2020.csv,2020,0.0,1.0
9635,The Last Elvis,841317,0,841317,2012.csv,2012,0.0,1.0
9636,Yennai Arindhaal,841040,0,841040,2015.csv,2015,0.0,1.0
9637,Mobile Suit Gundam: The Origin V - Clash at Loum,840973,0,840973,2017.csv,2017,0.0,1.0
9638,Eternity,840764,0,840764,2016.csv,2016,0.0,1.0
9639,Odnoklassnitsy,840408,0,840408,2016.csv,2016,0.0,1.0
9640,Campus Mystery,840000,0,840000,2015.csv,2015,0.0,1.0
9641,Mary Kom,839840,621300,218540,2014.csv,2014,0.739783768336826,0.2602162316631739
9642,Dead in a Week Or Your Money Back,839568,0,839568,2018.csv,2018,0.0,1.0
9643,BANDSTAND: The Broadway Musical on Screen,839554,839554,0,2018.csv,2018,1.0,0.0
9644,Hazard,839147,0,839147,2011.csv,2011,0.0,1.0
9645,A Call to Spy,837900,159014,678886,2020.csv,2020,0.18977682300990573,0.8102231769900943
9646,Fu lu shou,837854,0,837854,2011.csv,2011,0.0,1.0
9647,O Diário de Tati,837709,0,837709,2012.csv,2012,0.0,1.0
9648,Mon Son Phee,837601,0,837601,2015.csv,2015,0.0,1.0
9649,Mamangam,837421,0,837421,2019.csv,2019,0.0,1.0
9650,Goat Story with Cheese,837373,0,837373,2012.csv,2012,0.0,1.0
9651,Anchors Up,836791,0,836791,2017.csv,2017,0.0,1.0
9652,Hôtel Normandy,836709,4640,832069,2013.csv,2013,0.005545536142195196,0.9944544638578048
9653,Open Water 3: Cage Dive,836413,0,836413,2017.csv,2017,0.0,1.0
9654,Khiladi 786,835095,379466,455629,2012.csv,2012,0.4543986013567319,0.5456013986432682
9655,Code Geass: Akito the Exiled 3 - The Brightness Falls,834927,0,834927,2015.csv,2015,0.0,1.0
9656,Aikatsu! The Movie,834831,0,834831,2016.csv,2016,0.0,1.0
9657,The Exception,834572,708973,125599,2017.csv,2017,0.8495048959227005,0.1504951040772995
9658,Premam,834525,828278,6247,2016.csv,2016,0.9925143045445014,0.007485695455498637
9659,"Zoran, My Nephew the Idiot",834060,0,834060,2013.csv,2013,0.0,1.0
9660,Lover's Discourse,833955,0,833955,2010.csv,2010,0.0,1.0
9661,She Lights Up the Mountain,833839,0,833839,2019.csv,2019,0.0,1.0
9662,Helden van de zee,833722,0,833722,2016.csv,2016,0.0,1.0
9663,Enemy at the Dead End,832710,0,832710,2010.csv,2010,0.0,1.0
9664,Satyameva Jayate,832526,0,832526,2018.csv,2018,0.0,1.0
9665,Hajwala: The Missing Engine,832186,0,832186,2016.csv,2016,0.0,1.0
9666,Children's Party,832150,6330,825820,2011.csv,2011,0.0076068016583548635,0.9923931983416452
9667,Do Not Disturb,832150,0,832150,2012.csv,2012,0.0,1.0
9668,Fireman Sam: Alien Alert,831921,0,831921,2017.csv,2017,0.0,1.0
9669,"Sue, Mai & Sawa: Righting the Girl Ship",831902,0,831902,2013.csv,2013,0.0,1.0
9670,Poor Rich Dad,831655,0,831655,2016.csv,2016,0.0,1.0
9671,Mole Family 2 - The Spell of the Shadow,830678,0,830678,2016.csv,2016,0.0,1.0
9672,La fleur de l'âge,830435,0,830435,2013.csv,2013,0.0,1.0
9673,Mi vida,830386,0,830386,2019.csv,2019,0.0,1.0
9674,The Green Planet,830214,0,830214,2012.csv,2012,0.0,1.0
9675,Carry On Jatta 2,830113,0,830113,2018.csv,2018,0.0,1.0
9676,Spark,830000,0,830000,2013.csv,2013,0.0,1.0
9677,The Dreaming Man,828455,0,828455,2017.csv,2017,0.0,1.0
9678,Capri-Revolution,828363,0,828363,2018.csv,2018,0.0,1.0
9679,Byzantium,828284,89237,739047,2013.csv,2013,0.10773720124981287,0.8922627987501871
9680,JLS: Eyes Wide Open 3D,827792,0,827792,2011.csv,2011,0.0,1.0
9681,Love Is Blind,827547,0,827547,2016.csv,2016,0.0,1.0
9682,Detective Byomkesh Bakshy!,827437,579055,248382,2015.csv,2015,0.6998176296201403,0.30018237037985973
9683,13 Sins,826913,13809,813104,2014.csv,2014,0.01669945931434141,0.9833005406856586
9684,Gekijouban K: Missing Kings,826323,33531,792792,2014.csv,2014,0.04057856310425826,0.9594214368957418
9685,Hetian Jade Legend,826149,0,826149,2017.csv,2017,0.0,1.0
9686,Capitães da Areia,825947,0,825947,2011.csv,2011,0.0,1.0
9687,Game of Death,825882,0,825882,2016.csv,2016,0.0,1.0
9688,Never Too Late,825706,0,825706,2020.csv,2020,0.0,1.0
9689,A Twelve-Year Night,825391,0,825391,2018.csv,2018,0.0,1.0
9690,Signál,825261,0,825261,2012.csv,2012,0.0,1.0
9691,Jomon's Gospels,824647,0,824647,2017.csv,2017,0.0,1.0
9692,Mlechnyy put,824548,0,824548,2016.csv,2016,0.0,1.0
9693,Inside,824414,0,824414,2017.csv,2017,0.0,1.0
9694,When Margaux Meets Margaux,823640,0,823640,2018.csv,2018,0.0,1.0
9695,Undine,823241,0,823241,2020.csv,2020,0.0,1.0
9696,Extraños en la noche,823204,0,823204,2012.csv,2012,0.0,1.0
9697,TKKG,823170,0,823170,2019.csv,2019,0.0,1.0
9698,DZIDZIO Contrabass,822880,0,822880,2017.csv,2017,0.0,1.0
9699,Que Leones,822828,822828,0,2019.csv,2019,1.0,0.0
9700,Manhole,822780,0,822780,2014.csv,2014,0.0,1.0
9701,Moonlit Winter,822766,0,822766,2019.csv,2019,0.0,1.0
9702,Addio fottuti musi verdi,822764,0,822764,2017.csv,2017,0.0,1.0
9703,Lauf Junge lauf,822601,0,822601,2014.csv,2014,0.0,1.0
9704,Operation Shmenti Capelli,822522,0,822522,2011.csv,2011,0.0,1.0
9705,The Call,821666,516521,305145,2020.csv,2020,0.6286264735306073,0.37137352646939265
9706,Reinventing Marvin,821380,0,821380,2017.csv,2017,0.0,1.0
9707,Sources of Life,821276,0,821276,2013.csv,2013,0.0,1.0
9708,Leila,821177,0,821177,2011.csv,2011,0.0,1.0
9709,Wansei Back Home,820658,0,820658,2015.csv,2015,0.0,1.0
9710,"Brother, Superhit!",820417,0,820417,2018.csv,2018,0.0,1.0
9711,Les affamés,820361,0,820361,2018.csv,2018,0.0,1.0
9712,The Black Sheep,820140,0,820140,2010.csv,2010,0.0,1.0
9713,Importinis jaunikis,819278,0,819278,2020.csv,2020,0.0,1.0
9714,Fissa,819142,0,819142,2016.csv,2016,0.0,1.0
9715,Rashid & Rajab,819077,0,819077,2019.csv,2019,0.0,1.0
9716,"Half Sister, Full Love",818865,0,818865,2016.csv,2016,0.0,1.0
9717,The Lord of the Rings: The Return of the King 2011 Re-release,818580,818580,0,2011.csv,2011,1.0,0.0
9718,Nemici per la pelle,818549,0,818549,2016.csv,2016,0.0,1.0
9719,The Godfather 2011 Re-release,818333,0,818333,2011.csv,2011,0.0,1.0
9720,Aftermath,817874,0,817874,2017.csv,2017,0.0,1.0
9721,Kizumonogatari Part 3: Reiketsu,817874,0,817874,2017.csv,2017,0.0,1.0
9722,The Climb,817240,0,817240,2017.csv,2017,0.0,1.0
9723,Ku! Kin-dza-dza,817156,0,817156,2013.csv,2013,0.0,1.0
9724,The Stolen Caravaggio,816601,0,816601,2018.csv,2018,0.0,1.0
9725,180° moires,816544,0,816544,2010.csv,2010,0.0,1.0
9726,Mindhorn,815829,0,815829,2017.csv,2017,0.0,1.0
9727,Life Itself,815645,810454,5191,2014.csv,2014,0.9936357116147343,0.0063642883852656484
9728,Saw 10th Anniversary Release,815324,815324,0,2014.csv,2014,1.0,0.0
9729,Keet & Koen en de speurtocht naar Bassie & Adriaan,815177,0,815177,2015.csv,2015,0.0,1.0
9730,Nowhere in Moravia,815154,0,815154,2014.csv,2014,0.0,1.0
9731,What If...,814906,814906,0,2010.csv,2010,1.0,0.0
9732,Tangerine,814868,702354,112514,2015.csv,2015,0.861923648983639,0.13807635101636093
9733,Mon Rak Sib Muan,814662,0,814662,2015.csv,2015,0.0,1.0
9734,A Midsummer Night's Dream,814454,0,814454,2019.csv,2019,0.0,1.0
9735,Ayas,814348,0,814348,2013.csv,2013,0.0,1.0
9736,Chinese Zodiac 2014 Re-release,813930,0,813930,2014.csv,2014,0.0,1.0
9737,Age of Uprising: The Legend of Michael Kohlhaas,813550,3313,810237,2013.csv,2013,0.004072275828160531,0.9959277241718395
9738,DZIDZIO First Time,813387,0,813387,2018.csv,2018,0.0,1.0
9739,To Be King,813373,0,813373,2012.csv,2012,0.0,1.0
9740,Coldplay: A Head Full of Dreams,812524,0,812524,2018.csv,2018,0.0,1.0
9741,Decibels of Love,812172,0,812172,2016.csv,2016,0.0,1.0
9742,Cloudy Sunday,811642,0,811642,2015.csv,2015,0.0,1.0
9743,My Little Hero,811361,0,811361,2013.csv,2013,0.0,1.0
9744,The Heiresses,811196,78473,732723,2018.csv,2018,0.09673740994778081,0.9032625900522192
9745,Martin a Venuse,810999,0,810999,2013.csv,2013,0.0,1.0
9746,"She Said, He Said",810763,0,810763,2019.csv,2019,0.0,1.0
9747,Stereo,810702,0,810702,2014.csv,2014,0.0,1.0
9748,Bangistan,810419,48694,761725,2015.csv,2015,0.06008496839289306,0.939915031607107
9749,Magi,810229,0,810229,2016.csv,2016,0.0,1.0
9750,The Soccer Way,810000,0,810000,2013.csv,2013,0.0,1.0
9751,Short Stories,809738,0,809738,2012.csv,2012,0.0,1.0
9752,Popoz,809684,0,809684,2015.csv,2015,0.0,1.0
9753,Don't Be Afraid,809595,0,809595,2011.csv,2011,0.0,1.0
9754,Bill W.,809590,809590,0,2012.csv,2012,1.0,0.0
9755,Sudani from Nigeria,809541,0,809541,2018.csv,2018,0.0,1.0
9756,The Whistlers,809445,55608,753837,2019.csv,2019,0.0686989233363601,0.9313010766636399
9757,Buurman & Buurman: Hebben een nieuw huis,809336,0,809336,2018.csv,2018,0.0,1.0
9758,Under the North Star II,809280,0,809280,2010.csv,2010,0.0,1.0
9759,Joni 75: A Birthday Celebration,808831,752205,56626,2019.csv,2019,0.9299903193621412,0.07000968063785884
9760,Duas de Mim,808751,0,808751,2017.csv,2017,0.0,1.0
9761,A Jar Full of Life,808748,0,808748,2018.csv,2018,0.0,1.0
9762,Fire of Conscience,808429,0,808429,2010.csv,2010,0.0,1.0
9763,Beatles,807917,0,807917,2014.csv,2014,0.0,1.0
9764,Spring Returns to My Homeland,807862,0,807862,2018.csv,2018,0.0,1.0
9765,Escape,807673,0,807673,2012.csv,2012,0.0,1.0
9766,Breathing,807436,4630,802806,2011.csv,2011,0.005734200605373057,0.9942657993946269
9767,Iron Protector,807340,0,807340,2016.csv,2016,0.0,1.0
9768,As You Like It: NT Live 2016,807296,0,807296,2016.csv,2016,0.0,1.0
9769,Un ragazzo d'oro,807225,0,807225,2014.csv,2014,0.0,1.0
9770,Üç Harfliler 3: Karabüyü,806813,0,806813,2016.csv,2016,0.0,1.0
9771,Crazy Kingdom,806540,0,806540,2016.csv,2016,0.0,1.0
9772,And All Their Men,806451,0,806451,2019.csv,2019,0.0,1.0
9773,Un pays qui se tient sage,805985,0,805985,2020.csv,2020,0.0,1.0
9774,Alle tijd,805907,0,805907,2011.csv,2011,0.0,1.0
9775,V/H/S/2,805574,21833,783741,2013.csv,2013,0.027102413930936202,0.9728975860690638
9776,Heartstrings,804986,0,804986,2016.csv,2016,0.0,1.0
9777,Nicolas Og Elverdronningen,804574,0,804574,2015.csv,2015,0.0,1.0
9778,La solita commedia: Inferno,804394,0,804394,2015.csv,2015,0.0,1.0
9779,Berserk: The Golden Age Arc I - The Egg of the King 2012 Re-release,804258,0,804258,2012.csv,2012,0.0,1.0
9780,Shor in the City,804211,0,804211,2011.csv,2011,0.0,1.0
9781,Thondi Muthalum Driksakshiyum,803887,0,803887,2017.csv,2017,0.0,1.0
9782,Old Cow Vs Tender Grass,803635,0,803635,2010.csv,2010,0.0,1.0
9783,This Girl Is Bad-Ass!!,802807,0,802807,2011.csv,2011,0.0,1.0
9784,The Tillman Story,802535,802535,0,2010.csv,2010,1.0,0.0
9785,Hours,801983,0,801983,2013.csv,2013,0.0,1.0
9786,The Wrecking Crew!,801606,801606,0,2015.csv,2015,1.0,0.0
9787,Submarino,800681,0,800681,2010.csv,2010,0.0,1.0
9788,My Lucky Star,800299,0,800299,2012.csv,2012,0.0,1.0
9789,The Silent War,800270,0,800270,2012.csv,2012,0.0,1.0
9790,I Give It a Year 2014 Re-release,799902,0,799902,2014.csv,2014,0.0,1.0
9791,"Eila, Rampe and the Baby Girl",799011,0,799011,2014.csv,2014,0.0,1.0
9792,Entanglement,798896,0,798896,2011.csv,2011,0.0,1.0
9793,Red Army,798680,694600,104080,2015.csv,2015,0.8696849802173586,0.13031501978264134
9794,Wakefield,798214,262599,535615,2017.csv,2017,0.32898320500517403,0.6710167949948259
9795,App,798139,0,798139,2013.csv,2013,0.0,1.0
9796,Chekka Chivantha Vaanam,798098,0,798098,2018.csv,2018,0.0,1.0
9797,In Times of Fading Light,797776,0,797776,2018.csv,2018,0.0,1.0
9798,Can Feda,797118,0,797118,2018.csv,2018,0.0,1.0
9799,Agnosia,797070,0,797070,2010.csv,2010,0.0,1.0
9800,Wen Chaorong,797024,0,797024,2018.csv,2018,0.0,1.0
9801,Marshrut postroen,796804,0,796804,2016.csv,2016,0.0,1.0
9802,Bogatyrsha,796406,0,796406,2016.csv,2016,0.0,1.0
9803,The Audience 2015 Re-release,795972,0,795972,2015.csv,2015,0.0,1.0
9804,Podejrzani zakochani,795635,0,795635,2013.csv,2013,0.0,1.0
9805,Bakery in Brooklyn,795363,0,795363,2016.csv,2016,0.0,1.0
9806,Love Detective,794580,0,794580,2015.csv,2015,0.0,1.0
9807,Scarecrow,794123,0,794123,2019.csv,2019,0.0,1.0
9808,Sam Yan,793905,0,793905,2010.csv,2010,0.0,1.0
9809,Vita & Virginia,793439,42741,750698,2019.csv,2019,0.05386803522387985,0.9461319647761202
9810,Beni Unutma,793307,0,793307,2011.csv,2011,0.0,1.0
9811,National Street,792960,0,792960,2019.csv,2019,0.0,1.0
9812,OMG: Oh My God!,792634,0,792634,2012.csv,2012,0.0,1.0
9813,Moron 5.2: The Transformation,792584,0,792584,2014.csv,2014,0.0,1.0
9814,PolandJa,792205,0,792205,2017.csv,2017,0.0,1.0
9815,Unknown Title,791985,0,791985,2015.csv,2015,0.0,1.0
9816,The Shining 2020 Re-release (40th Anniversary),791771,0,791771,2020.csv,2020,0.0,1.0
9817,The Little Switzerland,791446,0,791446,2019.csv,2019,0.0,1.0
9818,Free! Take your Marks,791287,0,791287,2017.csv,2017,0.0,1.0
9819,Vishwaroopam,791040,0,791040,2013.csv,2013,0.0,1.0
9820,A Symphony of Summits: The Alps from Above,790998,0,790998,2013.csv,2013,0.0,1.0
9821,Memoirs of a Murderer 2019 Re-release,790588,0,790588,2019.csv,2019,0.0,1.0
9822,Tickled,790519,613956,176563,2016.csv,2016,0.7766492645970559,0.22335073540294414
9823,Thin Ice,790421,790421,0,2012.csv,2012,1.0,0.0
9824,100% Coco New York,790332,0,790332,2019.csv,2019,0.0,1.0
9825,Lootera,789671,581813,207858,2013.csv,2013,0.7367789877050063,0.26322101229499373
9826,Piet Piraat en het zeemonster,789649,0,789649,2013.csv,2013,0.0,1.0
9827,Güvercin Uçuverdi,789565,0,789565,2015.csv,2015,0.0,1.0
9828,Momentum,789406,0,789406,2015.csv,2015,0.0,1.0
9829,The Last Vermeer,788661,685380,103281,2020.csv,2020,0.8690425924446625,0.13095740755533747
9830,Christ(Off),788345,0,788345,2018.csv,2018,0.0,1.0
9831,The Second Lady,788280,0,788280,2015.csv,2015,0.0,1.0
9832,Chonda Pierce: Unashamed,787979,787979,0,2019.csv,2019,1.0,0.0
9833,The Ghost in the Well,787747,0,787747,2019.csv,2019,0.0,1.0
9834,Universitari - Molto più che amici,787423,0,787423,2013.csv,2013,0.0,1.0
9835,Nice and Easy,786962,0,786962,2014.csv,2014,0.0,1.0
9836,La ligne droite,786909,0,786909,2011.csv,2011,0.0,1.0
9837,Echoes from the Dead,786766,0,786766,2013.csv,2013,0.0,1.0
9838,Elf 2019 Re-release,786249,786249,0,2019.csv,2019,1.0,0.0
9839,Jurassic Park 2011 Re-release,786021,0,786021,2011.csv,2011,0.0,1.0
9840,Eine ganz heiße Nummer 2.0,785665,0,785665,2019.csv,2019,0.0,1.0
9841,No estamos solos,785548,0,785548,2016.csv,2016,0.0,1.0
9842,Heavy Duty,785356,0,785356,2019.csv,2019,0.0,1.0
9843,Locos sueltos en el zoo,785020,0,785020,2015.csv,2015,0.0,1.0
9844,George Takei's Allegiance,784850,784850,0,2017.csv,2017,1.0,0.0
9845,The Stone Roses: Made of Stone,784111,0,784111,2013.csv,2013,0.0,1.0
9846,Accomplices,783620,0,783620,2010.csv,2010,0.0,1.0
9847,Life During Wartime,783232,281447,501785,2010.csv,2010,0.3593405274554666,0.6406594725445334
9848,Mars,782880,0,782880,2016.csv,2016,0.0,1.0
9849,The Affair,782442,0,782442,2019.csv,2019,0.0,1.0
9850,Ghouls,782438,0,782438,2017.csv,2017,0.0,1.0
9851,Just Like Our Parents,782431,0,782431,2017.csv,2017,0.0,1.0
9852,Hor Taew Tak Hake Na Ka,782060,0,782060,2015.csv,2015,0.0,1.0
9853,Jack bestelt een broertje,781631,0,781631,2015.csv,2015,0.0,1.0
9854,My Name Is Francesco Totti,781555,0,781555,2020.csv,2020,0.0,1.0
9855,Disclaimer,781254,0,781254,2019.csv,2019,0.0,1.0
9856,The Paris Opera,781039,55482,725557,2017.csv,2017,0.07103614544216102,0.928963854557839
9857,Shiverstone Castle,780412,0,780412,2016.csv,2016,0.0,1.0
9858,HK: Forbidden Super Hero,779893,0,779893,2013.csv,2013,0.0,1.0
9859,Futuro Beach,779835,20262,759573,2014.csv,2014,0.025982419357941103,0.9740175806420589
9860,My Name Is Love,779658,0,779658,2012.csv,2012,0.0,1.0
9861,Sap nin,779639,0,779639,2015.csv,2015,0.0,1.0
9862,Take Me to the Moon,779487,0,779487,2018.csv,2018,0.0,1.0
9863,Grease 2020 Re-release,779427,102000,677427,2020.csv,2020,0.13086536648076086,0.8691346335192391
9864,Police Car Union,779255,0,779255,2018.csv,2018,0.0,1.0
9865,Brother,778797,0,778797,2019.csv,2019,0.0,1.0
9866,Ask Your Heart,778795,0,778795,2010.csv,2010,0.0,1.0
9867,Coming out,778670,0,778670,2013.csv,2013,0.0,1.0
9868,American Masters: Woody Allen: A Documentary,778621,0,778621,2012.csv,2012,0.0,1.0
9869,The Damned,778242,0,778242,2014.csv,2014,0.0,1.0
9870,Mrs. Hyde,778142,18627,759515,2018.csv,2018,0.023937790274782753,0.9760622097252173
9871,Diva,777542,0,777542,2020.csv,2020,0.0,1.0
9872,Z,776911,0,776911,2020.csv,2020,0.0,1.0
9873,Brasserie Valentine,776636,0,776636,2016.csv,2016,0.0,1.0
9874,Leve Boerenliefde,776536,0,776536,2013.csv,2013,0.0,1.0
9875,Security,776522,0,776522,2017.csv,2017,0.0,1.0
9876,Going Our Way 2,776455,0,776455,2013.csv,2013,0.0,1.0
9877,La daga de Rasputín,776049,0,776049,2011.csv,2011,0.0,1.0
9878,Enter the Void,775385,336467,438918,2010.csv,2010,0.43393539983363105,0.566064600166369
9879,Highway to Hellas,774977,0,774977,2015.csv,2015,0.0,1.0
9880,April's Daughter,774882,0,774882,2017.csv,2017,0.0,1.0
9881,Ordinary Love,774877,323688,451189,2019.csv,2019,0.41772823299697887,0.5822717670030211
9882,The D Train,774780,673151,101629,2015.csv,2015,0.8688285706910349,0.13117142930896514
9883,Made in Italy: Ciao Brother,774653,0,774653,2016.csv,2016,0.0,1.0
9884,"5 x Favela, Now by Ourselves",774161,0,774161,2010.csv,2010,0.0,1.0
9885,Little Secret,774128,0,774128,2016.csv,2016,0.0,1.0
9886,Jaws 2020 Re-release,773250,758300,14950,2020.csv,2020,0.9806660200452635,0.019333979954736503
9887,Playing Dead,772878,0,772878,2013.csv,2013,0.0,1.0
9888,The Motive,772690,0,772690,2017.csv,2017,0.0,1.0
9889,Dolly,772504,0,772504,2015.csv,2015,0.0,1.0
9890,The Devil's Candy,772319,0,772319,2016.csv,2016,0.0,1.0
9891,The Awakener,772282,0,772282,2018.csv,2018,0.0,1.0
9892,The Church,772000,772000,0,2019.csv,2019,1.0,0.0
9893,The Fairy Princess & the Unicorn,771969,0,771969,2019.csv,2019,0.0,1.0
9894,Party Crashers 2,771721,0,771721,2017.csv,2017,0.0,1.0
9895,Tutti giù per terra,771254,0,771254,2010.csv,2010,0.0,1.0
9896,When the Meteor Shot Across the Sky,770795,0,770795,2016.csv,2016,0.0,1.0
9897,OHA Diyorum: The Movie,770738,0,770738,2017.csv,2017,0.0,1.0
9898,De Reünie,770734,0,770734,2015.csv,2015,0.0,1.0
9899,Grand Masti,770535,413903,356632,2013.csv,2013,0.5371631398963058,0.4628368601036942
9900,Pariah,769552,769552,0,2011.csv,2011,1.0,0.0
9901,A Nice Girl Like You,769234,0,769234,2020.csv,2020,0.0,1.0
9902,Daffodils,769121,0,769121,2019.csv,2019,0.0,1.0
9903,The Lord of the Rings: The Fellowship of the Ring 2011 Re-release,768580,768580,0,2011.csv,2011,1.0,0.0
9904,Nerkonda Paarvai,768540,0,768540,2019.csv,2019,0.0,1.0
9905,Excuse Me,768538,0,768538,2012.csv,2012,0.0,1.0
9906,Theeb,768449,283024,485425,2015.csv,2015,0.3683055088886836,0.6316944911113165
9907,Var inte rädd Långa farbrorn,768219,0,768219,2011.csv,2011,0.0,1.0
9908,Beddua: The Curse,767878,0,767878,2018.csv,2018,0.0,1.0
9909,"Suh-Suh Pyoung, Slowly and Peacefully",767716,0,767716,2017.csv,2017,0.0,1.0
9910,Jolly Rangers,767595,0,767595,2010.csv,2010,0.0,1.0
9911,Holding the Man,767038,0,767038,2015.csv,2015,0.0,1.0
9912,Yalom's Cure,766974,1164,765810,2014.csv,2014,0.0015176524888718523,0.9984823475111282
9913,Bohemian Rhapsody 2020 Re-release,766866,240000,526866,2020.csv,2020,0.31296210811276026,0.6870378918872397
9914,Pak Panter,766048,0,766048,2010.csv,2010,0.0,1.0
9915,Lo and Behold: Reveries of the Connected World,765796,594912,170884,2016.csv,2016,0.7768544103129293,0.2231455896870707
9916,DanTDM Presents The Contest,765363,307484,457879,2019.csv,2019,0.4017492353301636,0.5982507646698364
9917,Patterns of Evidence: Moses Controversy,765361,765361,0,2019.csv,2019,1.0,0.0
9918,A Job Who Is Near Us,765297,0,765297,2019.csv,2019,0.0,1.0
9919,The Polar Express 2016 IMAX Release,765154,765154,0,2016.csv,2016,1.0,0.0
9920,Los miércoles no existen,765046,0,765046,2015.csv,2015,0.0,1.0
9921,The Lord of the Rings: The Two Towers 2011 Re-release,764607,764607,0,2011.csv,2011,1.0,0.0
9922,About Love,764578,0,764578,2015.csv,2015,0.0,1.0
9923,Kahlil Gibran's The Prophet,764498,355343,409155,2015.csv,2015,0.4648056633241683,0.5351943366758317
9924,The Invisibles,764250,407373,356877,2018.csv,2018,0.5330363101079489,0.466963689892051
9925,Toy Story 2020 Re-release,764172,727000,37172,2020.csv,2020,0.9513565008924693,0.04864349910753077
9926,Kung Fu Divas,764074,0,764074,2013.csv,2013,0.0,1.0
9927,Pick of the Litter,763688,578717,184971,2018.csv,2018,0.7577924492724778,0.24220755072752223
9928,Lucky Star,763475,0,763475,2019.csv,2019,0.0,1.0
9929,Detective Conan: Full Score of Fear 2019 Re-release,763420,0,763420,2019.csv,2019,0.0,1.0
9930,Cub,763280,0,763280,2014.csv,2014,0.0,1.0
9931,La valigia sul letto,763063,0,763063,2010.csv,2010,0.0,1.0
9932,Ammonite,763054,160930,602124,2020.csv,2020,0.21090250493412,0.78909749506588
9933,Thank You for Calling,762935,0,762935,2015.csv,2015,0.0,1.0
9934,Home for the Weekend,762777,0,762777,2012.csv,2012,0.0,1.0
9935,Museo,762284,148505,613779,2018.csv,2018,0.19481584291418946,0.8051841570858106
9936,Bakgat! II,762261,0,762261,2010.csv,2010,0.0,1.0
9937,The Box,762076,0,762076,2021.csv,2021,0.0,1.0
9938,Chez Nous,761677,0,761677,2013.csv,2013,0.0,1.0
9939,Waiting for the Barbarians,761361,0,761361,2020.csv,2020,0.0,1.0
9940,Do Not Miss It,761348,0,761348,2018.csv,2018,0.0,1.0
9941,Wild,761241,0,761241,2018.csv,2018,0.0,1.0
9942,Loli paradicka,760383,0,760383,2019.csv,2019,0.0,1.0
9943,The Shining 2017 Re-release,760309,421572,338737,2017.csv,2017,0.5544745623161109,0.445525437683889
9944,The Don Juans,760290,0,760290,2013.csv,2013,0.0,1.0
9945,#WszystkoGra,760146,0,760146,2016.csv,2016,0.0,1.0
9946,The Wizard's Daughter,759903,0,759903,2014.csv,2014,0.0,1.0
9947,Tween Academy: Class of 2012,758882,0,758882,2011.csv,2011,0.0,1.0
9948,Villmark 2,758497,0,758497,2015.csv,2015,0.0,1.0
9949,9: When Darkness Falls,758479,0,758479,2019.csv,2019,0.0,1.0
9950,Bombay Velvet,758478,450692,307786,2015.csv,2015,0.59420576470247,0.40579423529753006
9951,Gautas iskvietimas 3,758258,0,758258,2016.csv,2016,0.0,1.0
9952,Billy Connolly: The Sex Life of Bandages,757436,0,757436,2019.csv,2019,0.0,1.0
9953,The Foreigner 2017 Re-release,757178,0,757178,2017.csv,2017,0.0,1.0
9954,Psycho Pass 3: First Inspector,757096,0,757096,2020.csv,2020,0.0,1.0
9955,Campus Confidential,756949,0,756949,2014.csv,2014,0.0,1.0
9956,Port of Call,756911,0,756911,2015.csv,2015,0.0,1.0
9957,Boundaries,755977,703438,52539,2018.csv,2018,0.9305018538923803,0.06949814610761967
9958,Gate,755881,0,755881,2018.csv,2018,0.0,1.0
9959,Proxima,755639,0,755639,2019.csv,2019,0.0,1.0
9960,Who Gets the Dog? 2019 Re-release,755531,0,755531,2019.csv,2019,0.0,1.0
9961,Oh My Ghost,755278,0,755278,2013.csv,2013,0.0,1.0
9962,Paddle Pop Adventures 2: Journey Into the Kingdom,755073,0,755073,2012.csv,2012,0.0,1.0
9963,Brave Rabbit3 the Crazy Time Machine,754919,0,754919,2019.csv,2019,0.0,1.0
9964,A Thousand Times Stronger,754395,0,754395,2010.csv,2010,0.0,1.0
9965,I Love Lucy: A Colorized Celebration,754323,754323,0,2019.csv,2019,1.0,0.0
9966,Middle Men,754301,754301,0,2010.csv,2010,1.0,0.0
9967,Elsa & Fred,753975,285863,468112,2014.csv,2014,0.37914121821015284,0.6208587817898471
9968,The Great Bear,753930,0,753930,2011.csv,2011,0.0,1.0
9969,No soy tu mami,753610,0,753610,2019.csv,2019,0.0,1.0
9970,3 harfliler: Marid,753363,0,753363,2010.csv,2010,0.0,1.0
9971,Mahler on the Couch,753214,0,753214,2010.csv,2010,0.0,1.0
9972,La buca,752786,0,752786,2014.csv,2014,0.0,1.0
9973,Ardaas Karaan,752481,0,752481,2019.csv,2019,0.0,1.0
9974,Kafes,752408,0,752408,2015.csv,2015,0.0,1.0
9975,Engel,751834,0,751834,2020.csv,2020,0.0,1.0
9976,Adolescents,751655,0,751655,2020.csv,2020,0.0,1.0
9977,Tommy's Honour,751345,569306,182039,2017.csv,2017,0.7577158296122287,0.24228417038777125
9978,Iron Ladies Roar!,751170,0,751170,2014.csv,2014,0.0,1.0
9979,Useless Dad,750479,0,750479,2019.csv,2019,0.0,1.0
9980,Niente paura,750404,0,750404,2010.csv,2010,0.0,1.0
9981,Perdida,750192,0,750192,2020.csv,2020,0.0,1.0
9982,Let It Shine,750000,0,750000,2014.csv,2014,0.0,1.0
9983,Fúsi,749711,0,749711,2015.csv,2015,0.0,1.0
9984,Zeta,749677,0,749677,2016.csv,2016,0.0,1.0
9985,A Five Star Life 2014 Re-release,749653,306917,442736,2014.csv,2014,0.4094120879927113,0.5905879120072887
9986,The Magical Duvet,748575,0,748575,2011.csv,2011,0.0,1.0
9987,Everybody's Everything,748539,547207,201332,2019.csv,2019,0.731033386369982,0.26896661363001795
9988,Hobo with a Shotgun,748453,703372,45081,2011.csv,2011,0.9397677609682906,0.060232239031709406
9989,Bir Varmis Bir Yokmus,748381,0,748381,2015.csv,2015,0.0,1.0
9990,Spindl 2,748167,0,748167,2019.csv,2019,0.0,1.0
9991,Vikingdom,747872,0,747872,2013.csv,2013,0.0,1.0
9992,Dolce fine giornata,747716,0,747716,2019.csv,2019,0.0,1.0
9993,Let Me Fall,747236,0,747236,2018.csv,2018,0.0,1.0
9994,The Promised Land,747200,0,747200,2019.csv,2019,0.0,1.0
9995,Arthur Newman,747140,207853,539287,2013.csv,2013,0.27819819578659954,0.7218018042134005
9996,Krai... Nai Hong,745746,0,745746,2010.csv,2010,0.0,1.0
9997,The Terminal Trust,745039,0,745039,2012.csv,2012,0.0,1.0
9998,Do It Right,744789,0,744789,2017.csv,2017,0.0,1.0
9999,"My Voice, My Life",744784,0,744784,2014.csv,2014,0.0,1.0
10000,The Bacchus Lady,744487,0,744487,2016.csv,2016,0.0,1.0
10001,Senior,744410,0,744410,2015.csv,2015,0.0,1.0
10002,Holy Rollers,744266,303064,441202,2010.csv,2010,0.40719850161098314,0.5928014983890169
10003,Saturday's Warrior,744046,744046,0,2016.csv,2016,1.0,0.0
10004,Two Little Pigs Braved Mysterious Island,744017,0,744017,2018.csv,2018,0.0,1.0
10005,Calendar Girls,743799,0,743799,2015.csv,2015,0.0,1.0
10006,Ghost Day 2: Life Is Destined,743377,0,743377,2016.csv,2016,0.0,1.0
10007,Hu Wang Gui Lai,743020,0,743020,2010.csv,2010,0.0,1.0
10008,All About Happiness,743012,0,743012,2011.csv,2011,0.0,1.0
10009,Kölcsönlakás,742538,0,742538,2019.csv,2019,0.0,1.0
10010,Les Misérables in Concert: The 25th Anniversary,742004,0,742004,2010.csv,2010,0.0,1.0
10011,The Orator,741862,0,741862,2011.csv,2011,0.0,1.0
10012,Zombadings 1: Patayin sa shokot si Remington,741838,0,741838,2011.csv,2011,0.0,1.0
10013,Joschka und Herr Fischer,741708,0,741708,2011.csv,2011,0.0,1.0
10014,Mid Road Gang 2,741600,0,741600,2012.csv,2012,0.0,1.0
10015,Lietuviski svingeriai,741579,0,741579,2018.csv,2018,0.0,1.0
10016,Beyond the Edge,741481,0,741481,2013.csv,2013,0.0,1.0
10017,The Operative,740827,0,740827,2016.csv,2016,0.0,1.0
10018,The Gigolo,740756,0,740756,2015.csv,2015,0.0,1.0
10019,Monsters,740000,0,740000,2015.csv,2015,0.0,1.0
10020,Leaving Afghanistan,739934,0,739934,2019.csv,2019,0.0,1.0
10021,The Kid Who Lies,739909,0,739909,2011.csv,2011,0.0,1.0
10022,"Kumiko, The Treasure Hunter",739623,623383,116240,2015.csv,2015,0.8428388516852504,0.15716114831474953
10023,Forks Over Knives,739561,739561,0,2011.csv,2011,1.0,0.0
10024,Funny Cow,739252,0,739252,2018.csv,2018,0.0,1.0
10025,Father and Hero,739245,0,739245,2019.csv,2019,0.0,1.0
10026,Vicky Donor,739085,549001,190084,2012.csv,2012,0.7428117198968995,0.25718828010310046
10027,Unexpected Journey,738676,0,738676,2017.csv,2017,0.0,1.0
10028,Wish You Were Here,738015,0,738015,2019.csv,2019,0.0,1.0
10029,Deadly Still,737872,0,737872,2018.csv,2018,0.0,1.0
10030,Cold Skin,737478,0,737478,2017.csv,2017,0.0,1.0
10031,10 jours en or,737228,0,737228,2012.csv,2012,0.0,1.0
10032,Filial Party,737170,0,737170,2014.csv,2014,0.0,1.0
10033,Tutti contro tutti,737124,0,737124,2013.csv,2013,0.0,1.0
10034,Professor Kosta Vujic's Hat,736843,0,736843,2012.csv,2012,0.0,1.0
10035,I Want to Let You Know That I Love You,736019,0,736019,2016.csv,2016,0.0,1.0
10036,Chhota Bheem and the Throne of Bali,735550,0,735550,2013.csv,2013,0.0,1.0
10037,Humble Servants,735094,0,735094,2016.csv,2016,0.0,1.0
10038,Ramen Shop,735008,88455,646553,2018.csv,2018,0.12034562889111411,0.8796543711088859
10039,Wiener-Dog,734729,477453,257276,2016.csv,2016,0.6498355175853955,0.35016448241460457
10040,Article 15,734514,0,734514,2019.csv,2019,0.0,1.0
10041,FoodsFriends,734107,0,734107,2018.csv,2018,0.0,1.0
10042,Las niñas bien,734053,0,734053,2019.csv,2019,0.0,1.0
10043,Azazil: Dügüm,733676,0,733676,2014.csv,2014,0.0,1.0
10044,Uncertain Glory,733586,0,733586,2017.csv,2017,0.0,1.0
10045,Married for 7 Years 2013 Re-release,733050,0,733050,2013.csv,2013,0.0,1.0
10046,MeesterSpion,732898,0,732898,2016.csv,2016,0.0,1.0
10047,David Crosby: Remember My Name,732793,732793,0,2019.csv,2019,1.0,0.0
10048,Once I Was a Beehive,732655,732655,0,2015.csv,2015,1.0,0.0
10049,Tabloid,731925,696921,35004,2011.csv,2011,0.9521754278102265,0.04782457218977354
10050,Bölük,731767,0,731767,2017.csv,2017,0.0,1.0
10051,Pizza,731512,0,731512,2014.csv,2014,0.0,1.0
10052,Ultimate Hero,731388,0,731388,2016.csv,2016,0.0,1.0
10053,Manmadhan Ambu,731302,0,731302,2010.csv,2010,0.0,1.0
10054,Make a Fake,731299,0,731299,2011.csv,2011,0.0,1.0
10055,Jathi Ratnalu,731273,470000,261273,2021.csv,2021,0.6427148274310688,0.35728517256893116
10056,The Polar Express 2018 Re-release,731018,731018,0,2018.csv,2018,1.0,0.0
10057,Slaughterhouse Rulez,730762,4665,726097,2018.csv,2018,0.006383747376026668,0.9936162526239734
10058,Las Caras del Diablo 2014 Re-release,730590,0,730590,2014.csv,2014,0.0,1.0
10059,How I Ended This Summer,730412,8733,721679,2010.csv,2010,0.011956265778765957,0.988043734221234
10060,The Weird Doll,730261,0,730261,2016.csv,2016,0.0,1.0
10061,The Bachelor,729950,0,729950,2016.csv,2016,0.0,1.0
10062,Daily Fables,728944,0,728944,2018.csv,2018,0.0,1.0
10063,I Remember You,728751,0,728751,2017.csv,2017,0.0,1.0
10064,The Warning,728729,0,728729,2018.csv,2018,0.0,1.0
10065,First of May,728363,0,728363,2015.csv,2015,0.0,1.0
10066,Mae Nak 3D,728094,0,728094,2012.csv,2012,0.0,1.0
10067,Land Ho!,727594,727594,0,2014.csv,2014,1.0,0.0
10068,Peggy Guggenheim: Art Addict,727591,498428,229163,2015.csv,2015,0.6850387099345648,0.3149612900654351
10069,Eine Insel namens Udo,727450,0,727450,2011.csv,2011,0.0,1.0
10070,El Vientre,727364,0,727364,2014.csv,2014,0.0,1.0
10071,Collector,726763,0,726763,2016.csv,2016,0.0,1.0
10072,Call Me Bad Girl,726759,0,726759,2014.csv,2014,0.0,1.0
10073,Kilimanjar,726621,0,726621,2018.csv,2018,0.0,1.0
10074,Liz and the Blue Bird,726454,63204,663250,2018.csv,2018,0.08700344412722623,0.9129965558727737
10075,Innocent Crush,726105,0,726105,2014.csv,2014,0.0,1.0
10076,"Monsters, Inc. 2020 Re-release",726000,726000,0,2020.csv,2020,1.0,0.0
10077,Greenwood Adventure 2,725817,0,725817,2016.csv,2016,0.0,1.0
10078,Bullett Raja,725588,0,725588,2013.csv,2013,0.0,1.0
10079,Step,725513,0,725513,2020.csv,2020,0.0,1.0
10080,Miss,725444,0,725444,2020.csv,2020,0.0,1.0
10081,The Great Alaskan Race,725415,485603,239812,2019.csv,2019,0.6694140595383332,0.3305859404616668
10082,May it Last: A Portrait of the Avett Brothers,725286,725286,0,2017.csv,2017,1.0,0.0
10083,Castle in the Sky 2012 Re-release,725189,0,725189,2012.csv,2012,0.0,1.0
10084,"Yalla Aa'belkon: Single, Married, Divorced",725131,0,725131,2015.csv,2015,0.0,1.0
10085,A Tale of Love and Darkness,724885,572212,152673,2015.csv,2015,0.7893831435331121,0.21061685646688785
10086,Sin ella,724808,0,724808,2010.csv,2010,0.0,1.0
10087,The Hour of the Lynx,724445,0,724445,2013.csv,2013,0.0,1.0
10088,Cantábrico,724258,0,724258,2017.csv,2017,0.0,1.0
10089,Tale of a Forest,724248,0,724248,2012.csv,2012,0.0,1.0
10090,Rodina,724190,0,724190,2019.csv,2019,0.0,1.0
10091,Love Tactics,724180,0,724180,2010.csv,2010,0.0,1.0
10092,Limbo,723883,0,723883,2010.csv,2010,0.0,1.0
10093,20:16,722765,0,722765,2017.csv,2017,0.0,1.0
10094,Working Girls,722741,0,722741,2010.csv,2010,0.0,1.0
10095,The Act of Killing,722714,486919,235795,2013.csv,2013,0.6737367755432992,0.3262632244567007
10096,Where's My Roy Cohn?,722603,705274,17329,2019.csv,2019,0.9760186437089245,0.023981356291075458
10097,Singham,722451,350864,371587,2011.csv,2011,0.4856578508438635,0.5143421491561365
10098,Aswang,722156,0,722156,2011.csv,2011,0.0,1.0
10099,12 Days,722049,5204,716845,2017.csv,2017,0.007207267096831379,0.9927927329031686
10100,Cehennem 3D,721551,0,721551,2010.csv,2010,0.0,1.0
10101,Thailand Only,721293,0,721293,2017.csv,2017,0.0,1.0
10102,Lola Pater,721243,0,721243,2017.csv,2017,0.0,1.0
10103,Effie Gray,721143,352534,368609,2014.csv,2014,0.4888544990383322,0.5111455009616678
10104,Punjab 1984,720770,0,720770,2014.csv,2014,0.0,1.0
10105,8-Ball,720732,0,720732,2013.csv,2013,0.0,1.0
10106,Kusama: Infinity,720480,360931,359549,2018.csv,2018,0.5009590828336664,0.49904091716633353
10107,Pas son genre 2015 Re-release,720462,0,720462,2015.csv,2015,0.0,1.0
10108,The Night My Mother Killed My Father,720432,0,720432,2016.csv,2016,0.0,1.0
10109,Pizza Maffia,720416,0,720416,2011.csv,2011,0.0,1.0
10110,The Damned 2015 Re-release,720020,0,720020,2015.csv,2015,0.0,1.0
10111,Admisson by Guts,720000,0,720000,2015.csv,2015,0.0,1.0
10112,The Santa Clause 2020 Re-release,719342,706000,13342,2020.csv,2020,0.981452494084872,0.018547505915127993
10113,Monkey Business from a to Z,718881,0,718881,2015.csv,2015,0.0,1.0
10114,Combat Girls,718808,0,718808,2012.csv,2012,0.0,1.0
10115,Revive Us 2,718607,718607,0,2017.csv,2017,1.0,0.0
10116,HeavySaurus: The Movie,718579,0,718579,2015.csv,2015,0.0,1.0
10117,Holland: Natuur in de Delta,718510,0,718510,2015.csv,2015,0.0,1.0
10118,Quiz,718409,0,718409,2012.csv,2012,0.0,1.0
10119,Adopt a Daddy,718272,0,718272,2019.csv,2019,0.0,1.0
10120,Killing Bono,717798,0,717798,2011.csv,2011,0.0,1.0
10121,Jaane Kahan Se Aayi Hai,717777,0,717777,2010.csv,2010,0.0,1.0
10122,2001: A Space Odyssey 2014 Re-release,717744,214618,503126,2014.csv,2014,0.299017476983437,0.700982523016563
10123,The Addams Family 2020 Re-release,716968,678926,38042,2020.csv,2020,0.94694044922507,0.053059550774929985
10124,Omamamia,716783,0,716783,2012.csv,2012,0.0,1.0
10125,Goddesses in the Flames of War,716573,0,716573,2018.csv,2018,0.0,1.0
10126,Vecne tvá neverná,716563,0,716563,2018.csv,2018,0.0,1.0
10127,Losing It,715999,0,715999,2019.csv,2019,0.0,1.0
10128,J'irai Mourir Dans Les Carpates,715963,0,715963,2020.csv,2020,0.0,1.0
10129,Imperfect,715958,0,715958,2012.csv,2012,0.0,1.0
10130,The Shining 2012 Re-release,715736,342749,372987,2012.csv,2012,0.4788762895816335,0.5211237104183666
10131,New Initial D the Movie: Legend 1 - Awakening,715443,0,715443,2014.csv,2014,0.0,1.0
10132,The Table,715227,0,715227,2017.csv,2017,0.0,1.0
10133,The Polar Express 2020 Re-release,715021,711000,4021,2020.csv,2020,0.9943763889452197,0.00562361105478021
10134,Blossoms Bloom,714616,0,714616,2014.csv,2014,0.0,1.0
10135,Ill Manors,714441,0,714441,2012.csv,2012,0.0,1.0
10136,Always Watching: A Marble Hornets Story,714058,0,714058,2015.csv,2015,0.0,1.0
10137,The Blue Elephant 2,713957,0,713957,2019.csv,2019,0.0,1.0
10138,Juf Roos is Jarig,713768,0,713768,2019.csv,2019,0.0,1.0
10139,Shank,713697,0,713697,2010.csv,2010,0.0,1.0
10140,China's Post-00s,713623,0,713623,2019.csv,2019,0.0,1.0
10141,Passion,713616,92181,621435,2013.csv,2013,0.12917451402434924,0.8708254859756508
10142,Crazy and Dream City,713335,0,713335,2019.csv,2019,0.0,1.0
10143,Gerhard Richter Painting,713188,242646,470542,2011.csv,2011,0.34022726125509684,0.6597727387449032
10144,Along the Way,713129,0,713129,2012.csv,2012,0.0,1.0
10145,The Deep,713108,0,713108,2012.csv,2012,0.0,1.0
10146,The Burnt Orange Heresy,711691,144201,567490,2020.csv,2020,0.2026174280692042,0.7973825719307958
10147,The Climb,711639,234429,477210,2020.csv,2020,0.3294212374532593,0.6705787625467406
10148,Shootout at Wadala,711366,369573,341793,2013.csv,2013,0.5195258137161461,0.48047418628385385
10149,The Woman in the Septic Tank,711177,0,711177,2011.csv,2011,0.0,1.0
10150,The Polar Express 2011 IMAX Release,711168,711168,0,2011.csv,2011,1.0,0.0
10151,"Ninguém Entra, Ninguém Sai",710929,0,710929,2017.csv,2017,0.0,1.0
10152,Fire Will Come,710726,0,710726,2019.csv,2019,0.0,1.0
10153,Extraction,710636,16775,693861,2015.csv,2015,0.023605615251690037,0.97639438474831
10154,Lake Bodom,710456,0,710456,2016.csv,2016,0.0,1.0
10155,Kiangnan 1894,710318,0,710318,2019.csv,2019,0.0,1.0
10156,The Code on the Fingertips,710023,0,710023,2019.csv,2019,0.0,1.0
10157,"Janosch: Komm, wir finden einen Schatz",709626,0,709626,2012.csv,2012,0.0,1.0
10158,Mary,709528,0,709528,2019.csv,2019,0.0,1.0
10159,Muscle Shoals,709415,696241,13174,2013.csv,2013,0.9814297695988948,0.018570230401105135
10160,Florence and the Uffizi Gallery 3D/4K,709410,0,709410,2015.csv,2015,0.0,1.0
10161,Helwe Ktir W Kezzabi,709211,0,709211,2013.csv,2013,0.0,1.0
10162,Kochaj!,708782,0,708782,2016.csv,2016,0.0,1.0
10163,Paris Countdown,708757,1055,707702,2013.csv,2013,0.001488521453756365,0.9985114785462437
10164,Jatt & Juliet 2,708716,0,708716,2013.csv,2013,0.0,1.0
10165,Rouh's Beauty,708449,0,708449,2014.csv,2014,0.0,1.0
10166,Gori Tere Pyaar Mein!,708440,342184,366256,2013.csv,2013,0.48301055841002766,0.5169894415899723
10167,Kaanchi,708373,0,708373,2014.csv,2014,0.0,1.0
10168,Frankie,708193,171781,536412,2019.csv,2019,0.24256240883487976,0.7574375911651202
10169,Trophy Wife,708010,0,708010,2014.csv,2014,0.0,1.0
10170,Habana Eva,707988,0,707988,2010.csv,2010,0.0,1.0
10171,Lamb of God: The Concert Film,707988,707988,0,2021.csv,2021,1.0,0.0
10172,Open at Night,707875,0,707875,2017.csv,2017,0.0,1.0
10173,HBO Boxing: Canelo Alvarez vs. Gennady Golovkin II,707875,707875,0,2018.csv,2018,1.0,0.0
10174,Passione,707460,255355,452105,2010.csv,2010,0.3609462019054081,0.639053798094592
10175,My Ex-Wife's Wedding,707387,0,707387,2010.csv,2010,0.0,1.0
10176,Ghostbusters 2020 Re-release,706606,605000,101606,2020.csv,2020,0.8562055799129925,0.14379442008700746
10177,Legend of a Rabbit: The Martial of Fire,706354,0,706354,2015.csv,2015,0.0,1.0
10178,Buried Alive 2010 Re-release,706270,0,706270,2010.csv,2010,0.0,1.0
10179,The Last House on the Left 2012 Re-release,706170,0,706170,2012.csv,2012,0.0,1.0
10180,Manslaughter,705949,0,705949,2012.csv,2012,0.0,1.0
10181,The Lost Medallion: The Adventures of Billy Stone,705854,549632,156222,2013.csv,2013,0.7786766101771755,0.22132338982282454
10182,Life Is Beautiful 2016 Re-release,705489,0,705489,2016.csv,2016,0.0,1.0
10183,Ed Sheeran: Jumpers for Goalposts,705145,0,705145,2014.csv,2014,0.0,1.0
10184,Pantai Norasingha,705120,0,705120,2015.csv,2015,0.0,1.0
10185,Itzhak,704968,607290,97678,2018.csv,2018,0.8614433562941864,0.1385566437058136
10186,Blaze,704955,704955,0,2018.csv,2018,1.0,0.0
10187,The Shining 2019 Re-release,704716,551257,153459,2019.csv,2019,0.7822399377905426,0.21776006220945743
10188,Happy Times,704628,0,704628,2015.csv,2015,0.0,1.0
10189,Moterys meluoja geriau. Robertelis,704625,0,704625,2018.csv,2018,0.0,1.0
10190,Gurrumul,704070,0,704070,2018.csv,2018,0.0,1.0
10191,Systemfehler - Wenn Inge tanzt,703902,0,703902,2013.csv,2013,0.0,1.0
10192,90 Minutes,703803,0,703803,2012.csv,2012,0.0,1.0
10193,Spitfire,703795,0,703795,2018.csv,2018,0.0,1.0
10194,All I Want for Christmas,703734,0,703734,2018.csv,2018,0.0,1.0
10195,Akira 2020 Re-release,703470,0,703470,2020.csv,2020,0.0,1.0
10196,Countdown to Canelo vs. Golovkin,703396,703396,0,2017.csv,2017,1.0,0.0
10197,Mini Force: The Beginning,702457,0,702457,2016.csv,2016,0.0,1.0
10198,Everybody's Business,702336,0,702336,2013.csv,2013,0.0,1.0
10199,Ghost Hospital,702276,0,702276,2016.csv,2016,0.0,1.0
10200,Buena Vista Social Club: Adios,701575,123445,578130,2017.csv,2017,0.1759541032676478,0.8240458967323522
10201,The Mommy Returns,701389,0,701389,2012.csv,2012,0.0,1.0
10202,Le Quattro Volte,701334,152530,548804,2010.csv,2010,0.21748553470956777,0.7825144652904322
10203,56 Up,701278,701278,0,2013.csv,2013,1.0,0.0
10204,El cumple de la abuela,701193,0,701193,2016.csv,2016,0.0,1.0
10205,Njandukalude Naattil Oridavela,701169,0,701169,2017.csv,2017,0.0,1.0
10206,Heat,701042,0,701042,2011.csv,2011,0.0,1.0
10207,Our Children,700215,23203,677012,2012.csv,2012,0.033136965075012674,0.9668630349249874
10208,Frog Kingdom 2015 Re-release,700172,0,700172,2015.csv,2015,0.0,1.0
10209,Golden Oldies 2,700070,0,700070,2013.csv,2013,0.0,1.0
10210,Student A,700068,0,700068,2018.csv,2018,0.0,1.0
10211,"Vzroslaya doch, ili Test na... 2010 Re-release",699703,0,699703,2010.csv,2010,0.0,1.0
10212,Australian Dream,699338,0,699338,2019.csv,2019,0.0,1.0
10213,Se sei così ti dico sì,698910,0,698910,2011.csv,2011,0.0,1.0
10214,Stopped on Track,698829,0,698829,2011.csv,2011,0.0,1.0
10215,Tonkatsu DJ Age-Taro,698683,0,698683,2020.csv,2020,0.0,1.0
10216,Mitron,698636,0,698636,2018.csv,2018,0.0,1.0
10217,Vendo ou Alugo,698594,0,698594,2013.csv,2013,0.0,1.0
10218,The Greatest Movie Ever Sold,698249,638476,59773,2011.csv,2011,0.914395867376824,0.08560413262317597
10219,War on Everyone,698036,0,698036,2016.csv,2016,0.0,1.0
10220,Dying of the Light,697847,0,697847,2014.csv,2014,0.0,1.0
10221,Fatal Intuition,697826,0,697826,2015.csv,2015,0.0,1.0
10222,Kuroko No Basket Movie 3: Winter Cup Soushuuhen - Tobira No Mukou,697678,0,697678,2016.csv,2016,0.0,1.0
10223,Brillebjørn på bondegården,697247,0,697247,2018.csv,2018,0.0,1.0
10224,Three Days and a Life,697180,0,697180,2019.csv,2019,0.0,1.0
10225,Shapito-shou: Lyubov i druzhba,696511,0,696511,2012.csv,2012,0.0,1.0
10226,Patterns of Evidence: The Red Sea Miracle,696191,696191,0,2020.csv,2020,1.0,0.0
10227,Diablo. The race for everything,696126,0,696126,2018.csv,2018,0.0,1.0
10228,Barbie: Dolphin Magic,695987,0,695987,2017.csv,2017,0.0,1.0
10229,Tas Mektep,695939,0,695939,2013.csv,2013,0.0,1.0
10230,Frankie & Alice 2014 Re-release,695876,695876,0,2014.csv,2014,1.0,0.0
10231,Sezn@mka,695554,0,695554,2016.csv,2016,0.0,1.0
10232,Raise Hell: The Life & Times of Molly Ivins,695327,694410,917,2019.csv,2019,0.9986811960415747,0.0013188039584253164
10233,The Least of These: The Graham Staines Story,695164,607015,88149,2019.csv,2019,0.8731968283743117,0.12680317162568833
10234,The Congress 2013 Re-release,695131,137815,557316,2013.csv,2013,0.19825759461166312,0.8017424053883369
10235,Jim Henson's Holiday Special with Fraggle Rock and Emmet Otter,695130,695130,0,2018.csv,2018,1.0,0.0
10236,The Secret Scripture,694981,0,694981,2017.csv,2017,0.0,1.0
10237,In the Aisles,694586,28394,666192,2018.csv,2018,0.04087902721909166,0.9591209727809084
10238,Copacabana Palace 2010 Re-release,694338,0,694338,2010.csv,2010,0.0,1.0
10239,Possession,694193,0,694193,2010.csv,2010,0.0,1.0
10240,Varane Avashyamund,694187,0,694187,2020.csv,2020,0.0,1.0
10241,Chris Brown: Welcome To My Life,693984,693984,0,2017.csv,2017,1.0,0.0
10242,Dinosaurs: Prehistoric Planet,693797,0,693797,2016.csv,2016,0.0,1.0
10243,How Poets Wait for a Miracle,693741,0,693741,2016.csv,2016,0.0,1.0
10244,Hello Life,693523,0,693523,2018.csv,2018,0.0,1.0
10245,Milada,692646,0,692646,2017.csv,2017,0.0,1.0
10246,Cuties,692459,0,692459,2020.csv,2020,0.0,1.0
10247,Sar Basa,691996,0,691996,2019.csv,2019,0.0,1.0
10248,The Second Sight,691442,0,691442,2013.csv,2013,0.0,1.0
10249,Spud 2: The Madness Continues,691342,0,691342,2013.csv,2013,0.0,1.0
10250,Phua Chu Kang: The Movie,691336,0,691336,2010.csv,2010,0.0,1.0
10251,Mini Special Forces X,691040,0,691040,2018.csv,2018,0.0,1.0
10252,Love Punjab,690925,0,690925,2016.csv,2016,0.0,1.0
10253,Bon Bini: Judeska in da House,690397,0,690397,2020.csv,2020,0.0,1.0
10254,Kanikuly prezidenta,690196,0,690196,2018.csv,2018,0.0,1.0
10255,Klimt & Schiele: Eros and Psyche,690081,0,690081,2018.csv,2018,0.0,1.0
10256,Deep in the Heart,690000,0,690000,2015.csv,2015,0.0,1.0
10257,Ferrari Ki Sawaari,689861,434107,255754,2012.csv,2012,0.6292673451608367,0.37073265483916323
10258,Greetings from the North,689597,0,689597,2015.csv,2015,0.0,1.0
10259,The Fencer,689477,0,689477,2015.csv,2015,0.0,1.0
10260,Love Trip,688869,0,688869,2018.csv,2018,0.0,1.0
10261,The Stronghold,688806,0,688806,2017.csv,2017,0.0,1.0
10262,Romeo Akbar Walter,688719,236299,452420,2019.csv,2019,0.34309929013138885,0.6569007098686112
10263,"Russland - Im Reich der Tiger, Bären und Vulkane",688685,0,688685,2011.csv,2011,0.0,1.0
10264,Pixie,688519,0,688519,2020.csv,2020,0.0,1.0
10265,La horse,688225,0,688225,2010.csv,2010,0.0,1.0
10266,Worms,688009,0,688009,2013.csv,2013,0.0,1.0
10267,De brief voor Sinterklaas,687738,0,687738,2019.csv,2019,0.0,1.0
10268,Cobain: Montage of Heck,687649,0,687649,2015.csv,2015,0.0,1.0
10269,Vettai,687636,204373,483263,2012.csv,2012,0.29721102443734765,0.7027889755626523
10270,Tom at the Farm,687505,0,687505,2014.csv,2014,0.0,1.0
10271,Yang and His Summer,686594,0,686594,2017.csv,2017,0.0,1.0
10272,Black's Game,686545,0,686545,2012.csv,2012,0.0,1.0
10273,Let's Sin,686484,0,686484,2014.csv,2014,0.0,1.0
10274,Mr. Church,685780,685780,0,2016.csv,2016,1.0,0.0
10275,King Shakir: Let the Game Begin,685572,0,685572,2018.csv,2018,0.0,1.0
10276,Intimate Enemies,685244,0,685244,2015.csv,2015,0.0,1.0
10277,"Tarp musu, mergaiciu",685082,0,685082,2018.csv,2018,0.0,1.0
10278,Jez Jerzy,684957,0,684957,2011.csv,2011,0.0,1.0
10279,Pirouette et le sapin de Noël,684946,0,684946,2019.csv,2019,0.0,1.0
10280,Black Panther 2020 Re-release,684812,367000,317812,2020.csv,2020,0.5359135061885598,0.46408649381144024
10281,Hidden Love,684806,0,684806,2017.csv,2017,0.0,1.0
10282,Chatroom,683912,0,683912,2010.csv,2010,0.0,1.0
10283,"Excentrycy, czyli po slonecznej stronie ulicy",683205,0,683205,2016.csv,2016,0.0,1.0
10284,Ghost in Barber's,683146,0,683146,2017.csv,2017,0.0,1.0
10285,The Drudgery Train,683056,0,683056,2012.csv,2012,0.0,1.0
10286,Sye Raa Narasimha Reddy,682418,0,682418,2019.csv,2019,0.0,1.0
10287,Göktasi,682360,0,682360,2018.csv,2018,0.0,1.0
10288,The Kindergarten Teacher,681765,0,681765,2018.csv,2018,0.0,1.0
10289,Brigsby Bear,681632,532669,148963,2017.csv,2017,0.7814612576874325,0.21853874231256748
10290,Tilt,681419,0,681419,2011.csv,2011,0.0,1.0
10291,Ghastly,681403,0,681403,2011.csv,2011,0.0,1.0
10292,80 Millions,680834,0,680834,2011.csv,2011,0.0,1.0
10293,Ouija 4,680791,0,680791,2015.csv,2015,0.0,1.0
10294,"Right Now, Wrong Then",680728,24470,656258,2015.csv,2015,0.035946809885886874,0.9640531901141132
10295,Astral,680649,0,680649,2019.csv,2019,0.0,1.0
10296,Convoy 48,680578,0,680578,2019.csv,2019,0.0,1.0
10297,3 Generations,680351,155936,524415,2016.csv,2016,0.2291993397525689,0.7708006602474311
10298,A Matter of Faith,680113,680113,0,2014.csv,2014,1.0,0.0
10299,Choe-gang-jeon-sa Mi-ni-teuk-gong-dae: Yeong-ung-ui Tan-saeng,679695,0,679695,2016.csv,2016,0.0,1.0
10300,Mai Ka Mum,679534,0,679534,2011.csv,2011,0.0,1.0
10301,3faltig,679408,0,679408,2010.csv,2010,0.0,1.0
10302,Bait 2019 Re-release,679159,0,679159,2019.csv,2019,0.0,1.0
10303,I Spit on Your Grave 2,678604,809,677795,2013.csv,2013,0.0011921533029572474,0.9988078466970427
10304,To My 19-Year-Old,678553,0,678553,2018.csv,2018,0.0,1.0
10305,The King of Tibetan Antelope,678152,0,678152,2015.csv,2015,0.0,1.0
10306,All I See Is You,678150,217644,460506,2017.csv,2017,0.32093784560937844,0.6790621543906216
10307,Theri,678057,0,678057,2016.csv,2016,0.0,1.0
10308,Queen Marie of Romania,677896,0,677896,2019.csv,2019,0.0,1.0
10309,Facia Üçlü,677830,0,677830,2018.csv,2018,0.0,1.0
10310,Vares: Gambling Chip,677482,0,677482,2012.csv,2012,0.0,1.0
10311,The Price of Success,677086,0,677086,2017.csv,2017,0.0,1.0
10312,Haunted Sisters,677053,0,677053,2017.csv,2017,0.0,1.0
10313,Li Xue Sheng,676981,0,676981,2018.csv,2018,0.0,1.0
10314,"Suicide Made: Kwang-suk, Kim",676693,0,676693,2017.csv,2017,0.0,1.0
10315,Baaghi,676602,438207,238395,2016.csv,2016,0.6476584461766297,0.3523415538233703
10316,Mole Family - Haunted Forest,676539,0,676539,2015.csv,2015,0.0,1.0
10317,38,676407,0,676407,2014.csv,2014,0.0,1.0
10318,V Tsenturiya. V poiskakh zacharovannykh sokrovishch,676149,0,676149,2010.csv,2010,0.0,1.0
10319,Tyrannosaur,676111,22321,653790,2011.csv,2011,0.03301380986258173,0.9669861901374183
10320,Virados do Avesso,675566,0,675566,2014.csv,2014,0.0,1.0
10321,Héroes verdaderos,674607,0,674607,2010.csv,2010,0.0,1.0
10322,5 to 7,674579,162685,511894,2015.csv,2015,0.24116523046225868,0.7588347695377413
10323,The Lighthouse of the Whales,674493,0,674493,2016.csv,2016,0.0,1.0
10324,Kaththi,674359,0,674359,2014.csv,2014,0.0,1.0
10325,Yaktin Beni,674070,0,674070,2015.csv,2015,0.0,1.0
10326,Take Home Pay,673954,0,673954,2019.csv,2019,0.0,1.0
10327,Viento en contra,673866,0,673866,2011.csv,2011,0.0,1.0
10328,Anna and the Apocalypse,673523,545597,127926,2018.csv,2018,0.8100643927527345,0.1899356072472655
10329,Beyond the Hills,673493,124919,548574,2012.csv,2012,0.18547928486264892,0.8145207151373511
10330,Keu-ge doil nom,673244,0,673244,2019.csv,2019,0.0,1.0
10331,Tek Tek Boom,672908,0,672908,2011.csv,2011,0.0,1.0
10332,Malaventura,672888,0,672888,2015.csv,2015,0.0,1.0
10333,Once Upon an Island,672826,0,672826,2015.csv,2015,0.0,1.0
10334,Into the World,672729,0,672729,2020.csv,2020,0.0,1.0
10335,The Secret of S,672565,0,672565,2017.csv,2017,0.0,1.0
10336,Four Kids and It,672438,0,672438,2020.csv,2020,0.0,1.0
10337,Best Intentions,672282,0,672282,2018.csv,2018,0.0,1.0
10338,Dieumerci!,672079,0,672079,2016.csv,2016,0.0,1.0
10339,Mabup Chunjamun,671377,0,671377,2010.csv,2010,0.0,1.0
10340,The Trump Prophecy,671198,671198,0,2018.csv,2018,1.0,0.0
10341,The Man Who Bought the Moon,670855,0,670855,2019.csv,2019,0.0,1.0
10342,A Windfall Trap,670573,0,670573,2019.csv,2019,0.0,1.0
10343,Gosto Se Discute,670399,0,670399,2017.csv,2017,0.0,1.0
10344,Non c'è campo,670209,0,670209,2017.csv,2017,0.0,1.0
10345,Kingdom of Conquerors,670000,0,670000,2013.csv,2013,0.0,1.0
10346,Cairo 678,669933,0,669933,2011.csv,2011,0.0,1.0
10347,Cuky Luky film,669640,0,669640,2017.csv,2017,0.0,1.0
10348,Hanna's Journey,669525,0,669525,2014.csv,2014,0.0,1.0
10349,Perfect Imperfection,669445,0,669445,2016.csv,2016,0.0,1.0
10350,The Polar Express 2012 IMAX Release,669289,669289,0,2012.csv,2012,1.0,0.0
10351,Fort Bliss,669247,0,669247,2014.csv,2014,0.0,1.0
10352,Wait Here,669128,0,669128,2018.csv,2018,0.0,1.0
10353,Bright Days Ahead 2013 Re-release,669085,21770,647315,2013.csv,2013,0.03253697213358542,0.9674630278664146
10354,Phata Poster Nikhla Hero,669070,410526,258544,2013.csv,2013,0.6135770547177425,0.38642294528225746
10355,Emilia,669037,0,669037,2017.csv,2017,0.0,1.0
10356,The Unborn Child,668858,0,668858,2011.csv,2011,0.0,1.0
10357,Burying the Ex,668777,0,668777,2015.csv,2015,0.0,1.0
10358,Tai Chi 2: The Hero Rises,668484,35067,633417,2012.csv,2012,0.05245750085267561,0.9475424991473244
10359,Struggle for Life,667962,0,667962,2016.csv,2016,0.0,1.0
10360,My Prince Edward,667735,0,667735,2020.csv,2020,0.0,1.0
10361,Girlfriend Boyfriend,667626,64414,603212,2012.csv,2012,0.09648216216863933,0.9035178378313606
10362,Mahpeyker - Kösem Sultan,667292,0,667292,2010.csv,2010,0.0,1.0
10363,1939 Battle of Westerplatte,667149,0,667149,2013.csv,2013,0.0,1.0
10364,Someday This Pain Will Be Useful to You,666922,0,666922,2012.csv,2012,0.0,1.0
10365,Deano and Nige's Best Last Day Ever,666832,0,666832,2012.csv,2012,0.0,1.0
10366,Victor & Célia,666720,0,666720,2019.csv,2019,0.0,1.0
10367,Mi-Ni-Teuk-Gong-Dae X,666204,0,666204,2018.csv,2018,0.0,1.0
10368,Bethany Hamilton: Unstoppable,666178,590671,75507,2019.csv,2019,0.8866564191552407,0.1133435808447592
10369,The Assent,666086,0,666086,2020.csv,2020,0.0,1.0
10370,A Bottle in the Gaza Sea,666011,5872,660139,2012.csv,2012,0.008816671196121385,0.9911833288038786
10371,Mr. Gaga: A True Story of Love and Dance,665617,173994,491623,2016.csv,2016,0.2614025783596272,0.7385974216403728
10372,C'est ça l'amour,665603,0,665603,2019.csv,2019,0.0,1.0
10373,Stockholm,665527,292590,372937,2019.csv,2019,0.43963655869709267,0.5603634413029073
10374,The Chosen: Forbidden Cave,665148,0,665148,2015.csv,2015,0.0,1.0
10375,Selfie 69,664351,0,664351,2016.csv,2016,0.0,1.0
10376,Bizi Hatirla,664016,0,664016,2018.csv,2018,0.0,1.0
10377,Long Story Short,663815,0,663815,2021.csv,2021,0.0,1.0
10378,A Nail Clipper Romance,663773,0,663773,2017.csv,2017,0.0,1.0
10379,The Incredible Truth,663637,0,663637,2013.csv,2013,0.0,1.0
10380,Whatever Happened to My Revolution,663571,0,663571,2019.csv,2019,0.0,1.0
10381,Abattoir,663460,0,663460,2016.csv,2016,0.0,1.0
10382,Entaku,663432,0,663432,2014.csv,2014,0.0,1.0
10383,The Stanford Prison Experiment,663114,660561,2553,2015.csv,2015,0.9961499832607967,0.0038500167392032138
10384,Pirate TV,662986,0,662986,2012.csv,2012,0.0,1.0
10385,Toonpur Ka Superrhero,662821,0,662821,2010.csv,2010,0.0,1.0
10386,"S for Sex, S for Secrets",662432,0,662432,2015.csv,2015,0.0,1.0
10387,Neither with You,662428,0,662428,2019.csv,2019,0.0,1.0
10388,Mejor que nunca 2019 Re-release,662095,0,662095,2019.csv,2019,0.0,1.0
10389,Angamaly Diaries,661915,0,661915,2017.csv,2017,0.0,1.0
10390,Mara,661769,0,661769,2018.csv,2018,0.0,1.0
10391,When the Night,661427,0,661427,2011.csv,2011,0.0,1.0
10392,Uyare,661230,0,661230,2019.csv,2019,0.0,1.0
10393,Love Is Sunshine,661229,0,661229,2019.csv,2019,0.0,1.0
10394,Chez Gino,661084,0,661084,2011.csv,2011,0.0,1.0
10395,Don't Be Bad,660922,0,660922,2015.csv,2015,0.0,1.0
10396,City of Gold,660445,640979,19466,2016.csv,2016,0.9705259332722634,0.0294740667277366
10397,Camille Claudel 1915,660355,35296,625059,2013.csv,2013,0.05345003823700888,0.9465499617629911
10398,Son of a Gun,660241,0,660241,2014.csv,2014,0.0,1.0
10399,Whitestar,660151,0,660151,2019.csv,2019,0.0,1.0
10400,Dragged Across Concrete,660132,0,660132,2018.csv,2018,0.0,1.0
10401,Another Happy Day,659937,8464,651473,2011.csv,2011,0.012825466673333969,0.987174533326666
10402,While We're Young 2015 Re-release,659769,0,659769,2015.csv,2015,0.0,1.0
10403,The Woman in the Fifth,659769,113800,545969,2011.csv,2011,0.1724846120384559,0.8275153879615441
10404,The Goods,659554,0,659554,2012.csv,2012,0.0,1.0
10405,Onda su onda,659523,0,659523,2016.csv,2016,0.0,1.0
10406,The Painted Bird,659080,1460,657620,2019.csv,2019,0.002215209079322692,0.9977847909206773
10407,Dragon Ball Z: Broly - The Legendary Super Saiyan,658982,658982,0,2018.csv,2018,1.0,0.0
10408,East End Angels,658901,0,658901,2010.csv,2010,0.0,1.0
10409,Madame Bovary,658532,44235,614297,2015.csv,2015,0.06717213438375053,0.9328278656162495
10410,Chiang Khan Story,658122,0,658122,2014.csv,2014,0.0,1.0
10411,Black Water: Abyss,658110,0,658110,2020.csv,2020,0.0,1.0
10412,Cookie,657693,0,657693,2013.csv,2013,0.0,1.0
10413,On My Skin: The Last Seven Days of Stefano Cucchi,657690,0,657690,2018.csv,2018,0.0,1.0
10414,Khamis wa Jumah: Huroob Ijbari,657601,0,657601,2017.csv,2017,0.0,1.0
10415,Our Friend,657351,657351,0,2021.csv,2021,1.0,0.0
10416,Locos de Amor 3,657239,0,657239,2020.csv,2020,0.0,1.0
10417,Nobody from Nowhere,657097,0,657097,2014.csv,2014,0.0,1.0
10418,El mundo es nuestro,656882,0,656882,2012.csv,2012,0.0,1.0
10419,Madimak: Carina's Diary,656810,0,656810,2015.csv,2015,0.0,1.0
10420,Love Slave,656672,0,656672,2014.csv,2014,0.0,1.0
10421,Faan se trein,656661,0,656661,2014.csv,2014,0.0,1.0
10422,Snow Lotus,656631,0,656631,2017.csv,2017,0.0,1.0
10423,"Verpiss Dich, Schneewittchen",656528,0,656528,2018.csv,2018,0.0,1.0
10424,Fatih'in Fedaisi Kara Murat,656479,0,656479,2015.csv,2015,0.0,1.0
10425,"A White, White Day",656214,0,656214,2019.csv,2019,0.0,1.0
10426,Terri,655802,655802,0,2011.csv,2011,1.0,0.0
10427,Reindeerspotting - Escape from Santaland,654990,0,654990,2010.csv,2010,0.0,1.0
10428,Somebody to Love,654939,0,654939,2011.csv,2011,0.0,1.0
10429,Shadaa,654800,0,654800,2019.csv,2019,0.0,1.0
10430,Ballade vir 'n Enkeling,654714,0,654714,2015.csv,2015,0.0,1.0
10431,The Patience Stone,654587,148671,505916,2013.csv,2013,0.22712183407247624,0.7728781659275238
10432,Horror Stories III,654450,0,654450,2016.csv,2016,0.0,1.0
10433,No Problem,654369,285468,368901,2010.csv,2010,0.4362492721996305,0.5637507278003695
10434,Hai-Alarm am Müggelsee,654305,0,654305,2013.csv,2013,0.0,1.0
10435,A Month of Sundays,654116,0,654116,2016.csv,2016,0.0,1.0
10436,Miami,654019,0,654019,2017.csv,2017,0.0,1.0
10437,Whisky Galore,653866,20991,632875,2017.csv,2017,0.032102907935265025,0.967897092064735
10438,Tham Tu Hen-Ry,653576,0,653576,2015.csv,2015,0.0,1.0
10439,Jatt & Juliet,653479,0,653479,2012.csv,2012,0.0,1.0
10440,Maldamore,653416,0,653416,2014.csv,2014,0.0,1.0
10441,Ponyo 2018 Re-release,653072,653072,0,2018.csv,2018,1.0,0.0
10442,Rascals,652756,273829,378927,2011.csv,2011,0.4194967185288224,0.5805032814711776
10443,Amok,652713,0,652713,2017.csv,2017,0.0,1.0
10444,DTC -Yukemuri Junjou Hen- from HiGH & LOW,652537,0,652537,2018.csv,2018,0.0,1.0
10445,Billy T: Te Movie,652517,0,652517,2011.csv,2011,0.0,1.0
10446,O.T. The Movie,652445,0,652445,2014.csv,2014,0.0,1.0
10447,A Violent Life,652303,0,652303,2017.csv,2017,0.0,1.0
10448,In Secret,652228,444179,208049,2013.csv,2013,0.6810179875748972,0.3189820124251029
10449,The Haunting of Helena,651902,0,651902,2013.csv,2013,0.0,1.0
10450,Rudý kapitán,651765,0,651765,2016.csv,2016,0.0,1.0
10451,Meo Mai Moi,651467,0,651467,2015.csv,2015,0.0,1.0
10452,Alone,651445,537589,113856,2020.csv,2020,0.8252254603228208,0.17477453967717918
10453,Singham 2017 Re-release,650841,0,650841,2017.csv,2017,0.0,1.0
10454,Salinger,650675,583633,67042,2013.csv,2013,0.8969654589464786,0.10303454105352135
10455,Tum Bin 2,650387,0,650387,2016.csv,2016,0.0,1.0
10456,The Composer,649703,0,649703,2019.csv,2019,0.0,1.0
10457,The Extra Man,649626,453377,196249,2010.csv,2010,0.6979046405162355,0.3020953594837645
10458,The Family Fang,649555,262921,386634,2016.csv,2016,0.4047709585793351,0.5952290414206649
10459,El reality,649435,0,649435,2018.csv,2018,0.0,1.0
10460,"Love, Weddings & Other Disasters",649033,0,649033,2020.csv,2020,0.0,1.0
10461,Pornopung,649029,0,649029,2013.csv,2013,0.0,1.0
10462,Carry on Jatta,648911,0,648911,2012.csv,2012,0.0,1.0
10463,Fanatics,648557,0,648557,2012.csv,2012,0.0,1.0
10464,Broken,648008,0,648008,2018.csv,2018,0.0,1.0
10465,Leading Lady,647847,0,647847,2014.csv,2014,0.0,1.0
10466,Lost and Found,647840,0,647840,2019.csv,2019,0.0,1.0
10467,Chang Chen Ghost Stories: Be Possessed by Ghosts,647762,0,647762,2015.csv,2015,0.0,1.0
10468,City of Life,647666,0,647666,2010.csv,2010,0.0,1.0
10469,Besser Welt als Nie,647588,0,647588,2020.csv,2020,0.0,1.0
10470,Mary's Land,647441,0,647441,2013.csv,2013,0.0,1.0
10471,Jodorowsky's Dune,647280,647280,0,2014.csv,2014,1.0,0.0
10472,461 Lunch Boxes,647074,0,647074,2020.csv,2020,0.0,1.0
10473,Special 26,647074,0,647074,2013.csv,2013,0.0,1.0
10474,Benim Adim Feridun,646617,0,646617,2016.csv,2016,0.0,1.0
10475,Line of Duty,646389,8207,638182,2019.csv,2019,0.012696688835979573,0.9873033111640205
10476,Storage 24,646175,72,646103,2012.csv,2012,0.00011142492358881108,0.9998885750764112
10477,Foolish Plan,646105,0,646105,2016.csv,2016,0.0,1.0
10478,Halfway,645954,0,645954,2014.csv,2014,0.0,1.0
10479,Zinnia Flower,645786,0,645786,2015.csv,2015,0.0,1.0
10480,Gilbert's Grim Revenge,645590,0,645590,2016.csv,2016,0.0,1.0
10481,Tazza: One-Eyed Jack 2021 Re-release,645401,0,645401,2021.csv,2021,0.0,1.0
10482,Dorogoy papa,645377,0,645377,2019.csv,2019,0.0,1.0
10483,The Bride with Painted Skin,645256,0,645256,2016.csv,2016,0.0,1.0
10484,Forever Young,645148,0,645148,2010.csv,2010,0.0,1.0
10485,Da muss Mann durch,644922,0,644922,2015.csv,2015,0.0,1.0
10486,The Public,644740,573503,71237,2019.csv,2019,0.889510500356733,0.11048949964326706
10487,An Easy Girl,644582,0,644582,2019.csv,2019,0.0,1.0
10488,Odin vdokh,644262,0,644262,2020.csv,2020,0.0,1.0
10489,Rosebud,644236,0,644236,2019.csv,2019,0.0,1.0
10490,Rate Your Date,644155,0,644155,2019.csv,2019,0.0,1.0
10491,"Hjelp, vi er i filmbransjen",643805,0,643805,2011.csv,2011,0.0,1.0
10492,Dracula 3D,643758,8139,635619,2012.csv,2012,0.012642949679848638,0.9873570503201513
10493,I Am Mother,643593,0,643593,2019.csv,2019,0.0,1.0
10494,"Dark, Almost Night",642751,0,642751,2019.csv,2019,0.0,1.0
10495,Detective Downs,642575,0,642575,2013.csv,2013,0.0,1.0
10496,McLaren,642089,0,642089,2017.csv,2017,0.0,1.0
10497,Thaanaa Serndha Koottam,641973,0,641973,2018.csv,2018,0.0,1.0
10498,Love and Honor,641929,19684,622245,2012.csv,2012,0.030663827308004467,0.9693361726919956
10499,Music,641783,0,641783,2021.csv,2021,0.0,1.0
10500,Nise: The Heart of Madness,641510,0,641510,2016.csv,2016,0.0,1.0
10501,Lying and Stealing,641509,0,641509,2019.csv,2019,0.0,1.0
10502,Sparta,641359,0,641359,2016.csv,2016,0.0,1.0
10503,Marjaavaan,641154,174164,466990,2019.csv,2019,0.2716414465167495,0.7283585534832505
10504,Panya Raenu 2,641108,0,641108,2012.csv,2012,0.0,1.0
10505,Lu Pikirlah Sendiri,640980,0,640980,2010.csv,2010,0.0,1.0
10506,An Affair,640740,0,640740,2018.csv,2018,0.0,1.0
10507,Alois Nebel,640458,0,640458,2011.csv,2011,0.0,1.0
10508,Another Mother's Son,639967,0,639967,2017.csv,2017,0.0,1.0
10509,Code Geass: Lelouch of the Re;Surrection,639812,0,639812,2017.csv,2017,0.0,1.0
10510,Sajjan Singh Rangroot,639685,0,639685,2018.csv,2018,0.0,1.0
10511,H2-Oh!,639567,0,639567,2010.csv,2010,0.0,1.0
10512,Museum Hours,639121,561457,77664,2012.csv,2012,0.87848310413834,0.12151689586166
10513,Erkekler,639107,0,639107,2013.csv,2013,0.0,1.0
10514,Diggery,639052,0,639052,2016.csv,2016,0.0,1.0
10515,Herons,638984,0,638984,2020.csv,2020,0.0,1.0
10516,Aquarela,638907,307346,331561,2019.csv,2019,0.48104966763550877,0.5189503323644913
10517,"Derzhi udar, detka!",638823,0,638823,2016.csv,2016,0.0,1.0
10518,Inadequate People,638726,0,638726,2011.csv,2011,0.0,1.0
10519,Family of Winners,638695,0,638695,2017.csv,2017,0.0,1.0
10520,Force of Nature,638221,0,638221,2020.csv,2020,0.0,1.0
10521,Lóve,637750,0,637750,2011.csv,2011,0.0,1.0
10522,Snow in Midsummer,637626,0,637626,2017.csv,2017,0.0,1.0
10523,Judge Archer,637482,0,637482,2016.csv,2016,0.0,1.0
10524,Jack Goes Boating,637479,541992,95487,2010.csv,2010,0.8502115363800219,0.14978846361997808
10525,Heights,637346,0,637346,2017.csv,2017,0.0,1.0
10526,Italo Barocco,637136,0,637136,2015.csv,2015,0.0,1.0
10527,Welcome to Me,636819,608852,27967,2015.csv,2015,0.9560832826910001,0.04391671730899989
10528,The Virginity Hit,636706,636706,0,2010.csv,2010,1.0,0.0
10529,Into the White,636469,0,636469,2012.csv,2012,0.0,1.0
10530,Not Fade Away,636399,610792,25607,2012.csv,2012,0.9597626646176377,0.04023733538236232
10531,Siberia,636366,0,636366,2018.csv,2018,0.0,1.0
10532,Toman,636170,0,636170,2018.csv,2018,0.0,1.0
10533,You Don't Mess with Little Bugs,636032,0,636032,2019.csv,2019,0.0,1.0
10534,Batti Gul Meter Chalu,635869,249539,386330,2018.csv,2018,0.39243775054295776,0.6075622494570423
10535,The Last Lions,635325,635325,0,2011.csv,2011,1.0,0.0
10536,Kaboom,635162,118919,516243,2010.csv,2010,0.18722625094070489,0.8127737490592951
10537,Andre Rieu's Sydney Town Hall Concert - An Australian Celebration,634838,0,634838,2018.csv,2018,0.0,1.0
10538,A Beautiful Life,634784,66171,568613,2011.csv,2011,0.10424175782628421,0.8957582421737158
10539,Haikyu!! The Movie: Ending and Beginning,634583,0,634583,2016.csv,2016,0.0,1.0
10540,Karaoglan,634308,0,634308,2013.csv,2013,0.0,1.0
10541,No One Killed Jessica,634297,440525,193772,2011.csv,2011,0.6945090391409703,0.30549096085902977
10542,Tumhari Sulu,634114,0,634114,2017.csv,2017,0.0,1.0
10543,Collective Invention,634108,0,634108,2015.csv,2015,0.0,1.0
10544,Tracey,634018,0,634018,2018.csv,2018,0.0,1.0
10545,For the Birds,633959,0,633959,2016.csv,2016,0.0,1.0
10546,Nothing in Return,633906,0,633906,2015.csv,2015,0.0,1.0
10547,Then Came You,633632,0,633632,2019.csv,2019,0.0,1.0
10548,Love Undercover 4,633602,0,633602,2010.csv,2010,0.0,1.0
10549,Thalasso,632994,0,632994,2019.csv,2019,0.0,1.0
10550,The Black Prince,632823,0,632823,2017.csv,2017,0.0,1.0
10551,Grace Jones: Bloodlight and Bami,632394,375208,257186,2017.csv,2017,0.5933136620524546,0.4066863379475454
10552,My Neighbor's Wife,631793,0,631793,2011.csv,2011,0.0,1.0
10553,Ala Vaikunthapurramuloo,631683,0,631683,2020.csv,2020,0.0,1.0
10554,Fukrey Returns,631495,0,631495,2017.csv,2017,0.0,1.0
10555,Zvizdan,631431,0,631431,2015.csv,2015,0.0,1.0
10556,Secrets of the North Sea,631329,0,631329,2013.csv,2013,0.0,1.0
10557,Jonah: The Musical,631154,631154,0,2017.csv,2017,1.0,0.0
10558,Mermaid in Paris,630987,1988,628999,2020.csv,2020,0.0031506195848725886,0.9968493804151274
10559,The Devil's Bride,630987,0,630987,2011.csv,2011,0.0,1.0
10560,Justice in the Northwest,630896,0,630896,2018.csv,2018,0.0,1.0
10561,Colt 45,630787,0,630787,2014.csv,2014,0.0,1.0
10562,The Phobos,630706,0,630706,2010.csv,2010,0.0,1.0
10563,The Mule,630287,0,630287,2013.csv,2013,0.0,1.0
10564,Kappen!,629439,0,629439,2016.csv,2016,0.0,1.0
10565,Shut Up and Play the Hits,629107,510334,118773,2012.csv,2012,0.8112038174746108,0.18879618252538916
10566,"Não Se Preocupe, Nada Vai Dar Certo",628832,0,628832,2011.csv,2011,0.0,1.0
10567,Short Peace,628807,22862,605945,2013.csv,2013,0.03635773774783042,0.9636422622521695
10568,Invader,628677,0,628677,2012.csv,2012,0.0,1.0
10569,Together,628363,0,628363,2013.csv,2013,0.0,1.0
10570,Löwenzahn - Das Kinoabenteuer,628360,0,628360,2011.csv,2011,0.0,1.0
10571,The Word,628191,0,628191,2014.csv,2014,0.0,1.0
10572,The Gold Seekers,627902,0,627902,2017.csv,2017,0.0,1.0
10573,When the Lights Went Out,627716,0,627716,2012.csv,2012,0.0,1.0
10574,Nicostratos the Pelican,627588,0,627588,2011.csv,2011,0.0,1.0
10575,Suddenly Twenty,627563,0,627563,2016.csv,2016,0.0,1.0
10576,Twixt,627327,0,627327,2012.csv,2012,0.0,1.0
10577,David Attenborough: A Life on Our Planet,627209,0,627209,2020.csv,2020,0.0,1.0
10578,Asako I & II,627102,25559,601543,2019.csv,2019,0.04075732496467879,0.9592426750353212
10579,Korkoro,627088,8242,618846,2010.csv,2010,0.013143290893782054,0.9868567091062179
10580,Secret of the Wings,627018,0,627018,2012.csv,2012,0.0,1.0
10581,Virus,626930,0,626930,2019.csv,2019,0.0,1.0
10582,The Anthem of the Heart,626730,0,626730,2017.csv,2017,0.0,1.0
10583,I'm Still Here,626396,408983,217413,2010.csv,2010,0.652914450283846,0.347085549716154
10584,Nurse 3D 2020 Re-release,626386,0,626386,2020.csv,2020,0.0,1.0
10585,"Love, Gilda",626318,626318,0,2018.csv,2018,1.0,0.0
10586,Varathan,626221,0,626221,2018.csv,2018,0.0,1.0
10587,All at Sea,626012,0,626012,2011.csv,2011,0.0,1.0
10588,Looking for Rohmer,625975,0,625975,2018.csv,2018,0.0,1.0
10589,Freedom 2015 Re-release,625775,0,625775,2015.csv,2015,0.0,1.0
10590,Alaska,624945,0,624945,2015.csv,2015,0.0,1.0
10591,The Summer Is Gone,624929,0,624929,2014.csv,2014,0.0,1.0
10592,Sleepless Night,624913,3358,621555,2011.csv,2011,0.005373547997881305,0.9946264520021187
10593,The Crucible,624875,0,624875,2014.csv,2014,0.0,1.0
10594,Space Dogs: Tropical Adventure,624859,0,624859,2020.csv,2020,0.0,1.0
10595,Give Me Liberty,624818,242734,382084,2019.csv,2019,0.3884875275680278,0.6115124724319722
10596,Syu-peo Ppae-kkom: Seu-pa-i Dae-jak-jeon,624763,0,624763,2017.csv,2017,0.0,1.0
10597,Expedition Happiness,624733,0,624733,2017.csv,2017,0.0,1.0
10598,The Sound of Music 2018 Re-release,624392,616171,8221,2018.csv,2018,0.9868335917180233,0.013166408281976707
10599,Beyond the Oneday - Story of 2PM and 2AM,624084,0,624084,2012.csv,2012,0.0,1.0
10600,Laxmii,623913,0,623913,2020.csv,2020,0.0,1.0
10601,Winter in Wartime 2010 Re-release,623392,543100,80292,2010.csv,2010,0.8712014270314665,0.12879857296853345
10602,Istoriya odnogo naznacheniya,623263,0,623263,2018.csv,2018,0.0,1.0
10603,Nancy Drew and the Hidden Staircase,623088,623088,0,2019.csv,2019,1.0,0.0
10604,Dirty Dancing 2019 Re-release,622968,622968,0,2019.csv,2019,1.0,0.0
10605,Masal Satosu: Sihirli Davet,621852,0,621852,2019.csv,2019,0.0,1.0
10606,Range 15,621738,621738,0,2016.csv,2016,1.0,0.0
10607,And Then We Danced,621446,177262,444184,2019.csv,2019,0.2852411955342862,0.7147588044657138
10608,Kings & Rats,620926,0,620926,2012.csv,2012,0.0,1.0
10609,Moomins and the Comet Chase,620733,0,620733,2010.csv,2010,0.0,1.0
10610,Bolshoi Ballet: The Nutcracker,620723,303000,317723,2019.csv,2019,0.4881404426773295,0.5118595573226705
10611,Le leggi del desiderio,620658,0,620658,2015.csv,2015,0.0,1.0
10612,Die Hard 30th Anniversary Release,620525,510241,110284,2018.csv,2018,0.822273075218565,0.17772692478143506
10613,Der Atem des Himmels,620346,0,620346,2010.csv,2010,0.0,1.0
10614,Code Geass: Lelouch of the Re;Surrection 2018 Re-release,620280,0,620280,2018.csv,2018,0.0,1.0
10615,Tales from the Dark Part 2,620251,0,620251,2013.csv,2013,0.0,1.0
10616,"Happy, Happy",620238,45154,575084,2010.csv,2010,0.0728010860347157,0.9271989139652843
10617,Looktung Millionaire,620100,0,620100,2013.csv,2013,0.0,1.0
10618,Betrayal,620040,0,620040,2012.csv,2012,0.0,1.0
10619,Killerman,619855,291477,328378,2019.csv,2019,0.470234167668245,0.529765832331755
10620,Amy 2015 Re-release,619640,0,619640,2015.csv,2015,0.0,1.0
10621,Dianas bryllup,619621,0,619621,2020.csv,2020,0.0,1.0
10622,The Transformers,619597,619597,0,2018.csv,2018,1.0,0.0
10623,Nowitzki: The Perfect Shot,619517,41340,578177,2014.csv,2014,0.06672940371289246,0.9332705962871075
10624,The Diary of Carlota,619459,0,619459,2010.csv,2010,0.0,1.0
10625,Paradise: Faith,618696,6508,612188,2013.csv,2013,0.010518897810879656,0.9894811021891203
10626,Masha i Medved 3,618519,0,618519,2019.csv,2019,0.0,1.0
10627,Li and the Poet,617850,0,617850,2011.csv,2011,0.0,1.0
10628,King Petar the First,617831,0,617831,2018.csv,2018,0.0,1.0
10629,Paulo Coelho's Best Story,617377,8808,608569,2014.csv,2014,0.014266809421147856,0.9857331905788521
10630,Out in the Open,616905,0,616905,2019.csv,2019,0.0,1.0
10631,Breaking Through,616898,0,616898,2015.csv,2015,0.0,1.0
10632,Long quan xiao zi,616640,0,616640,2016.csv,2016,0.0,1.0
10633,Kristy,616506,0,616506,2014.csv,2014,0.0,1.0
10634,V siti 18+,616422,0,616422,2020.csv,2020,0.0,1.0
10635,Shakespeare Live! From the RSC,616342,0,616342,2016.csv,2016,0.0,1.0
10636,96,616333,0,616333,2018.csv,2018,0.0,1.0
10637,Ocean Heaven,616319,0,616319,2010.csv,2010,0.0,1.0
10638,"Néstor Kirchner, la película",616205,0,616205,2012.csv,2012,0.0,1.0
10639,Stray,616160,0,616160,2019.csv,2019,0.0,1.0
10640,The Adventures of the Ugly Duckling,616018,0,616018,2016.csv,2016,0.0,1.0
10641,Grandfathers,615930,0,615930,2019.csv,2019,0.0,1.0
10642,A Polar Year,615847,0,615847,2018.csv,2018,0.0,1.0
10643,The Bronze,615816,615816,0,2016.csv,2016,1.0,0.0
10644,Plae kao,615766,0,615766,2014.csv,2014,0.0,1.0
10645,Lost River,615500,45431,570069,2015.csv,2015,0.07381153533712428,0.9261884646628757
10646,Abu Shanab,615386,0,615386,2016.csv,2016,0.0,1.0
10647,The Reconstruction,615355,0,615355,2013.csv,2013,0.0,1.0
10648,The Bremen Bandits,615277,0,615277,2016.csv,2016,0.0,1.0
10649,The Angriest Man in Brooklyn,615198,0,615198,2014.csv,2014,0.0,1.0
10650,Conni und Co 2 - Das Geheimnis des T-Rex,615194,0,615194,2017.csv,2017,0.0,1.0
10651,Image,615184,0,615184,2014.csv,2014,0.0,1.0
10652,The Secrets We Keep,615113,207928,407185,2020.csv,2020,0.3380321989618168,0.6619678010381832
10653,Sisters: The Summer We Found Our Superpowers,614622,0,614622,2020.csv,2020,0.0,1.0
10654,Ernst & Bobbie en 'Het geheim van de Monta Rossa',614591,0,614591,2010.csv,2010,0.0,1.0
10655,Omar,614444,356000,258444,2013.csv,2013,0.5793855908756534,0.42061440912434656
10656,Rainbow: A Private Affair,614334,0,614334,2017.csv,2017,0.0,1.0
10657,The Factory,614316,0,614316,2019.csv,2019,0.0,1.0
10658,Stevie Nicks 24 Karat Gold the Concert,613612,410265,203347,2020.csv,2020,0.668606546156203,0.33139345384379704
10659,Ittymaani: Made in China,613540,0,613540,2019.csv,2019,0.0,1.0
10660,Agente Ñero Ñero 7: Comando Jungla,613149,0,613149,2017.csv,2017,0.0,1.0
10661,"Sí, Mi Amor",613049,0,613049,2020.csv,2020,0.0,1.0
10662,Die Wonderwerker,612755,0,612755,2012.csv,2012,0.0,1.0
10663,Walking the Camino: Six Ways to Santiago,612717,612717,0,2013.csv,2013,1.0,0.0
10664,The Returned,612521,0,612521,2013.csv,2013,0.0,1.0
10665,Bolshaya rzhaka,612481,0,612481,2012.csv,2012,0.0,1.0
10666,Tango libre,612377,0,612377,2012.csv,2012,0.0,1.0
10667,Finsterworld,611939,0,611939,2013.csv,2013,0.0,1.0
10668,Seven Days in Heaven,611866,0,611866,2010.csv,2010,0.0,1.0
10669,In Another Country,611365,25079,586286,2012.csv,2012,0.04102132114203463,0.9589786788579654
10670,"Tulipani: Liefde, eer en een fiets",611008,0,611008,2017.csv,2017,0.0,1.0
10671,A Wedding,610876,0,610876,2017.csv,2017,0.0,1.0
10672,Sümela'nin Sifresi 3: Cünyor Temel,610815,0,610815,2017.csv,2017,0.0,1.0
10673,Welcome to Norway,610580,0,610580,2016.csv,2016,0.0,1.0
10674,The Muppet Movie 2019 Re-release,610475,610475,0,2019.csv,2019,1.0,0.0
10675,Love Bank,610000,0,610000,2013.csv,2013,0.0,1.0
10676,The Deadly Strands,610000,0,610000,2013.csv,2013,0.0,1.0
10677,Two Days,609894,0,609894,2011.csv,2011,0.0,1.0
10678,Life in a Fishbowl,609888,0,609888,2014.csv,2014,0.0,1.0
10679,Project Nim,609880,411184,198696,2011.csv,2011,0.6742047615924445,0.3257952384075556
10680,The Wee Man,609607,0,609607,2013.csv,2013,0.0,1.0
10681,Avan Ivan,609530,0,609530,2011.csv,2011,0.0,1.0
10682,High School Fleet the Movie,609346,0,609346,2020.csv,2020,0.0,1.0
10683,Dead Before Dawn 3D,608881,0,608881,2012.csv,2012,0.0,1.0
10684,The Last Suit,608209,73548,534661,2017.csv,2017,0.12092553710977641,0.8790744628902236
10685,Amorosa: The Revenge,608173,0,608173,2012.csv,2012,0.0,1.0
10686,Shambala,607917,0,607917,2012.csv,2012,0.0,1.0
10687,Unter deutschen Betten,607723,0,607723,2017.csv,2017,0.0,1.0
10688,Mr. Right,607595,34694,572901,2016.csv,2016,0.057100535718694195,0.9428994642813058
10689,Wondrous Boccaccio,607313,0,607313,2015.csv,2015,0.0,1.0
10690,The Reports on Sarah and Saleem,607206,117479,489727,2018.csv,2018,0.1934747021603871,0.8065252978396129
10691,Boy Pick-Up: The Movie,607200,0,607200,2012.csv,2012,0.0,1.0
10692,400 Contra 1: Uma História do Crime Organizado,607187,0,607187,2010.csv,2010,0.0,1.0
10693,Genis Aile 2: Her Türlü,607170,0,607170,2016.csv,2016,0.0,1.0
10694,Life in a Day,607169,252788,354381,2011.csv,2011,0.4163387788243471,0.5836612211756529
10695,Beware the Gorilla,607078,0,607078,2019.csv,2019,0.0,1.0
10696,La última fiesta,606962,0,606962,2016.csv,2016,0.0,1.0
10697,King of Mahjong,606900,0,606900,2015.csv,2015,0.0,1.0
10698,Bolshoi Ballet: The Sleeping Beauty,606872,311368,295504,2019.csv,2019,0.513070301480378,0.4869296985196219
10699,Fly Me to Venus,606752,0,606752,2015.csv,2015,0.0,1.0
10700,The Sixth Time,606691,0,606691,2017.csv,2017,0.0,1.0
10701,Neither Wolf Nor Dog,606511,606511,0,2017.csv,2017,1.0,0.0
10702,Showdown in Manila,606238,0,606238,2016.csv,2016,0.0,1.0
10703,Kaos örümcek agi,606190,0,606190,2012.csv,2012,0.0,1.0
10704,The Walking Dead: Wrath/The Walking Dead/Fear the Walking Dead: What's Your Story?/Fear the Walking Dead,605764,605764,0,2018.csv,2018,1.0,0.0
10705,Bell Chamber,605757,0,605757,2019.csv,2019,0.0,1.0
10706,Kaappaan,605756,0,605756,2019.csv,2019,0.0,1.0
10707,Hold Me Tight,605613,0,605613,2010.csv,2010,0.0,1.0
10708,Summer in February,605403,1624,603779,2013.csv,2013,0.0026825106581896685,0.9973174893418103
10709,So It's You,605209,0,605209,2014.csv,2014,0.0,1.0
10710,The Rumble of the Stones,604565,0,604565,2011.csv,2011,0.0,1.0
10711,The Golden Glove,604479,6160,598319,2019.csv,2019,0.010190593883327626,0.9898094061166723
10712,The Hows of Us,603917,0,603917,2018.csv,2018,0.0,1.0
10713,Queen of Walking,603699,0,603699,2016.csv,2016,0.0,1.0
10714,"DCI 2019: Big, Loud & Live 16",603320,603320,0,2018.csv,2018,1.0,0.0
10715,All Roads Lead to Rome,602872,0,602872,2016.csv,2016,0.0,1.0
10716,Hanii,602803,0,602803,2018.csv,2018,0.0,1.0
10717,Reasonable Doubt,602802,0,602802,2014.csv,2014,0.0,1.0
10718,Les naufragés,602788,0,602788,2016.csv,2016,0.0,1.0
10719,Undertow,602059,108620,493439,2010.csv,2010,0.1804142118961763,0.8195857881038238
10720,Lost Crime,601496,0,601496,2010.csv,2010,0.0,1.0
10721,The Moon Child,601289,0,601289,2011.csv,2011,0.0,1.0
10722,The Little Death,601162,18238,582924,2014.csv,2014,0.03033791224328883,0.9696620877567111
10723,The Dolphin: Story of a Dreamer 2011 Re-release,600785,0,600785,2011.csv,2011,0.0,1.0
10724,Underset,600768,0,600768,2018.csv,2018,0.0,1.0
10725,The Grateful Dead Meet-Up 2018,600554,600554,0,2018.csv,2018,1.0,0.0
10726,Children Who Chase Lost Voices,600486,0,600486,2011.csv,2011,0.0,1.0
10727,Belgica,600455,0,600455,2016.csv,2016,0.0,1.0
10728,Lahoriye,600376,0,600376,2017.csv,2017,0.0,1.0
10729,Oh Lucy!,600145,375391,224754,2018.csv,2018,0.6255005040448558,0.37449949595514415
10730,The Net,599913,0,599913,2016.csv,2016,0.0,1.0
10731,"Allez, Eddy!",599888,0,599888,2012.csv,2012,0.0,1.0
10732,Jimi: All Is by My Side,599840,340911,258929,2014.csv,2014,0.568336556415044,0.431663443584956
10733,Lailat Hana wa Suroor,599817,0,599817,2018.csv,2018,0.0,1.0
10734,Freier Fall,599721,0,599721,2013.csv,2013,0.0,1.0
10735,The Soul of Shui People in 1944,599574,0,599574,2018.csv,2018,0.0,1.0
10736,The Fencer 2016 Re-release,599537,95952,503585,2016.csv,2016,0.1600435002343475,0.8399564997656525
10737,Romeo Juliet,599252,0,599252,2015.csv,2015,0.0,1.0
10738,Cuidado con lo que sueñas,599153,0,599153,2013.csv,2013,0.0,1.0
10739,The Whisper,599101,0,599101,2016.csv,2016,0.0,1.0
10740,Egon Schiele: Tod und Mädchen,598929,0,598929,2016.csv,2016,0.0,1.0
10741,The Metropolitan Opera HD Live: Philip Glass: Akhnaten,598901,0,598901,2019.csv,2019,0.0,1.0
10742,Rocks,598859,0,598859,2020.csv,2020,0.0,1.0
10743,Reprisal,598625,0,598625,2018.csv,2018,0.0,1.0
10744,Güelcom tu Colombia,598593,0,598593,2015.csv,2015,0.0,1.0
10745,Como en el cine,598265,0,598265,2015.csv,2015,0.0,1.0
10746,Saturday Killer,597862,0,597862,2010.csv,2010,0.0,1.0
10747,Dreams Come True,597660,0,597660,2010.csv,2010,0.0,1.0
10748,The Mole,597199,0,597199,2011.csv,2011,0.0,1.0
10749,Sneekweek,597149,0,597149,2016.csv,2016,0.0,1.0
10750,Ninkyo Gakuen,597134,0,597134,2019.csv,2019,0.0,1.0
10751,The One I Love,596933,513447,83486,2014.csv,2014,0.8601417579527351,0.13985824204726494
10752,Backstage,596591,0,596591,2018.csv,2018,0.0,1.0
10753,Waiting for the Hearse,596550,0,596550,2012.csv,2012,0.0,1.0
10754,Damat Takimi,595949,0,595949,2017.csv,2017,0.0,1.0
10755,Trust,595802,120016,475786,2011.csv,2011,0.20143604754599684,0.7985639524540031
10756,Skin Trade,595268,1242,594026,2015.csv,2015,0.002086455176491933,0.997913544823508
10757,Maharshi,595200,0,595200,2019.csv,2019,0.0,1.0
10758,Blue Like Jazz,595018,595018,0,2012.csv,2012,1.0,0.0
10759,The Metropolitan Opera HD Live: Massenet: Manon,594963,0,594963,2019.csv,2019,0.0,1.0
10760,Todo lo que tú quieras,594935,0,594935,2010.csv,2010,0.0,1.0
10761,In the Blood,594860,0,594860,2014.csv,2014,0.0,1.0
10762,Kamisama Minarai: Himitsu no Cocotama,594847,0,594847,2017.csv,2017,0.0,1.0
10763,Ixcanul,594836,295157,299679,2015.csv,2015,0.4961989523162687,0.5038010476837314
10764,Are You Here,594396,0,594396,2014.csv,2014,0.0,1.0
10765,The Armstrong Lie,594394,383294,211100,2013.csv,2013,0.644848366571668,0.35515163342833206
10766,Boss,594283,0,594283,2013.csv,2013,0.0,1.0
10767,Three Sisters 2021 Re-release,594075,0,594075,2021.csv,2021,0.0,1.0
10768,7 Minutes,593966,0,593966,2016.csv,2016,0.0,1.0
10769,The Candidate,593437,0,593437,2013.csv,2013,0.0,1.0
10770,Two Lottery Tickets,593418,0,593418,2016.csv,2016,0.0,1.0
10771,Don't. Get. Out!,593078,0,593078,2019.csv,2019,0.0,1.0
10772,Comme des garçons,592954,0,592954,2018.csv,2018,0.0,1.0
10773,The Wonderland,592866,50876,541990,2019.csv,2019,0.08581365772366774,0.9141863422763322
10774,The Big Lebowski 2018 Re-release,592832,582585,10247,2018.csv,2018,0.9827151705710893,0.01728482942891072
10775,The Broken 2012 Re-release,592509,0,592509,2012.csv,2012,0.0,1.0
10776,To Kill a Mockingbird 2019 Re-release,592237,592237,0,2019.csv,2019,1.0,0.0
10777,Compliance,592116,319285,272831,2012.csv,2012,0.5392271109039445,0.4607728890960555
10778,Many Heavens,592047,0,592047,2017.csv,2017,0.0,1.0
10779,Rough Play,592021,0,592021,2013.csv,2013,0.0,1.0
10780,The Cure: Anniversary 1978-2018 Live in Hyde Park,591904,378405,213499,2019.csv,2019,0.6393013056171271,0.3606986943828729
10781,Siruthai,591700,0,591700,2011.csv,2011,0.0,1.0
10782,Rifkin's Festival,591465,0,591465,2020.csv,2020,0.0,1.0
10783,As Jy Sing,591018,0,591018,2013.csv,2013,0.0,1.0
10784,Love Games,591008,0,591008,2016.csv,2016,0.0,1.0
10785,Pasmerkti. Kauno Romanas,591008,0,591008,2019.csv,2019,0.0,1.0
10786,Seberg,590837,434702,156135,2020.csv,2020,0.7357392986559745,0.2642607013440255
10787,The Human Resources Manager,590567,64014,526553,2010.csv,2010,0.10839413648239743,0.8916058635176026
10788,Foute Vrienden,590441,0,590441,2015.csv,2015,0.0,1.0
10789,Kiddo the Hacker,590359,0,590359,2018.csv,2018,0.0,1.0
10790,My Valentine,589984,0,589984,2010.csv,2010,0.0,1.0
10791,Storm Surfers 3D,589945,117090,472855,2012.csv,2012,0.19847612913068166,0.8015238708693183
10792,Wajib,589794,0,589794,2018.csv,2018,0.0,1.0
10793,Greetings from Fukushima,589491,0,589491,2016.csv,2016,0.0,1.0
10794,Perfect Partner,589311,0,589311,2011.csv,2011,0.0,1.0
10795,Starry Starry Night,589299,10033,579266,2011.csv,2011,0.01702531312627376,0.9829746868737262
10796,Shortcut,588869,588869,0,2020.csv,2020,1.0,0.0
10797,Ojos Rojos,588779,0,588779,2010.csv,2010,0.0,1.0
10798,Eiourinn,588272,0,588272,2016.csv,2016,0.0,1.0
10799,El último justo 2010 Re-release,588184,0,588184,2010.csv,2010,0.0,1.0
10800,Gallants,588151,0,588151,2010.csv,2010,0.0,1.0
10801,The Signal 2014 Re-release,588041,0,588041,2014.csv,2014,0.0,1.0
10802,The Guest,587873,0,587873,2016.csv,2016,0.0,1.0
10803,Nao Zai Wan Zhong,587839,0,587839,2015.csv,2015,0.0,1.0
10804,Elvis on Tour,587818,587818,0,2010.csv,2010,1.0,0.0
10805,La influencia,587782,0,587782,2019.csv,2019,0.0,1.0
10806,Americano,587592,0,587592,2016.csv,2016,0.0,1.0
10807,La hija de Moctezuma,587461,0,587461,2014.csv,2014,0.0,1.0
10808,Thunderstruck,587211,587211,0,2012.csv,2012,1.0,0.0
10809,Upstream Color,587174,444098,143076,2013.csv,2013,0.7563311727017885,0.24366882729821143
10810,Papanasam,586973,0,586973,2015.csv,2015,0.0,1.0
10811,La pelea de mi vida,586530,0,586530,2012.csv,2012,0.0,1.0
10812,StarDog and TurboCat,586399,80490,505909,2019.csv,2019,0.13726148919080694,0.8627385108091931
10813,Mobile Suit Gundam the Origin IV,586061,0,586061,2016.csv,2016,0.0,1.0
10814,Sinterklaas & Diego: Het geheim van de ring,585901,0,585901,2014.csv,2014,0.0,1.0
10815,Fruit Story,585388,0,585388,2016.csv,2016,0.0,1.0
10816,Benji,585333,0,585333,2018.csv,2018,0.0,1.0
10817,One Role for Two,585074,0,585074,2019.csv,2019,0.0,1.0
10818,Sweethearts,585028,0,585028,2019.csv,2019,0.0,1.0
10819,Grandma's Wedding,584868,0,584868,2019.csv,2019,0.0,1.0
10820,The 9th Life of Louis Drax,584723,0,584723,2016.csv,2016,0.0,1.0
10821,The Black Panthers: Vanguard of the Revolution,584109,516893,67216,2015.csv,2015,0.8849255875187679,0.1150744124812321
10822,Undefeated,583844,562218,21626,2012.csv,2012,0.9629592836442611,0.03704071635573886
10823,Gleason,583664,583664,0,2016.csv,2016,1.0,0.0
10824,Un'avventura,583497,0,583497,2019.csv,2019,0.0,1.0
10825,The Flat,583443,471842,111601,2012.csv,2012,0.8087199606473983,0.1912800393526017
10826,Schoßgebete,583178,0,583178,2014.csv,2014,0.0,1.0
10827,The Owners,583134,0,583134,2020.csv,2020,0.0,1.0
10828,Poorna,583012,0,583012,2017.csv,2017,0.0,1.0
10829,7 Sea Pirates,582094,0,582094,2012.csv,2012,0.0,1.0
10830,Ghost Bride,582022,0,582022,2017.csv,2017,0.0,1.0
10831,White God,581904,282358,299546,2014.csv,2014,0.48523124089196845,0.5147687591080315
10832,Kenau,581801,0,581801,2014.csv,2014,0.0,1.0
10833,Inmate Zero,581583,0,581583,2020.csv,2020,0.0,1.0
10834,"Knock, Knock Who's There",581260,0,581260,2015.csv,2015,0.0,1.0
10835,Klitschko,580487,0,580487,2011.csv,2011,0.0,1.0
10836,The Superdeep,580409,0,580409,2020.csv,2020,0.0,1.0
10837,Novitiate,580346,580346,0,2017.csv,2017,1.0,0.0
10838,Stranded 2013 Re-release,580215,0,580215,2013.csv,2013,0.0,1.0
10839,Hypnosis,580049,0,580049,2020.csv,2020,0.0,1.0
10840,Super Bear,580014,0,580014,2018.csv,2018,0.0,1.0
10841,Dead Sign,580000,0,580000,2013.csv,2013,0.0,1.0
10842,Bedeviled,579942,0,579942,2017.csv,2017,0.0,1.0
10843,The Family House,579830,0,579830,2017.csv,2017,0.0,1.0
10844,Prima di lunedì,579732,0,579732,2016.csv,2016,0.0,1.0
10845,Requiem Pour Une Tueuse - Requiem for A Killer,579633,0,579633,2011.csv,2011,0.0,1.0
10846,Choe-gang-jeon-sa Mi-ni-teuk-gong-dae,579452,0,579452,2015.csv,2015,0.0,1.0
10847,Ghadi,579164,0,579164,2013.csv,2013,0.0,1.0
10848,Odd Thomas 2015 Re-release,579099,0,579099,2015.csv,2015,0.0,1.0
10849,Let's Talk,578990,0,578990,2015.csv,2015,0.0,1.0
10850,Patlabor: The Movie,578959,0,578959,2020.csv,2020,0.0,1.0
10851,Dance of the 41,578919,0,578919,2020.csv,2020,0.0,1.0
10852,Harry & Snowman,578820,561460,17360,2016.csv,2016,0.9700079472029302,0.0299920527970699
10853,I'm a Killer,578768,0,578768,2016.csv,2016,0.0,1.0
10854,Status: It's Complicated!,578612,0,578612,2013.csv,2013,0.0,1.0
10855,Tuhog,578482,0,578482,2013.csv,2013,0.0,1.0
10856,Weird Science: Future Bride,578152,0,578152,2016.csv,2016,0.0,1.0
10857,On the Balcony,577923,0,577923,2019.csv,2019,0.0,1.0
10858,All About Them,577789,0,577789,2015.csv,2015,0.0,1.0
10859,Bilal: A New Breed of Hero 2018 Re-release,576805,490973,85832,2018.csv,2018,0.8511940777212402,0.14880592227875972
10860,Soul Story,576472,0,576472,2015.csv,2015,0.0,1.0
10861,The One Who Loved You,576403,0,576403,2018.csv,2018,0.0,1.0
10862,Ugly Nasty People,575160,0,575160,2017.csv,2017,0.0,1.0
10863,A Mother's Story,574764,0,574764,2012.csv,2012,0.0,1.0
10864,Boys Will Be Boys,574527,0,574527,2016.csv,2016,0.0,1.0
10865,Twilight Online,574253,0,574253,2014.csv,2014,0.0,1.0
10866,Annem,573574,0,573574,2019.csv,2019,0.0,1.0
10867,Guardians of the Galaxy 2020 Re-release,573547,542000,31547,2020.csv,2020,0.944996661128033,0.0550033388719669
10868,The Intent 2: The Come Up,573194,0,573194,2018.csv,2018,0.0,1.0
10869,Ho ucciso Napoleone,573115,0,573115,2015.csv,2015,0.0,1.0
10870,Clara,573023,0,573023,2019.csv,2019,0.0,1.0
10871,Heaven on Earth,572895,0,572895,2015.csv,2015,0.0,1.0
10872,Mesrine: Killer Instinct 2010 Re-release,572790,551697,21093,2010.csv,2010,0.9631749855968156,0.03682501440318441
10873,Thomas & Friends: King of the Railway,572255,0,572255,2013.csv,2013,0.0,1.0
10874,El Paseo De Teresa,572079,0,572079,2017.csv,2017,0.0,1.0
10875,Yesterday Never Ends,572044,0,572044,2013.csv,2013,0.0,1.0
10876,Mosley,571947,0,571947,2019.csv,2019,0.0,1.0
10877,11 Minutes,571697,0,571697,2015.csv,2015,0.0,1.0
10878,15 Years and One Day,571096,0,571096,2013.csv,2013,0.0,1.0
10879,What Ever Happened to Timi,570354,0,570354,2014.csv,2014,0.0,1.0
10880,Odd Thomas,570168,0,570168,2013.csv,2013,0.0,1.0
10881,First Snowfall,570104,0,570104,2013.csv,2013,0.0,1.0
10882,A Girl at My Door,569809,0,569809,2014.csv,2014,0.0,1.0
10883,Beauty in a Bottle,569802,0,569802,2014.csv,2014,0.0,1.0
10884,"Rio, I Love You",569755,0,569755,2014.csv,2014,0.0,1.0
10885,Velaikkaran,569727,0,569727,2017.csv,2017,0.0,1.0
10886,The Falling,569498,0,569498,2015.csv,2015,0.0,1.0
10887,Crimes of Passion: Death of a Loved One,569491,0,569491,2013.csv,2013,0.0,1.0
10888,108 Costuras,569340,0,569340,2019.csv,2019,0.0,1.0
10889,Seni Seviyorum Adamim,569022,0,569022,2014.csv,2014,0.0,1.0
10890,Federal,568819,0,568819,2010.csv,2010,0.0,1.0
10891,Debt Fees,568757,0,568757,2019.csv,2019,0.0,1.0
10892,Ramaleela,568241,0,568241,2017.csv,2017,0.0,1.0
10893,Ladies,567945,0,567945,2017.csv,2017,0.0,1.0
10894,Alma,567883,0,567883,2015.csv,2015,0.0,1.0
10895,The Justice of Wolves,567700,0,567700,2010.csv,2010,0.0,1.0
10896,Kaiketsu Zorori the Movie: Secret Of,567421,0,567421,2017.csv,2017,0.0,1.0
10897,We Are the Pirates of the Roads,567265,0,567265,2015.csv,2015,0.0,1.0
10898,Precious Cargo,567064,0,567064,2016.csv,2016,0.0,1.0
10899,Aikatsu! Music Award: Minna de Shou wo MoracchaimaShow!,567006,0,567006,2015.csv,2015,0.0,1.0
10900,Once Upon a Time in Shanghai,566985,0,566985,2014.csv,2014,0.0,1.0
10901,Headfirst,566795,0,566795,2014.csv,2014,0.0,1.0
10902,FIGHT LIKE ANGELS,566764,0,566764,2019.csv,2019,0.0,1.0
10903,Somuncu Baba: Askin Sirri,566636,0,566636,2016.csv,2016,0.0,1.0
10904,Goodbye to Language,566423,401889,164534,2014.csv,2014,0.7095209763727814,0.2904790236272185
10905,Kottan ermittelt: Rien ne va plus,566395,0,566395,2010.csv,2010,0.0,1.0
10906,Battle,566386,0,566386,2019.csv,2019,0.0,1.0
10907,Classmates 2: New Turn,566232,0,566232,2017.csv,2017,0.0,1.0
10908,5 Is the Perfect Number,565965,0,565965,2019.csv,2019,0.0,1.0
10909,The Last Fashion Show,565895,0,565895,2011.csv,2011,0.0,1.0
10910,Baby Done,565602,0,565602,2020.csv,2020,0.0,1.0
10911,Üç Harfliler 2: Hablis,565020,0,565020,2015.csv,2015,0.0,1.0
10912,I'm All Yours,565000,0,565000,2015.csv,2015,0.0,1.0
10913,Margaret,564864,46495,518369,2011.csv,2011,0.08231184851574892,0.9176881514842511
10914,Christmas at Cattle Hill,564401,0,564401,2020.csv,2020,0.0,1.0
10915,Jackie Chan Presents: Amnesia,563883,0,563883,2015.csv,2015,0.0,1.0
10916,The Cat Returns 2018 Re-release,563718,563718,0,2018.csv,2018,1.0,0.0
10917,Bitcoin Heist,562919,0,562919,2016.csv,2016,0.0,1.0
10918,Like Someone in Love,562878,239056,323822,2012.csv,2012,0.4247030439988772,0.5752969560011229
10919,Beetlejuice 2018 Re-release,562613,512947,49666,2018.csv,2018,0.911722622833102,0.08827737716689803
10920,The Happiest Day in the Life of Olli Maki,562537,0,562537,2016.csv,2016,0.0,1.0
10921,Frank & Fearless,562375,0,562375,2018.csv,2018,0.0,1.0
10922,Paquete #3,562076,0,562076,2015.csv,2015,0.0,1.0
10923,Unfinished,561767,0,561767,2018.csv,2018,0.0,1.0
10924,Felony,561369,0,561369,2014.csv,2014,0.0,1.0
10925,Il-sa-gag-o,561131,0,561131,2016.csv,2016,0.0,1.0
10926,My Fair Lady 2019 Re-release,560711,560711,0,2019.csv,2019,1.0,0.0
10927,Bir Avuç Deniz,560622,0,560622,2011.csv,2011,0.0,1.0
10928,A Remarkable Tale,560504,0,560504,2019.csv,2019,0.0,1.0
10929,Hibiscus & Ruthless,560481,0,560481,2018.csv,2018,0.0,1.0
10930,Zhe Yang Yi Wei Jiang Jun,560328,0,560328,2015.csv,2015,0.0,1.0
10931,The Pills: Sempre meglio che lavorare,560041,0,560041,2016.csv,2016,0.0,1.0
10932,Max 2015 Re-release,559828,0,559828,2015.csv,2015,0.0,1.0
10933,Brave ragazze,559369,0,559369,2019.csv,2019,0.0,1.0
10934,My Name Is Kim Bok Dong,559065,0,559065,2019.csv,2019,0.0,1.0
10935,Fiddler: A Miracle of Miracles,558816,549386,9430,2019.csv,2019,0.9831250357899559,0.016874964210044092
10936,The Dance of Reality,558636,293680,264956,2013.csv,2013,0.5257090484680543,0.47429095153194567
10937,Mae Bia,558098,0,558098,2015.csv,2015,0.0,1.0
10938,Cine Holliúdy 2: A Chibata Sideral,558037,0,558037,2019.csv,2019,0.0,1.0
10939,Christmas Jars,558018,459462,98556,2019.csv,2019,0.8233820414395234,0.17661795856047655
10940,"AAA, la película: Sin límite en el tiempo",557931,0,557931,2010.csv,2010,0.0,1.0
10941,Perras,557845,0,557845,2011.csv,2011,0.0,1.0
10942,Forrest Gump 2014 IMAX Release,557683,557683,0,2014.csv,2014,1.0,0.0
10943,The Violin Teacher,557588,0,557588,2015.csv,2015,0.0,1.0
10944,Castle in the Sky 2018 Re-release,557541,523664,33877,2018.csv,2018,0.9392385492726095,0.060761450727390455
10945,Rojo,557092,94757,462335,2018.csv,2018,0.1700921930309536,0.8299078069690464
10946,Kdyz draka boli hlava,556872,0,556872,2018.csv,2018,0.0,1.0
10947,Time Traveller,556798,0,556798,2010.csv,2010,0.0,1.0
10948,Familienfest,556456,0,556456,2015.csv,2015,0.0,1.0
10949,Waar,556003,0,556003,2014.csv,2014,0.0,1.0
10950,Samaritan's Purse presents Facing Darkness,555533,555533,0,2017.csv,2017,1.0,0.0
10951,Circumstance,555511,454121,101390,2011.csv,2011,0.8174833621656457,0.18251663783435432
10952,Dolores,555309,555309,0,2017.csv,2017,1.0,0.0
10953,Woman,555073,0,555073,2020.csv,2020,0.0,1.0
10954,Love Stories,554976,0,554976,2016.csv,2016,0.0,1.0
10955,Every Thing Will Be Fine,554953,9233,545720,2015.csv,2015,0.01663744497281752,0.9833625550271825
10956,Endless Poetry,554706,153440,401266,2016.csv,2016,0.2766149996574762,0.7233850003425238
10957,12 mesyatsev. Novaya skazka,554645,0,554645,2015.csv,2015,0.0,1.0
10958,Nikka Zaildar 2,554305,0,554305,2017.csv,2017,0.0,1.0
10959,Egg,554295,0,554295,2020.csv,2020,0.0,1.0
10960,Felfel Abyad,554274,0,554274,2019.csv,2019,0.0,1.0
10961,When the Lights Went Out 2014 Re-release,554213,0,554213,2014.csv,2014,0.0,1.0
10962,The Venerable W.,554098,0,554098,2017.csv,2017,0.0,1.0
10963,Matching Jack,553424,0,553424,2010.csv,2010,0.0,1.0
10964,Wolf 2010 Re-release,553170,0,553170,2010.csv,2010,0.0,1.0
10965,Klein Karoo,553119,0,553119,2013.csv,2013,0.0,1.0
10966,LoveShhuda,552922,0,552922,2016.csv,2016,0.0,1.0
10967,"Josee, the Tiger and the Fish 2020 Re-release",552832,0,552832,2020.csv,2020,0.0,1.0
10968,Goldstone,552757,0,552757,2016.csv,2016,0.0,1.0
10969,Yes or No,552629,0,552629,2010.csv,2010,0.0,1.0
10970,Back to the Future 2020 Re-release,552473,247000,305473,2020.csv,2020,0.44708067181563627,0.5529193281843637
10971,All in All Azhagu Raja,552188,0,552188,2013.csv,2013,0.0,1.0
10972,The Day Shall Come,552033,26972,525061,2019.csv,2019,0.04885939789831405,0.9511406021016859
10973,The Queen of Fear,551930,0,551930,2018.csv,2018,0.0,1.0
10974,Rangasthalam 1985,551820,0,551820,2018.csv,2018,0.0,1.0
10975,Baby Phone,551802,0,551802,2017.csv,2017,0.0,1.0
10976,Viral,551760,0,551760,2016.csv,2016,0.0,1.0
10977,Warning,551488,0,551488,2013.csv,2013,0.0,1.0
10978,Iki Kafadar: Chinese Connection,551364,0,551364,2013.csv,2013,0.0,1.0
10979,Bulmaca Kulesi: Dev Kusun Gizemi,551050,0,551050,2019.csv,2019,0.0,1.0
10980,Diva 2012 Re-release,551006,0,551006,2012.csv,2012,0.0,1.0
10981,Janaan,550899,0,550899,2016.csv,2016,0.0,1.0
10982,The Special Relationship,550789,0,550789,2010.csv,2010,0.0,1.0
10983,Open Windows,550108,1750,548358,2014.csv,2014,0.0031811935110923673,0.9968188064889076
10984,Sunstrokes,549905,0,549905,2014.csv,2014,0.0,1.0
10985,Branagh Theatre Live: The Winter's Tale 2019,549770,0,549770,2019.csv,2019,0.0,1.0
10986,Dhadak,549628,0,549628,2018.csv,2018,0.0,1.0
10987,"The Old Man, Child and Foreigner",549493,0,549493,2015.csv,2015,0.0,1.0
10988,Gangster Ka: African,549448,0,549448,2015.csv,2015,0.0,1.0
10989,Zanetti Story,549437,0,549437,2015.csv,2015,0.0,1.0
10990,Mr. Cop,549196,0,549196,2019.csv,2019,0.0,1.0
10991,23 Blast,549185,549185,0,2014.csv,2014,1.0,0.0
10992,Owl Mountain,549006,0,549006,2018.csv,2018,0.0,1.0
10993,Best Supporting Actor,548959,0,548959,2010.csv,2010,0.0,1.0
10994,Divã a 2,548762,0,548762,2015.csv,2015,0.0,1.0
10995,Two Brides and One Wedding,548632,0,548632,2018.csv,2018,0.0,1.0
10996,Followed,548608,538179,10429,2020.csv,2020,0.9809900694120391,0.019009930587960803
10997,Üç Harfliler: Adak,548237,0,548237,2019.csv,2019,0.0,1.0
10998,Aadu - Oru Bheegara Jeevi Aanu 2,548189,0,548189,2018.csv,2018,0.0,1.0
10999,Trai Tim Quai Vat,548175,0,548175,2020.csv,2020,0.0,1.0
11000,We Are X,548126,45270,502856,2016.csv,2016,0.0825904992647676,0.9174095007352324
11001,Git Basimdan,548011,0,548011,2014.csv,2014,0.0,1.0
11002,Blue Valentine 2013 Re-release,547915,0,547915,2013.csv,2013,0.0,1.0
11003,"Casanova, Last Love",547793,0,547793,2019.csv,2019,0.0,1.0
11004,My Wedding and Other Secrets,547672,0,547672,2011.csv,2011,0.0,1.0
11005,Que Pena Tu Vida,547626,0,547626,2010.csv,2010,0.0,1.0
11006,The Courier,547269,0,547269,2019.csv,2019,0.0,1.0
11007,Palace of the Damned,547134,0,547134,2017.csv,2017,0.0,1.0
11008,Deliormanli,546823,0,546823,2016.csv,2016,0.0,1.0
11009,Vikram Vedha,546792,0,546792,2017.csv,2017,0.0,1.0
11010,Succede,546697,0,546697,2018.csv,2018,0.0,1.0
11011,Planetarium,546584,3262,543322,2016.csv,2016,0.005967975645097551,0.9940320243549025
11012,System Crasher,546444,0,546444,2019.csv,2019,0.0,1.0
11013,Eureka Seven: Hi-Evolution 1,546384,0,546384,2017.csv,2017,0.0,1.0
11014,A Girl Walks Home Alone at Night,546352,491910,54442,2014.csv,2014,0.9003536181802209,0.0996463818197792
11015,Tonight We Dine at Iokastis,546342,0,546342,2015.csv,2015,0.0,1.0
11016,My Generation,546183,0,546183,2018.csv,2018,0.0,1.0
11017,Rudderless,546149,58293,487856,2014.csv,2014,0.10673460905357329,0.8932653909464268
11018,"DCI 2019: Big, Loud & Live 16",546060,546060,0,2019.csv,2019,1.0,0.0
11019,The Singer 2020 Re-release,546017,0,546017,2020.csv,2020,0.0,1.0
11020,Rabat,545764,0,545764,2011.csv,2011,0.0,1.0
11021,Zahradnictví: Rodinný prítel,545677,0,545677,2017.csv,2017,0.0,1.0
11022,Foxfire: Confessions of a Girl Gang,545658,0,545658,2013.csv,2013,0.0,1.0
11023,Angrej,545546,0,545546,2015.csv,2015,0.0,1.0
11024,Hoofmeisie,545328,0,545328,2011.csv,2011,0.0,1.0
11025,Battle,545206,0,545206,2018.csv,2018,0.0,1.0
11026,Miss Happy,545143,0,545143,2015.csv,2015,0.0,1.0
11027,Super Four,544914,0,544914,2018.csv,2018,0.0,1.0
11028,The Art of the Steal,544890,544890,0,2010.csv,2010,1.0,0.0
11029,Porinju Mariyam Jose,544889,0,544889,2019.csv,2019,0.0,1.0
11030,Ninja: Shadow of a Tear,544853,0,544853,2014.csv,2014,0.0,1.0
11031,He's Out There,544674,0,544674,2018.csv,2018,0.0,1.0
11032,Suriname,544343,0,544343,2020.csv,2020,0.0,1.0
11033,Bear with Us,543116,0,543116,2018.csv,2018,0.0,1.0
11034,On Any Sunday: The Next Chapter,543044,543044,0,2014.csv,2014,1.0,0.0
11035,Of All the Things,542932,0,542932,2012.csv,2012,0.0,1.0
11036,Endless Loop,542586,0,542586,2018.csv,2018,0.0,1.0
11037,My Cactus Heart,542331,0,542331,2012.csv,2012,0.0,1.0
11038,Move,542086,0,542086,2012.csv,2012,0.0,1.0
11039,Wallander: Den orolige mannen,542024,0,542024,2013.csv,2013,0.0,1.0
11040,The Case of the Dead Deadman,541723,0,541723,2020.csv,2020,0.0,1.0
11041,Die Ostsee von oben,541635,0,541635,2013.csv,2013,0.0,1.0
11042,Gledelig jul,541549,0,541549,2020.csv,2020,0.0,1.0
11043,The Club,541515,52761,488754,2015.csv,2015,0.09743220409406941,0.9025677959059306
11044,Maya the Bee 3: The Golden Orb,541499,0,541499,2021.csv,2021,0.0,1.0
11045,Poslednyaya skazka Rity,541362,0,541362,2012.csv,2012,0.0,1.0
11046,Tunnel,541083,0,541083,2014.csv,2014,0.0,1.0
11047,Aadhi,540930,0,540930,2018.csv,2018,0.0,1.0
11048,Worst Woman,540926,0,540926,2016.csv,2016,0.0,1.0
11049,Father and Sons,540812,0,540812,2019.csv,2019,0.0,1.0
11050,Dragon Ball Z: Bardock - The Father of Goku/Dragon Ball Z: Fusion Reborn,540707,540707,0,2018.csv,2018,1.0,0.0
11051,On the Way to School 2015 Re-release,540658,7424,533234,2015.csv,2015,0.013731416163267722,0.9862685838367323
11052,Love Action Drama,540541,0,540541,2019.csv,2019,0.0,1.0
11053,The Hardy Bucks Movie,540419,0,540419,2013.csv,2013,0.0,1.0
11054,Kaip susigrazinti ja per 7 dienas,540406,0,540406,2017.csv,2017,0.0,1.0
11055,Liz in September,540390,0,540390,2014.csv,2014,0.0,1.0
11056,Property Master,540348,0,540348,2019.csv,2019,0.0,1.0
11057,Søsken til evig tid,540248,0,540248,2013.csv,2013,0.0,1.0
11058,Double Xposure,540000,0,540000,2014.csv,2014,0.0,1.0
11059,Running All the Way,540000,0,540000,2013.csv,2013,0.0,1.0
11060,95,539966,0,539966,2017.csv,2017,0.0,1.0
11061,Lullaby Killer,539954,0,539954,2017.csv,2017,0.0,1.0
11062,Sean Banan inuti Seanfrika,539841,0,539841,2012.csv,2012,0.0,1.0
11063,André Rieu: Magical Maastricht,539780,0,539780,2020.csv,2020,0.0,1.0
11064,Yok Artik 2,539716,0,539716,2016.csv,2016,0.0,1.0
11065,The Shooter,539631,0,539631,2013.csv,2013,0.0,1.0
11066,Tell Me When,539584,0,539584,2020.csv,2020,0.0,1.0
11067,DINO X Adventure Squad,539407,0,539407,2016.csv,2016,0.0,1.0
11068,Villain,538997,0,538997,2017.csv,2017,0.0,1.0
11069,A Street in Palermo,538992,0,538992,2013.csv,2013,0.0,1.0
11070,Strayer's Chronicle,538798,0,538798,2015.csv,2015,0.0,1.0
11071,Reis,538551,0,538551,2017.csv,2017,0.0,1.0
11072,Lyubov v Gorode Angelov,538208,0,538208,2017.csv,2017,0.0,1.0
11073,The Golem,538176,0,538176,2019.csv,2019,0.0,1.0
11074,Ask Olsun,538102,0,538102,2015.csv,2015,0.0,1.0
11075,Guardians of the Night,538091,0,538091,2016.csv,2016,0.0,1.0
11076,Phas Gaye Re Obama,537952,0,537952,2010.csv,2010,0.0,1.0
11077,Born to Suffer,537825,0,537825,2010.csv,2010,0.0,1.0
11078,"High Heels, Low Tide",537451,0,537451,2012.csv,2012,0.0,1.0
11079,Swingers 2,537311,0,537311,2019.csv,2019,0.0,1.0
11080,Uso happyaku,537307,0,537307,2018.csv,2018,0.0,1.0
11081,Killed My Wife,537193,0,537193,2019.csv,2019,0.0,1.0
11082,Loving Is Losing,537185,0,537185,2019.csv,2019,0.0,1.0
11083,Grateful Dead Meet-Up 2019,537153,537153,0,2019.csv,2019,1.0,0.0
11084,The Weekend,537038,0,537038,2013.csv,2013,0.0,1.0
11085,Our Hodja,537028,0,537028,2014.csv,2014,0.0,1.0
11086,Players,536945,0,536945,2012.csv,2012,0.0,1.0
11087,Frozen Silence,536761,0,536761,2012.csv,2012,0.0,1.0
11088,CatVideoFest,536566,470923,65643,2019.csv,2019,0.8776609028525848,0.12233909714741523
11089,Once Were Brothers: Robbie Robertson and the Band,536534,449561,86973,2020.csv,2020,0.8378984370049242,0.1621015629950758
11090,Karwaan,536525,182009,354516,2018.csv,2018,0.3392367550440334,0.6607632449559666
11091,Sisters in Arms,536522,0,536522,2019.csv,2019,0.0,1.0
11092,Parava,536418,0,536418,2017.csv,2017,0.0,1.0
11093,Ti sposo ma non troppo,536396,0,536396,2014.csv,2014,0.0,1.0
11094,Talenttyven,536147,0,536147,2012.csv,2012,0.0,1.0
11095,Weeds on Fire,536012,0,536012,2017.csv,2017,0.0,1.0
11096,O Fim da Inocência,535954,0,535954,2017.csv,2017,0.0,1.0
11097,Home kwamrak kwamsuk kwam songjam,535678,0,535678,2012.csv,2012,0.0,1.0
11098,Lasting,535674,0,535674,2013.csv,2013,0.0,1.0
11099,Body Fat Index of Love,535433,0,535433,2012.csv,2012,0.0,1.0
11100,Corazón ardiente,535425,0,535425,2020.csv,2020,0.0,1.0
11101,Working Class Boy,535182,0,535182,2018.csv,2018,0.0,1.0
11102,Barcelona Christmas Night,535025,0,535025,2015.csv,2015,0.0,1.0
11103,Slumboy-Soi-Teeed,534888,0,534888,2017.csv,2017,0.0,1.0
11104,Judgementall Hai Kya,534878,0,534878,2019.csv,2019,0.0,1.0
11105,Phoenix 11·23,534683,0,534683,2012.csv,2012,0.0,1.0
11106,Hungry Hearts,534549,6921,527628,2015.csv,2015,0.012947363104224308,0.9870526368957757
11107,Prazdniny v Provence,534252,0,534252,2016.csv,2016,0.0,1.0
11108,Spicy Beauty Queen of Bangkok 2,534073,0,534073,2012.csv,2012,0.0,1.0
11109,Vergiss mein nicht,533885,0,533885,2013.csv,2013,0.0,1.0
11110,What They Had,533579,260136,273443,2018.csv,2018,0.4875304312950847,0.5124695687049153
11111,Crazy Loves,533412,0,533412,2010.csv,2010,0.0,1.0
11112,Creature,533235,508714,24521,2011.csv,2011,0.9540146464504393,0.0459853535495607
11113,Kill Your Friends,533147,0,533147,2015.csv,2015,0.0,1.0
11114,Cheers for the Youth,533102,0,533102,2017.csv,2017,0.0,1.0
11115,Silvio Forever,532916,0,532916,2011.csv,2011,0.0,1.0
11116,Kahaani 2,532877,350703,182174,2016.csv,2016,0.6581312385409767,0.3418687614590234
11117,Försvunnen,532521,0,532521,2011.csv,2011,0.0,1.0
11118,Liza the Fox-Fairy,532381,0,532381,2015.csv,2015,0.0,1.0
11119,Air Strike,532377,0,532377,2018.csv,2018,0.0,1.0
11120,Shi Youm Rah Fil,532298,0,532298,2015.csv,2015,0.0,1.0
11121,The Hijack That Went South,532269,0,532269,2013.csv,2013,0.0,1.0
11122,Senin Hikayen,531873,0,531873,2013.csv,2013,0.0,1.0
11123,Standing Ovation,531806,531806,0,2010.csv,2010,1.0,0.0
11124,"Rico, Oskar und der Diebstahlstein",531452,0,531452,2016.csv,2016,0.0,1.0
11125,Campamento Flipy,531355,0,531355,2010.csv,2010,0.0,1.0
11126,Lumière!,530949,0,530949,2017.csv,2017,0.0,1.0
11127,The Island of Secrets,530945,0,530945,2014.csv,2014,0.0,1.0
11128,The Bouncer,530496,0,530496,2018.csv,2018,0.0,1.0
11129,Inferno,530398,0,530398,2010.csv,2010,0.0,1.0
11130,Tokyo Island,530319,0,530319,2010.csv,2010,0.0,1.0
11131,Wildlings,530069,0,530069,2019.csv,2019,0.0,1.0
11132,Where Once We Walked,529773,0,529773,2011.csv,2011,0.0,1.0
11133,Metropolis 2010 Re-release,529603,529603,0,2010.csv,2010,1.0,0.0
11134,A Place on Earth,529579,0,529579,2013.csv,2013,0.0,1.0
11135,Margaret Atwood: Live in Cinemas,529285,93690,435595,2019.csv,2019,0.177012384632098,0.822987615367902
11136,Les Mythos,529130,0,529130,2011.csv,2011,0.0,1.0
11137,Doll,529112,0,529112,2013.csv,2013,0.0,1.0
11138,Al filo de la ley,528850,0,528850,2015.csv,2015,0.0,1.0
11139,"João, o Maestro",528837,0,528837,2017.csv,2017,0.0,1.0
11140,Fatima,528785,0,528785,2020.csv,2020,0.0,1.0
11141,The Reef 2011 Re-release,528334,0,528334,2011.csv,2011,0.0,1.0
11142,Love Struck,528002,0,528002,2014.csv,2014,0.0,1.0
11143,Tu mi nascondi qualcosa,527951,0,527951,2018.csv,2018,0.0,1.0
11144,White House,527913,0,527913,2010.csv,2010,0.0,1.0
11145,Monster Zone,527803,0,527803,2020.csv,2020,0.0,1.0
11146,Frida. Viva la Vida,527262,0,527262,2019.csv,2019,0.0,1.0
11147,Willy Wonka & the Chocolate Factory 2016 Re-release,526954,526633,321,2016.csv,2016,0.9993908386690299,0.0006091613309700657
11148,Ümmü Sibyan: Zifir,526724,0,526724,2014.csv,2014,0.0,1.0
11149,"If Not Us, Who?",526344,0,526344,2011.csv,2011,0.0,1.0
11150,Code Geass: Lelouch of the Rebellion II - Transgression,526114,0,526114,2018.csv,2018,0.0,1.0
11151,Three Summers,526047,0,526047,2017.csv,2017,0.0,1.0
11152,Only Yesterday 2016 Re-release,525958,453243,72715,2016.csv,2016,0.8617475159613506,0.13825248403864948
11153,Oflu Hoca'nin Sifresi 3,525847,0,525847,2018.csv,2018,0.0,1.0
11154,Pasmerkti. Pajurio dziazas,525732,0,525732,2019.csv,2019,0.0,1.0
11155,Napoletans,525196,0,525196,2011.csv,2011,0.0,1.0
11156,Mayday 3DNA,525055,0,525055,2011.csv,2011,0.0,1.0
11157,Long Weekend,524954,524954,0,2021.csv,2021,1.0,0.0
11158,Yu-Gi-Oh! Bonds Beyond Time 2011 Re-release,524867,0,524867,2011.csv,2011,0.0,1.0
11159,My Best Enemy,524855,0,524855,2011.csv,2011,0.0,1.0
11160,Hello Again 2020 Re-release,524810,0,524810,2020.csv,2020,0.0,1.0
11161,Water Lilies of Monet - The Magic of Water and Light,524188,0,524188,2018.csv,2018,0.0,1.0
11162,Die Thomaner,524132,0,524132,2012.csv,2012,0.0,1.0
11163,Kaithi,524061,0,524061,2019.csv,2019,0.0,1.0
11164,Three Summer Nights,523620,0,523620,2015.csv,2015,0.0,1.0
11165,The Audience 2019 Re-release,523432,106529,416903,2019.csv,2019,0.20352022803344083,0.7964797719665592
11166,The Death Note,523354,0,523354,2016.csv,2016,0.0,1.0
11167,Das Blaue vom Himmel,523277,0,523277,2011.csv,2011,0.0,1.0
11168,Breath of Life,523262,0,523262,2019.csv,2019,0.0,1.0
11169,Sul mare,523238,0,523238,2010.csv,2010,0.0,1.0
11170,Momento Mori,522976,0,522976,2016.csv,2016,0.0,1.0
11171,The Cardboard Village,522376,0,522376,2011.csv,2011,0.0,1.0
11172,August,522191,0,522191,2011.csv,2011,0.0,1.0
11173,Bolshoi Ballet: Carmen Suite/Petrushka,522179,207523,314656,2019.csv,2019,0.39741736071347183,0.6025826392865282
11174,Pim & Pom: Het Grote Avontuur,521973,0,521973,2014.csv,2014,0.0,1.0
11175,Flowers and Songs,521939,0,521939,2019.csv,2019,0.0,1.0
11176,Doraemon: Nobita and the Birth of Japan,521938,0,521938,2017.csv,2017,0.0,1.0
11177,Byc jak Kazimierz Deyna,521217,0,521217,2013.csv,2013,0.0,1.0
11178,Sound City,521181,422853,98328,2013.csv,2013,0.8113361768752123,0.18866382312478774
11179,Son of Cain,521145,0,521145,2013.csv,2013,0.0,1.0
11180,Khun Thong Dang The Inspirations,520921,0,520921,2015.csv,2015,0.0,1.0
11181,Cinderella 3D,520859,0,520859,2012.csv,2012,0.0,1.0
11182,Punished,520617,0,520617,2011.csv,2011,0.0,1.0
11183,The Wrath,520577,0,520577,2018.csv,2018,0.0,1.0
11184,Pasolini,520435,0,520435,2014.csv,2014,0.0,1.0
11185,Go Karts,520191,0,520191,2020.csv,2020,0.0,1.0
11186,Brabançonne,519947,0,519947,2014.csv,2014,0.0,1.0
11187,Haunted Changi,519733,0,519733,2010.csv,2010,0.0,1.0
11188,The Spy Behind Home Plate,519525,519525,0,2019.csv,2019,1.0,0.0
11189,Wild Nights with Emily,519487,519487,0,2019.csv,2019,1.0,0.0
11190,Hak na'Sarakham,519474,0,519474,2011.csv,2011,0.0,1.0
11191,Prebz og Dennis: The Movie,519059,0,519059,2017.csv,2017,0.0,1.0
11192,Destinies,519018,0,519018,2019.csv,2019,0.0,1.0
11193,Miss Julie,518437,0,518437,2014.csv,2014,0.0,1.0
11194,You Beautify My Life,518385,0,518385,2018.csv,2018,0.0,1.0
11195,Scatter My Ashes at Bergdorf's,518342,518342,0,2013.csv,2013,1.0,0.0
11196,Jonas,518018,0,518018,2012.csv,2012,0.0,1.0
11197,Doomsday Book,517717,0,517717,2012.csv,2012,0.0,1.0
11198,Solo para dos,517625,0,517625,2013.csv,2013,0.0,1.0
11199,Vrou soek boer,517586,0,517586,2014.csv,2014,0.0,1.0
11200,Vánocní Kamenák,517523,0,517523,2015.csv,2015,0.0,1.0
11201,Demain est à nous,517522,0,517522,2019.csv,2019,0.0,1.0
11202,Vishwaroopam 2,517375,0,517375,2018.csv,2018,0.0,1.0
11203,Trespass Against Us,517197,5711,511486,2017.csv,2017,0.011042214088635472,0.9889577859113645
11204,The Kick,517069,0,517069,2011.csv,2011,0.0,1.0
11205,Grave of the Fireflies,516962,516962,0,2018.csv,2018,1.0,0.0
11206,Space Battleship Yamato 2202 Chapter 4,516840,0,516840,2018.csv,2018,0.0,1.0
11207,The Devil's Doorway,516660,0,516660,2019.csv,2019,0.0,1.0
11208,That Sounds Good,516604,0,516604,2010.csv,2010,0.0,1.0
11209,De president,516423,0,516423,2011.csv,2011,0.0,1.0
11210,Listen to Me Marlon,516337,425831,90506,2015.csv,2015,0.824715253797423,0.175284746202577
11211,Walking the Camino: Six Ways to Santiago 2015 Re-release,516161,0,516161,2015.csv,2015,0.0,1.0
11212,The Sandlot 2018 Re-release,516130,516130,0,2018.csv,2018,1.0,0.0
11213,The Hidden Child,515997,0,515997,2013.csv,2013,0.0,1.0
11214,Miss Marx,515838,0,515838,2020.csv,2020,0.0,1.0
11215,"Love, Wedding, Marriage",515823,1926,513897,2011.csv,2011,0.003733838933122408,0.9962661610668776
11216,Trade Your Love,515784,0,515784,2019.csv,2019,0.0,1.0
11217,Wild Life,515669,0,515669,2014.csv,2014,0.0,1.0
11218,Dark Spell,515596,0,515596,2021.csv,2021,0.0,1.0
11219,Argo 2,515522,0,515522,2015.csv,2015,0.0,1.0
11220,The Big Ugly,515399,514107,1292,2020.csv,2020,0.9974932042941488,0.002506795705851195
11221,Babam,515309,0,515309,2017.csv,2017,0.0,1.0
11222,Preacher's Kid,515065,515065,0,2010.csv,2010,1.0,0.0
11223,Podaa Podi,515031,0,515031,2012.csv,2012,0.0,1.0
11224,A Hard Day's Night 2014 Re-release,515005,515005,0,2014.csv,2014,1.0,0.0
11225,Goodbye First Love,514913,95000,419913,2011.csv,2011,0.18449718690341863,0.8155028130965813
11226,Xiang Xiao Qiang Yi Yang Huo Zhe,514780,0,514780,2011.csv,2011,0.0,1.0
11227,Dvojníci,514331,0,514331,2016.csv,2016,0.0,1.0
11228,Big Bang Made the Movie,514154,0,514154,2016.csv,2016,0.0,1.0
11229,The Journey of Allen Strange: Battle,514112,0,514112,2016.csv,2016,0.0,1.0
11230,Racing Hearts,513839,0,513839,2014.csv,2014,0.0,1.0
11231,Banksters,513740,0,513740,2020.csv,2020,0.0,1.0
11232,Cats Don't Have Vertigo,513720,0,513720,2014.csv,2014,0.0,1.0
11233,Segrt Hlapic,513623,0,513623,2013.csv,2013,0.0,1.0
11234,Cinco metros cuadrados,513455,0,513455,2011.csv,2011,0.0,1.0
11235,The Thief of Baghdad,512990,0,512990,2020.csv,2020,0.0,1.0
11236,Kaptan Pengu ve Arkadaslari,512960,0,512960,2020.csv,2020,0.0,1.0
11237,None Like Us,512693,0,512693,2018.csv,2018,0.0,1.0
11238,The Metropolitan Opera HD Live: Poulenc: Dialogues des Carmélites,512190,0,512190,2019.csv,2019,0.0,1.0
11239,Miniforce: Deeno the King of Dinosaurs,512169,0,512169,2020.csv,2020,0.0,1.0
11240,Love Pascal (2018),512000,0,512000,2018.csv,2018,0.0,1.0
11241,The Beach of the Drowned,511924,0,511924,2015.csv,2015,0.0,1.0
11242,"Karol, który zostal swietym",511364,0,511364,2014.csv,2014,0.0,1.0
11243,Bullitt 2018 Re-release,511350,511350,0,2018.csv,2018,1.0,0.0
11244,Black Butler: Book of the Atlantic,511132,248286,262846,2017.csv,2017,0.4857571038401039,0.514242896159896
11245,Dangerous Boys,511033,0,511033,2014.csv,2014,0.0,1.0
11246,Dangerous Cooking,511000,0,511000,2010.csv,2010,0.0,1.0
11247,Monsters and Men,510967,500101,10866,2018.csv,2018,0.9787344388189453,0.021265561181054746
11248,Unsullied,510957,510957,0,2016.csv,2016,1.0,0.0
11249,Delirium,510580,0,510580,2014.csv,2014,0.0,1.0
11250,Confucius 2011 Re-release,510253,0,510253,2011.csv,2011,0.0,1.0
11251,Bana Bir Soygun Yaz,510207,0,510207,2012.csv,2012,0.0,1.0
11252,Psychic,510106,0,510106,2015.csv,2015,0.0,1.0
11253,Closed Doors Village,510000,0,510000,2014.csv,2014,0.0,1.0
11254,Gekijouban Mahou sensei Negima! Anime Final,509926,0,509926,2011.csv,2011,0.0,1.0
11255,Bol,509872,188850,321022,2011.csv,2011,0.3703870775410299,0.62961292245897
11256,Spievankovo a kralovna Harmonia,509315,0,509315,2017.csv,2017,0.0,1.0
11257,Zenne Dancer,509253,0,509253,2012.csv,2012,0.0,1.0
11258,Ispansi!,509173,0,509173,2011.csv,2011,0.0,1.0
11259,Shakuhachi: One Sound One Life,508836,0,508836,2019.csv,2019,0.0,1.0
11260,"10,000 Miles",508820,0,508820,2017.csv,2017,0.0,1.0
11261,Love Battle,508781,0,508781,2019.csv,2019,0.0,1.0
11262,Saving Private Ryan 2019 Re-release,508694,508694,0,2019.csv,2019,1.0,0.0
11263,Patlak Sokaklar: Gerzomat,508656,0,508656,2012.csv,2012,0.0,1.0
11264,Brother,508647,0,508647,2016.csv,2016,0.0,1.0
11265,Nos Vamos Pal Mundial,508630,0,508630,2014.csv,2014,0.0,1.0
11266,Space Battleship Yamato 2202: Chapter of Departure,508619,0,508619,2017.csv,2017,0.0,1.0
11267,23-F: la película,508305,0,508305,2011.csv,2011,0.0,1.0
11268,Una,508169,22815,485354,2017.csv,2017,0.04489648128870514,0.9551035187112948
11269,Gimme the Power,508139,0,508139,2012.csv,2012,0.0,1.0
11270,The Nutcrackers,508079,0,508079,2010.csv,2010,0.0,1.0
11271,Midnight Whisper,508033,0,508033,2015.csv,2015,0.0,1.0
11272,Hands Up,508012,0,508012,2010.csv,2010,0.0,1.0
11273,Kite,507180,0,507180,2014.csv,2014,0.0,1.0
11274,Jaws 2012 Re-release,507140,0,507140,2012.csv,2012,0.0,1.0
11275,Eiga Hanakappa: Hanasake! Pakkân Chou no kuni no daibouken,507114,0,507114,2013.csv,2013,0.0,1.0
11276,Zhila-byla odna baba,507099,0,507099,2011.csv,2011,0.0,1.0
11277,The Dirty Dutch,506588,0,506588,2016.csv,2016,0.0,1.0
11278,Boonchu Jayunaijaisamer,506484,0,506484,2010.csv,2010,0.0,1.0
11279,The Inevitable Defeat of Mister & Pete,506303,494608,11695,2013.csv,2013,0.9769011836785482,0.02309881632145178
11280,Satisfaktsiya,506205,0,506205,2011.csv,2011,0.0,1.0
11281,Instant Hit of the Elephant Lin Wang,506150,0,506150,2017.csv,2017,0.0,1.0
11282,Ultraman Ginga S: Showdown! Ultra 10 Warriors!! 2020 Re-release,506125,0,506125,2015.csv,2015,0.0,1.0
11283,Our Last Tango,505885,100086,405799,2015.csv,2015,0.19784338337764512,0.8021566166223549
11284,Spin Out,505822,0,505822,2016.csv,2016,0.0,1.0
11285,Gabriel and the Mountain,505769,18415,487354,2017.csv,2017,0.03640990254444223,0.9635900974555578
11286,Tea Pets 2018 Re-release,505364,0,505364,2018.csv,2018,0.0,1.0
11287,Huang cun xiong jian,505203,0,505203,2016.csv,2016,0.0,1.0
11288,Wildling,504718,0,504718,2018.csv,2018,0.0,1.0
11289,Carcereiros: O Filme,504155,0,504155,2019.csv,2019,0.0,1.0
11290,Djam,504078,0,504078,2017.csv,2017,0.0,1.0
11291,Have a Nice Day,504003,79393,424610,2018.csv,2018,0.15752485600284125,0.8424751439971587
11292,Ardaas,504002,0,504002,2016.csv,2016,0.0,1.0
11293,The Peppercorns and the Curse of the Black King,503932,0,503932,2017.csv,2017,0.0,1.0
11294,Masterpiece,503784,0,503784,2018.csv,2018,0.0,1.0
11295,Grean Fictions,503587,0,503587,2013.csv,2013,0.0,1.0
11296,Global Player - Wo wir sind isch vorne,503279,0,503279,2013.csv,2013,0.0,1.0
11297,"Hello, Stranger 2010 Re-release",503238,0,503238,2010.csv,2010,0.0,1.0
11298,The Nun,503090,0,503090,2013.csv,2013,0.0,1.0
11299,Letters from Baghdad,502941,359735,143206,2017.csv,2017,0.7152628240688271,0.2847371759311728
11300,Loc Phat,502785,0,502785,2016.csv,2016,0.0,1.0
11301,One Kiss,502615,0,502615,2016.csv,2016,0.0,1.0
11302,La source,502610,0,502610,2019.csv,2019,0.0,1.0
11303,Chuck,502518,320725,181793,2017.csv,2017,0.6382358442881648,0.3617641557118352
11304,Queen,502391,0,502391,2014.csv,2014,0.0,1.0
11305,Deli Man,502294,502294,0,2015.csv,2015,1.0,0.0
11306,The Forgotten Carols,502252,502252,0,2020.csv,2020,1.0,0.0
11307,The King of Fighters,502153,0,502153,2010.csv,2010,0.0,1.0
11308,Futtkastu Ozaki Yutaka Yokohama Arena,501744,0,501744,2012.csv,2012,0.0,1.0
11309,Stroomop,501597,0,501597,2018.csv,2018,0.0,1.0
11310,Neethaane En Ponvasantham,501432,0,501432,2012.csv,2012,0.0,1.0
11311,A Clever Crook,501368,0,501368,2019.csv,2019,0.0,1.0
11312,Bride Flight 2011 Re-release,501360,501360,0,2011.csv,2011,1.0,0.0
11313,Synonyms,501223,206003,295220,2019.csv,2019,0.411000692306618,0.5889993076933819
11314,Pee Nak,500963,0,500963,2019.csv,2019,0.0,1.0
11315,The Waiting City,500641,0,500641,2010.csv,2010,0.0,1.0
11316,Demon Inside,500548,0,500548,2014.csv,2014,0.0,1.0
11317,Homecoming,500429,0,500429,2015.csv,2015,0.0,1.0
11318,Spell,500104,500104,0,2020.csv,2020,1.0,0.0
11319,A Tale from the Orient,500000,0,500000,2015.csv,2015,0.0,1.0
11320,Midnight Microblog,500000,0,500000,2013.csv,2013,0.0,1.0
11321,Verrückt nach Fixi,499877,0,499877,2016.csv,2016,0.0,1.0
11322,Silent Heart,499796,0,499796,2014.csv,2014,0.0,1.0
11323,Smashed,499725,376597,123128,2012.csv,2012,0.7536084846665666,0.2463915153334334
11324,Azem: Cin Karasi,499674,0,499674,2014.csv,2014,0.0,1.0
11325,An American Pickle,499649,0,499649,2020.csv,2020,0.0,1.0
11326,Asana Travelogue,499623,0,499623,2012.csv,2012,0.0,1.0
11327,Steam of Life,499527,0,499527,2010.csv,2010,0.0,1.0
11328,Kings for a Day,498915,0,498915,2018.csv,2018,0.0,1.0
11329,Istanbul Muhafizlari: Ab-i Hayat Çesmesi,498847,0,498847,2018.csv,2018,0.0,1.0
11330,Hamari Adhuri Kahani,498774,235361,263413,2015.csv,2015,0.4718790474242843,0.5281209525757157
11331,Whisper of the Heart 2019 Re-release,498156,498156,0,2019.csv,2019,1.0,0.0
11332,Our Lovers,498011,0,498011,2016.csv,2016,0.0,1.0
11333,Ava,497676,0,497676,2017.csv,2017,0.0,1.0
11334,Two Crowns,497549,0,497549,2017.csv,2017,0.0,1.0
11335,This Town,497248,0,497248,2020.csv,2020,0.0,1.0
11336,Yangin var,497243,0,497243,2011.csv,2011,0.0,1.0
11337,500 manbul,496998,0,496998,2012.csv,2012,0.0,1.0
11338,Kahlil Gibran's The Prophet 2015 Re-release,496914,370146,126768,2015.csv,2015,0.7448894577331289,0.25511054226687113
11339,Scorpion in Love,496762,0,496762,2013.csv,2013,0.0,1.0
11340,Felix and Meira,496714,447353,49361,2015.csv,2015,0.9006249068880684,0.09937509311193161
11341,23 Walks,496672,0,496672,2020.csv,2020,0.0,1.0
11342,Chasing the Wind,496659,0,496659,2013.csv,2013,0.0,1.0
11343,Chico: Artista Brasileiro,496526,0,496526,2015.csv,2015,0.0,1.0
11344,Unda,496417,0,496417,2019.csv,2019,0.0,1.0
11345,Monty Python's Life of Brian 2019 Re-release,496256,161507,334749,2019.csv,2019,0.3254509769151406,0.6745490230848594
11346,Hell 2011 Re-release,495905,0,495905,2011.csv,2011,0.0,1.0
11347,April and the Extraordinary World,495879,295488,200391,2015.csv,2015,0.5958873031525836,0.4041126968474164
11348,Nausicaä of the Valley of the Wind 2019 Re-release,495770,495770,0,2019.csv,2019,1.0,0.0
11349,Not Suitable for Children,495760,0,495760,2012.csv,2012,0.0,1.0
11350,Golden Doll,495742,0,495742,2016.csv,2016,0.0,1.0
11351,Kokoko,495379,0,495379,2012.csv,2012,0.0,1.0
11352,Driving Licence,495146,0,495146,2019.csv,2019,0.0,1.0
11353,Eden,494949,65460,429489,2014.csv,2014,0.13225605062339757,0.8677439493766025
11354,A Son,494542,0,494542,2020.csv,2020,0.0,1.0
11355,Steve Jobs: The Man in the Machine,494506,494506,0,2015.csv,2015,1.0,0.0
11356,Horseplay 2014 Re-release,494157,0,494157,2014.csv,2014,0.0,1.0
11357,Marcelino Pan y Vino,494122,0,494122,2010.csv,2010,0.0,1.0
11358,Beautiful Tomorrow,494073,0,494073,2017.csv,2017,0.0,1.0
11359,"Lots of Kids, a Monkey and a Castle",493873,0,493873,2017.csv,2017,0.0,1.0
11360,The Polar Express 2013 IMAX Release,493776,493776,0,2013.csv,2013,1.0,0.0
11361,Grazinti Nepriklausomybe,493695,0,493695,2018.csv,2018,0.0,1.0
11362,Mamarazzi,493470,0,493470,2010.csv,2010,0.0,1.0
11363,You Only Live Once,493374,0,493374,2017.csv,2017,0.0,1.0
11364,Vivere,493072,0,493072,2019.csv,2019,0.0,1.0
11365,Funeral Wake,493000,0,493000,2019.csv,2019,0.0,1.0
11366,Gnade,492828,0,492828,2012.csv,2012,0.0,1.0
11367,Taste the Waste,492700,0,492700,2011.csv,2011,0.0,1.0
11368,"Traukinio apiplesimas, kuri ivykde Saulius ir Paulius",492566,0,492566,2015.csv,2015,0.0,1.0
11369,The Coming Days,492376,0,492376,2010.csv,2010,0.0,1.0
11370,Two Night Stand,492332,18612,473720,2014.csv,2014,0.03780375843942705,0.9621962415605729
11371,The History of Love,492272,0,492272,2016.csv,2016,0.0,1.0
11372,Bin Roye,492270,0,492270,2015.csv,2015,0.0,1.0
11373,The Lord of the Rings: The Fellowship of the Ring 2020 Re-release,492266,166000,326266,2020.csv,2020,0.3372160579849106,0.6627839420150894
11374,On Fallen Wings,492189,0,492189,2017.csv,2017,0.0,1.0
11375,L'imbroglio nel lenzuolo,492068,0,492068,2010.csv,2010,0.0,1.0
11376,The Queen of Spades,491952,0,491952,2016.csv,2016,0.0,1.0
11377,France,491710,0,491710,2016.csv,2016,0.0,1.0
11378,You're Still the One,491693,0,491693,2015.csv,2015,0.0,1.0
11379,Archipelago,491598,0,491598,2011.csv,2011,0.0,1.0
11380,Soul on a String,491294,3669,487625,2017.csv,2017,0.007468033397517576,0.9925319666024824
11381,A Promise,491204,0,491204,2014.csv,2014,0.0,1.0
11382,Lucky DI Unlucky Story,491163,0,491163,2013.csv,2013,0.0,1.0
11383,Wolves,491154,12139,479015,2014.csv,2014,0.024715262422783893,0.9752847375772161
11384,Trance,490855,0,490855,2020.csv,2020,0.0,1.0
11385,Backtrace,490636,0,490636,2019.csv,2019,0.0,1.0
11386,Noi 4,490471,0,490471,2014.csv,2014,0.0,1.0
11387,Road to Berlin,490337,0,490337,2015.csv,2015,0.0,1.0
11388,Essential Killing,490320,0,490320,2010.csv,2010,0.0,1.0
11389,Fat Pizza vs. Housos,490242,0,490242,2014.csv,2014,0.0,1.0
11390,How to Shake Off a Bride,490138,0,490138,2016.csv,2016,0.0,1.0
11391,Pirdino Sürpriz Yumurta,490094,0,490094,2015.csv,2015,0.0,1.0
11392,When Sun Meets Moon,490060,0,490060,2018.csv,2018,0.0,1.0
11393,Back to the Sea,490000,0,490000,2012.csv,2012,0.0,1.0
11394,Bu Bu Zhui Hun,490000,0,490000,2013.csv,2013,0.0,1.0
11395,Death Trip,490000,0,490000,2015.csv,2015,0.0,1.0
11396,Colette,489941,0,489941,2013.csv,2013,0.0,1.0
11397,Another Me,489884,0,489884,2014.csv,2014,0.0,1.0
11398,Let's Eat!,489846,0,489846,2016.csv,2016,0.0,1.0
11399,Hermitage. The Power of Art,489815,0,489815,2019.csv,2019,0.0,1.0
11400,Open Grave,489812,0,489812,2013.csv,2013,0.0,1.0
11401,Zama,489692,200600,289092,2017.csv,2017,0.40964524639977784,0.5903547536002222
11402,Supervention 2,489573,0,489573,2016.csv,2016,0.0,1.0
11403,Animals,489198,0,489198,2019.csv,2019,0.0,1.0
11404,L'amour fou,489126,312494,176632,2010.csv,2010,0.638882414756116,0.361117585243884
11405,The Macaluso Sisters,488984,0,488984,2020.csv,2020,0.0,1.0
11406,The Greatest Gift,488925,0,488925,2018.csv,2018,0.0,1.0
11407,The Spirit of '45,488854,0,488854,2013.csv,2013,0.0,1.0
11408,Vicious,488593,0,488593,2019.csv,2019,0.0,1.0
11409,What Richard Did,488327,2749,485578,2012.csv,2012,0.0056294245454377905,0.9943705754545622
11410,The August Virgin,488299,0,488299,2019.csv,2019,0.0,1.0
11411,2001: A Space Odyssey 2020 Re-release,488272,0,488272,2020.csv,2020,0.0,1.0
11412,Romantic Heaven,488024,0,488024,2011.csv,2011,0.0,1.0
11413,At Any Price,487455,380594,106861,2013.csv,2013,0.7807777128145162,0.21922228718548378
11414,London Fields,487420,252676,234744,2018.csv,2018,0.5183948135078577,0.4816051864921423
11415,School's Out,487374,0,487374,2019.csv,2019,0.0,1.0
11416,Prodavets igrushek,486846,0,486846,2013.csv,2013,0.0,1.0
11417,Miss Gangster,486842,0,486842,2019.csv,2019,0.0,1.0
11418,Beach Rats,486623,473771,12852,2017.csv,2017,0.973589411104695,0.02641058889530499
11419,Ricordi?,486046,0,486046,2019.csv,2019,0.0,1.0
11420,Entre Idas e Vindas,485619,0,485619,2016.csv,2016,0.0,1.0
11421,Cooties,485544,60058,425486,2015.csv,2015,0.12369218855551711,0.8763078114444829
11422,Arthur et la magie de No'l,485327,0,485327,2018.csv,2018,0.0,1.0
11423,My Little Pony: Equestria Girls,485232,0,485232,2013.csv,2013,0.0,1.0
11424,A Christmas Gift from Bob,485169,0,485169,2020.csv,2020,0.0,1.0
11425,The Russian Five,485049,485049,0,2019.csv,2019,1.0,0.0
11426,Macho Peruano Que Se Respeta,484996,0,484996,2015.csv,2015,0.0,1.0
11427,Crosscurrent,484727,0,484727,2016.csv,2016,0.0,1.0
11428,Little Anna and the Tall Uncle,484423,0,484423,2012.csv,2012,0.0,1.0
11429,Perro Guardián,484271,0,484271,2014.csv,2014,0.0,1.0
11430,Kedi Özledi,483933,0,483933,2013.csv,2013,0.0,1.0
11431,Awasarn Lok Suay,483925,0,483925,2016.csv,2016,0.0,1.0
11432,The Good Plumber,483687,0,483687,2016.csv,2016,0.0,1.0
11433,63 Up,483684,483684,0,2019.csv,2019,1.0,0.0
11434,Endless Night,483588,0,483588,2015.csv,2015,0.0,1.0
11435,Our Little Sister 2016 Re-release,483559,467555,16004,2016.csv,2016,0.9669037283971552,0.03309627160284474
11436,Little Grey Fergie Full Throttle!,483445,0,483445,2016.csv,2016,0.0,1.0
11437,Dirt Music,483445,0,483445,2020.csv,2020,0.0,1.0
11438,The Great Escape of 3S Ladies,483331,0,483331,2018.csv,2018,0.0,1.0
11439,Snu,483240,0,483240,2019.csv,2019,0.0,1.0
11440,Redbad,482806,0,482806,2018.csv,2018,0.0,1.0
11441,Heist 2017 Re-release,482729,0,482729,2017.csv,2017,0.0,1.0
11442,Loveholic,482540,0,482540,2010.csv,2010,0.0,1.0
11443,Lawrence of Arabia 2019 Re-release,482281,482281,0,2019.csv,2019,1.0,0.0
11444,The Journey,482209,155475,326734,2017.csv,2017,0.32242243508520163,0.6775775649147984
11445,Drifters,482142,0,482142,2015.csv,2015,0.0,1.0
11446,"Te quiero, imbécil",482113,0,482113,2020.csv,2020,0.0,1.0
11447,Manzel na hodinu,482099,0,482099,2016.csv,2016,0.0,1.0
11448,Y nos fuimos pal mundial,481836,0,481836,2018.csv,2018,0.0,1.0
11449,The Mother,481834,0,481834,2019.csv,2019,0.0,1.0
11450,I Origins,481234,336472,144762,2014.csv,2014,0.6991858430617953,0.3008141569382047
11451,Breathe In,481079,89661,391418,2013.csv,2013,0.1863747949920907,0.8136252050079094
11452,Evangelion: 2.0 You Can (Not) Advance/Evangelion: 1.0 You Are (Not) Alone/Evangelion: 3.0 You Can (Not) Redo,480953,0,480953,2017.csv,2017,0.0,1.0
11453,Father of My Children,480834,144022,336812,2010.csv,2010,0.29952540793704274,0.7004745920629573
11454,Pat & Mat,480418,0,480418,2016.csv,2016,0.0,1.0
11455,An Odd Evening in April,480334,0,480334,2014.csv,2014,0.0,1.0
11456,Dr. Huang Danian,480201,0,480201,2018.csv,2018,0.0,1.0
11457,Broken Road,480188,0,480188,2017.csv,2017,0.0,1.0
11458,Souvenir the Movie - Mariya Takeuchi Theater Live,480066,0,480066,2018.csv,2018,0.0,1.0
11459,Zai Jian Wo Men De Shi Nian,480000,0,480000,2015.csv,2015,0.0,1.0
11460,Bekas,479226,0,479226,2012.csv,2012,0.0,1.0
11461,Japy Ending,479081,0,479081,2014.csv,2014,0.0,1.0
11462,I Am Heath Ledger,479054,0,479054,2017.csv,2017,0.0,1.0
11463,Intimate Enemy,478957,0,478957,2018.csv,2018,0.0,1.0
11464,The Third Man 2015 Re-release,478945,449191,29754,2015.csv,2015,0.9378759565294553,0.062124043470544635
11465,Ghost on Air,478792,0,478792,2012.csv,2012,0.0,1.0
11466,The Seven Ravens,478725,0,478725,2015.csv,2015,0.0,1.0
11467,Second Chance 2012 Re-release,478712,0,478712,2012.csv,2012,0.0,1.0
11468,Amazon Tears: Through Her Eyes,478654,0,478654,2010.csv,2010,0.0,1.0
11469,Brotherly Love,478595,478595,0,2015.csv,2015,1.0,0.0
11470,Loue-moi!,478454,0,478454,2017.csv,2017,0.0,1.0
11471,Love Birds,478315,0,478315,2011.csv,2011,0.0,1.0
11472,Ariane's Thread,478252,0,478252,2014.csv,2014,0.0,1.0
11473,Louise by the Shore,478003,0,478003,2016.csv,2016,0.0,1.0
11474,Mobile Suit Gundam: The Origin III - Dawn of Rebellion,477689,0,477689,2016.csv,2016,0.0,1.0
11475,Howl,477656,0,477656,2015.csv,2015,0.0,1.0
11476,The Music According to Antonio Carlos Jobim,477146,0,477146,2012.csv,2012,0.0,1.0
11477,Liam Gallagher: As It Was,477009,0,477009,2019.csv,2019,0.0,1.0
11478,Ahtta Mama,476634,0,476634,2011.csv,2011,0.0,1.0
11479,G.E.M.: G-Force,476613,0,476613,2017.csv,2017,0.0,1.0
11480,Small Ru Gu Naew,476610,0,476610,2011.csv,2011,0.0,1.0
11481,Gahim Fel Hend,476534,0,476534,2016.csv,2016,0.0,1.0
11482,Heart of a Dog,476384,420813,55571,2015.csv,2015,0.8833483072479345,0.11665169275206556
11483,15 Minutes of War,476231,0,476231,2019.csv,2019,0.0,1.0
11484,Locust,476015,0,476015,2015.csv,2015,0.0,1.0
11485,Pepee: Birlik zamani,475966,0,475966,2017.csv,2017,0.0,1.0
11486,"2 Francs, 40 Pesetas",475796,0,475796,2014.csv,2014,0.0,1.0
11487,About That Life,475770,0,475770,2019.csv,2019,0.0,1.0
11488,Geuk-jang-pan Ban-ji-eui Bi-mil-il-gi,475610,0,475610,2019.csv,2019,0.0,1.0
11489,The Babymakers,475511,7889,467622,2012.csv,2012,0.016590573088740325,0.9834094269112597
11490,Gorillaz: Reject False Icons,475465,453687,21778,2019.csv,2019,0.9541964182431935,0.045803581756806495
11491,Midnight Ghost,475322,0,475322,2018.csv,2018,0.0,1.0
11492,Rak Sud Teen,475290,0,475290,2012.csv,2012,0.0,1.0
11493,Kiss Me You Fucking Moron,475180,0,475180,2013.csv,2013,0.0,1.0
11494,Cool Gel Attacks,474990,0,474990,2010.csv,2010,0.0,1.0
11495,The Dark Side of the Moon,474926,0,474926,2016.csv,2016,0.0,1.0
11496,Mooirivier,474700,0,474700,2015.csv,2015,0.0,1.0
11497,The Awakening Calling from Love,474656,0,474656,2019.csv,2019,0.0,1.0
11498,Speech,474603,0,474603,2018.csv,2018,0.0,1.0
11499,Melagiai/Liars,474562,0,474562,2018.csv,2018,0.0,1.0
11500,Bangkok Assassins,474390,0,474390,2011.csv,2011,0.0,1.0
11501,Muklawa,474162,0,474162,2019.csv,2019,0.0,1.0
11502,See piu fung wan,474127,0,474127,2010.csv,2010,0.0,1.0
11503,The Shawshank Redemption 2019 Re-release,473776,358507,115269,2019.csv,2019,0.7567014791800345,0.24329852081996556
11504,Petition,473564,0,473564,2011.csv,2011,0.0,1.0
11505,Magic Arch 3D,473377,0,473377,2020.csv,2020,0.0,1.0
11506,Ultraman Orb: Lend Me the Power of Bonds!,473282,0,473282,2017.csv,2017,0.0,1.0
11507,The Day of the Crows,473104,0,473104,2012.csv,2012,0.0,1.0
11508,Traceless,473029,0,473029,2010.csv,2010,0.0,1.0
11509,On the Job,472890,164620,308270,2013.csv,2013,0.34811478356488823,0.6518852164351118
11510,Vada Chennai,472865,0,472865,2018.csv,2018,0.0,1.0
11511,Huroob Ezterari,472708,0,472708,2017.csv,2017,0.0,1.0
11512,Pearl Jam Twenty,471334,471334,0,2011.csv,2011,1.0,0.0
11513,Firincinin Karisi,471182,0,471182,2019.csv,2019,0.0,1.0
11514,You & Me Forever,471159,0,471159,2012.csv,2012,0.0,1.0
11515,Complot,471092,0,471092,2014.csv,2014,0.0,1.0
11516,Uma Loucura de Mulher,470903,0,470903,2016.csv,2016,0.0,1.0
11517,Darbareye Elly 2015 Re-release,470760,470760,0,2015.csv,2015,1.0,0.0
11518,The Soul Conductor,470617,0,470617,2018.csv,2018,0.0,1.0
11519,Going to Brazil,470508,0,470508,2017.csv,2017,0.0,1.0
11520,On the Edge,470476,0,470476,2014.csv,2014,0.0,1.0
11521,Tommy,470338,0,470338,2014.csv,2014,0.0,1.0
11522,Journal 64,470308,0,470308,2018.csv,2018,0.0,1.0
11523,Aus dem Nichts 2018 Re-release,469946,0,469946,2018.csv,2018,0.0,1.0
11524,Greedy Ghost,469823,0,469823,2012.csv,2012,0.0,1.0
11525,Genis Aile Komsu Kizi,469742,0,469742,2019.csv,2019,0.0,1.0
11526,White Bird in a Blizzard,469701,33821,435880,2014.csv,2014,0.07200538214736608,0.9279946178526339
11527,Matangi/Maya/M.I.A,469489,230808,238681,2018.csv,2018,0.49161535201037726,0.5083846479896228
11528,Vicky,469332,0,469332,2016.csv,2016,0.0,1.0
11529,Screaming Live,469140,0,469140,2018.csv,2018,0.0,1.0
11530,The Painter and the Thief,468983,0,468983,2020.csv,2020,0.0,1.0
11531,The Adventures of Pureza: Queen of the Riles,468883,0,468883,2011.csv,2011,0.0,1.0
11532,Requirements to Be a Normal Person,468761,0,468761,2015.csv,2015,0.0,1.0
11533,Paintedskin: The Double Mask,468683,0,468683,2018.csv,2018,0.0,1.0
11534,Week-ends,468454,0,468454,2014.csv,2014,0.0,1.0
11535,Reunion,468269,0,468269,2019.csv,2019,0.0,1.0
11536,El día de la unión,468002,0,468002,2018.csv,2018,0.0,1.0
11537,Don Mendo Rock ¿La venganza?,467984,0,467984,2010.csv,2010,0.0,1.0
11538,DCI 2017 Tour Premeire,467817,467817,0,2017.csv,2017,1.0,0.0
11539,Spyder,467720,0,467720,2017.csv,2017,0.0,1.0
11540,Detour,467670,0,467670,2016.csv,2016,0.0,1.0
11541,Days of Grace,467572,0,467572,2012.csv,2012,0.0,1.0
11542,Hail Satan?,467361,424284,43077,2019.csv,2019,0.9078292797216713,0.09217072027832875
11543,Fairy Tale Killer,467327,0,467327,2012.csv,2012,0.0,1.0
11544,Collision,467282,0,467282,2013.csv,2013,0.0,1.0
11545,The Killing Room,467220,0,467220,2010.csv,2010,0.0,1.0
11546,True History of the Kelly Gang,467198,33817,433381,2020.csv,2020,0.07238258725422626,0.9276174127457737
11547,Samir Abu el-Nil,467059,0,467059,2013.csv,2013,0.0,1.0
11548,Night of Knots,466791,0,466791,2018.csv,2018,0.0,1.0
11549,No Tell Motel,466535,0,466535,2013.csv,2013,0.0,1.0
11550,The Rain Fairy,466403,0,466403,2010.csv,2010,0.0,1.0
11551,Last Days in Vietnam,466114,466114,0,2014.csv,2014,1.0,0.0
11552,Pájaros volando,466069,0,466069,2010.csv,2010,0.0,1.0
11553,A Dose of Happiness,465907,0,465907,2019.csv,2019,0.0,1.0
11554,Gomorroide,465875,0,465875,2017.csv,2017,0.0,1.0
11555,Ghost Coins,465802,0,465802,2014.csv,2014,0.0,1.0
11556,Hustle,465788,0,465788,2015.csv,2015,0.0,1.0
11557,Dog Pound,465725,0,465725,2010.csv,2010,0.0,1.0
11558,Love Is the Last Word,465326,0,465326,2010.csv,2010,0.0,1.0
11559,The Mayor of Rione Sanità,465257,0,465257,2019.csv,2019,0.0,1.0
11560,Super vacanze di Natale,465211,0,465211,2017.csv,2017,0.0,1.0
11561,Kidnap - Bo's Most Exciting Holiday Ever,465184,0,465184,2015.csv,2015,0.0,1.0
11562,Neighboring Sounds,465082,60255,404827,2012.csv,2012,0.1295577984097428,0.8704422015902572
11563,Sen Sag Ben Selamet,464824,0,464824,2016.csv,2016,0.0,1.0
11564,I Love You Two,464505,0,464505,2016.csv,2016,0.0,1.0
11565,Puffs: Filmed Live Off Broadway,464483,464483,0,2018.csv,2018,1.0,0.0
11566,Plan de table 2013 Re-release,464357,0,464357,2013.csv,2013,0.0,1.0
11567,All About Love,463803,0,463803,2010.csv,2010,0.0,1.0
11568,Don Giovani,463711,0,463711,2019.csv,2019,0.0,1.0
11569,Pooh - L'Ultimo Concerto,463660,0,463660,2016.csv,2016,0.0,1.0
11570,Wizard,463380,0,463380,2019.csv,2019,0.0,1.0
11571,Honeymoon,463049,0,463049,2013.csv,2013,0.0,1.0
11572,Deepsea Challenge,462959,235659,227300,2014.csv,2014,0.5090277972779447,0.4909722027220553
11573,The Commitment,462886,0,462886,2019.csv,2019,0.0,1.0
11574,Before We Go,462875,37151,425724,2015.csv,2015,0.08026140966783689,0.9197385903321631
11575,Velipadinte Pusthakam,462711,0,462711,2017.csv,2017,0.0,1.0
11576,Death Proof 2010 Re-release,462460,0,462460,2010.csv,2010,0.0,1.0
11577,Ammar,462429,0,462429,2014.csv,2014,0.0,1.0
11578,Jesus is Dead,462345,0,462345,2017.csv,2017,0.0,1.0
11579,"O, ne! O, taip!",462293,0,462293,2016.csv,2016,0.0,1.0
11580,The Prince's Voyage,462183,0,462183,2019.csv,2019,0.0,1.0
11581,The Bag Man,461780,56574,405206,2014.csv,2014,0.12251288492355668,0.8774871150764433
11582,MFKZ,461724,229423,232301,2018.csv,2018,0.4968834195320148,0.5031165804679852
11583,Jäger des Augenblicks - Ein Abenteuer am Mount Roraima,461698,0,461698,2013.csv,2013,0.0,1.0
11584,Scotty and the Secret History of Hollywood,461689,461689,0,2018.csv,2018,1.0,0.0
11585,A Journey to the Seaside,461674,0,461674,2019.csv,2019,0.0,1.0
11586,Tribute to Heroes,461427,0,461427,2020.csv,2020,0.0,1.0
11587,Living Legends,461421,0,461421,2014.csv,2014,0.0,1.0
11588,Bully,461405,279202,182203,2012.csv,2012,0.6051126450732003,0.39488735492679966
11589,Wolwedans in die Skemer,461245,0,461245,2012.csv,2012,0.0,1.0
11590,Disorder,460997,51879,409118,2015.csv,2015,0.11253652409885531,0.8874634759011447
11591,Life Is Fruity,460508,0,460508,2018.csv,2018,0.0,1.0
11592,Inside Out 2020 Re-release,460176,460000,176,2020.csv,2020,0.9996175376377734,0.0003824623622266263
11593,Mihrez: Cin Padisahi,460165,0,460165,2015.csv,2015,0.0,1.0
11594,Fall of Ming,460000,0,460000,2013.csv,2013,0.0,1.0
11595,Malasartes e o Duelo com a Morte,459947,0,459947,2017.csv,2017,0.0,1.0
11596,The Invisibles 2019 Re-release,459848,0,459848,2019.csv,2019,0.0,1.0
11597,Manglehorn,459636,143101,316535,2015.csv,2015,0.3113354915628889,0.6886645084371111
11598,The Lady Improper,459289,0,459289,2019.csv,2019,0.0,1.0
11599,Kahaani,459234,0,459234,2012.csv,2012,0.0,1.0
11600,Ghost,459179,0,459179,2016.csv,2016,0.0,1.0
11601,Eric Clapton: A Life in 12 Bars,459088,0,459088,2017.csv,2017,0.0,1.0
11602,Exorcism: Haunted Child,458896,0,458896,2015.csv,2015,0.0,1.0
11603,"Hjelp, vi er russ",458344,0,458344,2011.csv,2011,0.0,1.0
11604,Saat Uchakkey,458010,0,458010,2016.csv,2016,0.0,1.0
11605,South Pacific 2018 Re-release,458000,458000,0,2018.csv,2018,1.0,0.0
11606,Transit 2018 Re-release,457987,0,457987,2018.csv,2018,0.0,1.0
11607,Time Freak,457690,0,457690,2018.csv,2018,0.0,1.0
11608,Tesla,457687,93147,364540,2020.csv,2020,0.20351681389246362,0.7964831861075363
11609,We Steal Secrets,457517,166243,291274,2013.csv,2013,0.3633591757246179,0.6366408242753822
11610,Twenty,457137,0,457137,2018.csv,2018,0.0,1.0
11611,Paradise: Hope,457132,6701,450431,2013.csv,2013,0.014658785646159096,0.9853412143538409
11612,Fight the Fight,457120,0,457120,2011.csv,2011,0.0,1.0
11613,Wonder Woman 2020 Re-release,456493,252000,204493,2020.csv,2020,0.5520347519020007,0.4479652480979993
11614,Sound of Noise,456366,24565,431801,2010.csv,2010,0.05382741045564306,0.9461725895443569
11615,Freelancers,456350,0,456350,2012.csv,2012,0.0,1.0
11616,Thunder Road,456304,0,456304,2018.csv,2018,0.0,1.0
11617,Staying Vertical,456271,12158,444113,2016.csv,2016,0.026646444766377876,0.9733535552336221
11618,A Spice for Life,456206,0,456206,2020.csv,2020,0.0,1.0
11619,Yamla Pagla Deewana 2,455841,0,455841,2013.csv,2013,0.0,1.0
11620,Lola Versus,455754,252603,203151,2012.csv,2012,0.5542529522505563,0.4457470477494438
11621,Love on the Rocks 2014 Re-release,455481,0,455481,2014.csv,2014,0.0,1.0
11622,Sherlock Holmes and the Great Escape,455220,0,455220,2019.csv,2019,0.0,1.0
11623,Bingo,455065,0,455065,2013.csv,2013,0.0,1.0
11624,"Come Rain, Come Shine",455038,0,455038,2011.csv,2011,0.0,1.0
11625,Koyver Gitsin,454638,0,454638,2018.csv,2018,0.0,1.0
11626,White Lies,454586,0,454586,2013.csv,2013,0.0,1.0
11627,Pohádky pro Emu,454580,0,454580,2016.csv,2016,0.0,1.0
11628,The Gospel According to André,454550,400713,53837,2018.csv,2018,0.881559784402156,0.11844021559784403
11629,Alamet-i Kiyamet: Tarikat,454374,0,454374,2016.csv,2016,0.0,1.0
11630,The Most Dangerous Man in America: Daniel Ellsberg and the Pentagon Papers,453993,453993,0,2010.csv,2010,1.0,0.0
11631,Good Vibrations,453974,0,453974,2013.csv,2013,0.0,1.0
11632,Lightning Man and the Mystery Island,453672,0,453672,2018.csv,2018,0.0,1.0
11633,Hamlet,453637,0,453637,2015.csv,2015,0.0,1.0
11634,Storm: Letters van Vuur,453511,0,453511,2017.csv,2017,0.0,1.0
11635,Løvekvinnen,453276,0,453276,2016.csv,2016,0.0,1.0
11636,Miss Farkku-Suomi,453178,0,453178,2012.csv,2012,0.0,1.0
11637,Kalathil Sandhippom,453001,0,453001,2021.csv,2021,0.0,1.0
11638,That Girl in Pinafore,452941,0,452941,2013.csv,2013,0.0,1.0
11639,Outing - Fidanzati per sbaglio,452636,0,452636,2013.csv,2013,0.0,1.0
11640,Sleepwalker,452634,0,452634,2011.csv,2011,0.0,1.0
11641,Enchanted Feather,452513,0,452513,2020.csv,2020,0.0,1.0
11642,Leaning Into The Wind,452372,400530,51842,2018.csv,2018,0.8853996268557736,0.11460037314422643
11643,One Way Ticket to the Moon,452285,0,452285,2013.csv,2013,0.0,1.0
11644,La coppia dei campioni,452078,0,452078,2016.csv,2016,0.0,1.0
11645,Sailor Moon R: The Movie: The Promise of the Rose,452053,452053,0,2017.csv,2017,1.0,0.0
11646,Hedgehogs 2017 Re-release,452044,0,452044,2017.csv,2017,0.0,1.0
11647,22 Minutes,452036,0,452036,2014.csv,2014,0.0,1.0
11648,Rak Wei Hei,451995,0,451995,2012.csv,2012,0.0,1.0
11649,Young Love Lost,451772,0,451772,2017.csv,2017,0.0,1.0
11650,Love Song of Huayao Thai,451751,0,451751,2017.csv,2017,0.0,1.0
11651,Wo de shi pian 2017 Re-release,451030,0,451030,2017.csv,2017,0.0,1.0
11652,The Perfect Host,450885,48764,402121,2011.csv,2011,0.10815174601062355,0.8918482539893764
11653,The Gambler,450747,0,450747,2014.csv,2014,0.0,1.0
11654,Perfect Blue 2017 Re-release,450594,446062,4532,2017.csv,2017,0.9899421652307843,0.010057834769215747
11655,Kill List,450275,29063,421212,2011.csv,2011,0.06454500027760812,0.9354549997223919
11656,Pearl Jam: Let's Play Two,450273,348833,101440,2017.csv,2017,0.7747144510108313,0.2252855489891688
11657,Intimate Parts,450203,0,450203,2013.csv,2013,0.0,1.0
11658,Burden,450189,139270,310919,2020.csv,2020,0.3093589581264758,0.6906410418735243
11659,Behind You,449724,0,449724,2020.csv,2020,0.0,1.0
11660,Hesher,449702,382946,66756,2011.csv,2011,0.8515550297752734,0.1484449702247266
11661,17 Girls,449626,15123,434503,2011.csv,2011,0.033634620773709704,0.9663653792262903
11662,Gekijouban Tenpesuto 3D 2012 Re-release,449518,0,449518,2012.csv,2012,0.0,1.0
11663,My Lady Boss,449509,0,449509,2013.csv,2013,0.0,1.0
11664,Black Water 2017 Re-release,449126,0,449126,2017.csv,2017,0.0,1.0
11665,The Rocket,449064,56823,392241,2013.csv,2013,0.1265365293143071,0.8734634706856929
11666,A Dream Ring,449039,0,449039,2016.csv,2016,0.0,1.0
11667,Before We Vanish,448829,52087,396742,2017.csv,2017,0.11605087906530104,0.8839491209346989
11668,Watching the None,448772,0,448772,2019.csv,2019,0.0,1.0
11669,The Invaluable Treasure,448720,0,448720,2011.csv,2011,0.0,1.0
11670,Henri,448635,0,448635,2013.csv,2013,0.0,1.0
11671,Sebahat & Melahat,448406,0,448406,2015.csv,2015,0.0,1.0
11672,Magic Mirror 3,447856,0,447856,2019.csv,2019,0.0,1.0
11673,Life for Sale,447839,0,447839,2011.csv,2011,0.0,1.0
11674,Oversize,447809,0,447809,2017.csv,2017,0.0,1.0
11675,The Greatest Showman 2020 Re-release,447797,0,447797,2020.csv,2020,0.0,1.0
11676,My Mother Is Crazy,447679,0,447679,2018.csv,2018,0.0,1.0
11677,18 Meals,447674,0,447674,2010.csv,2010,0.0,1.0
11678,Code Geass: Akito the Exiled - The Wyvern Arrives,447630,0,447630,2012.csv,2012,0.0,1.0
11679,Bizim Hikaye 2015 Re-release,447389,0,447389,2015.csv,2015,0.0,1.0
11680,Red Eagle,447282,0,447282,2010.csv,2010,0.0,1.0
11681,Lost in Mobius,447191,0,447191,2018.csv,2018,0.0,1.0
11682,The Truth About Love Is...,447125,0,447125,2017.csv,2017,0.0,1.0
11683,Koode,446792,0,446792,2018.csv,2018,0.0,1.0
11684,David et Madame Hansen,446644,0,446644,2012.csv,2012,0.0,1.0
11685,Antidote,446619,0,446619,2014.csv,2014,0.0,1.0
11686,Archer: Double Trouble,446478,0,446478,2015.csv,2015,0.0,1.0
11687,Capital in the Twenty-First Century,446284,0,446284,2019.csv,2019,0.0,1.0
11688,The Sleeping Beauty,446131,29066,417065,2011.csv,2011,0.06515126722868395,0.9348487327713161
11689,War Games,445968,0,445968,2011.csv,2011,0.0,1.0
11690,South Solitary,445957,0,445957,2010.csv,2010,0.0,1.0
11691,Tintoretto. A Rebel in Venice,445924,0,445924,2019.csv,2019,0.0,1.0
11692,La Herencia,445779,0,445779,2015.csv,2015,0.0,1.0
11693,Privychka rasstavatsya,445729,0,445729,2013.csv,2013,0.0,1.0
11694,Cruel Intentions 2019 Re-release,445218,445218,0,2019.csv,2019,1.0,0.0
11695,Cumali Ceber 2,445125,0,445125,2018.csv,2018,0.0,1.0
11696,The Cell,445054,0,445054,2017.csv,2017,0.0,1.0
11697,Zaklete pirko,445004,0,445004,2020.csv,2020,0.0,1.0
11698,Diep Vu Chan Dai,444923,0,444923,2016.csv,2016,0.0,1.0
11699,Arkadasim Max,444635,0,444635,2013.csv,2013,0.0,1.0
11700,Mohalla Assi,444399,0,444399,2018.csv,2018,0.0,1.0
11701,Mr. Idol,444225,0,444225,2011.csv,2011,0.0,1.0
11702,Alles voor elkaar,444139,0,444139,2017.csv,2017,0.0,1.0
11703,The Summer of All My Parents,444064,0,444064,2016.csv,2016,0.0,1.0
11704,Charlie Countryman,443990,11650,432340,2013.csv,2013,0.026239329714633212,0.9737606702853668
11705,Tonno spiaggiato,443769,0,443769,2018.csv,2018,0.0,1.0
11706,Don't Listen,443458,0,443458,2020.csv,2020,0.0,1.0
11707,It's Entertainment,443151,0,443151,2014.csv,2014,0.0,1.0
11708,La Tarajo3 La Esteslam,443078,0,443078,2010.csv,2010,0.0,1.0
11709,Porco Rosso 2018 Re-release,443059,443059,0,2018.csv,2018,1.0,0.0
11710,Ayirathil Oruvan,443008,0,443008,2010.csv,2010,0.0,1.0
11711,Bin Bulaye Baraati,442971,0,442971,2011.csv,2011,0.0,1.0
11712,Animal Rescue Squad,442969,0,442969,2019.csv,2019,0.0,1.0
11713,Ækte vare,442742,0,442742,2014.csv,2014,0.0,1.0
11714,The Last Fishing Trip,442701,0,442701,2020.csv,2020,0.0,1.0
11715,Grave Encounters 2013 Re-release,442697,0,442697,2013.csv,2013,0.0,1.0
11716,A Lonely Place to Die,442550,0,442550,2011.csv,2011,0.0,1.0
11717,Desire,442472,0,442472,2017.csv,2017,0.0,1.0
11718,Sami Blood,442416,0,442416,2017.csv,2017,0.0,1.0
11719,The Cane,442362,0,442362,2011.csv,2011,0.0,1.0
11720,Prince Avalanche,442313,205139,237174,2013.csv,2013,0.46378695629565486,0.5362130437043451
11721,Papadopoulos & Sons,442287,0,442287,2013.csv,2013,0.0,1.0
11722,Elf 2018 Re-release,442073,442073,0,2018.csv,2018,1.0,0.0
11723,Jamaica,441928,0,441928,2017.csv,2017,0.0,1.0
11724,Nadie Sabe para quien trabaja,441606,0,441606,2017.csv,2017,0.0,1.0
11725,De Hvide Blade,441430,0,441430,2014.csv,2014,0.0,1.0
11726,11-12-13 Rak Kan Ja Tai,441349,0,441349,2016.csv,2016,0.0,1.0
11727,Camino Skies,441138,0,441138,2019.csv,2019,0.0,1.0
11728,Lockdown all'italiana,440786,0,440786,2020.csv,2020,0.0,1.0
11729,The Falcons,440723,0,440723,2018.csv,2018,0.0,1.0
11730,Crossing Hennessy,440650,0,440650,2010.csv,2010,0.0,1.0
11731,Ashke,440647,0,440647,2018.csv,2018,0.0,1.0
11732,Paiyaa,440586,0,440586,2010.csv,2010,0.0,1.0
11733,The Memory of Water,440254,0,440254,2015.csv,2015,0.0,1.0
11734,Lost Valentine,439987,0,439987,2014.csv,2014,0.0,1.0
11735,Bastards,439935,24525,415410,2013.csv,2013,0.05574687169695523,0.9442531283030448
11736,The Haunted Graduation Photo,439839,0,439839,2017.csv,2017,0.0,1.0
11737,The Muppet Christmas Carol 2017 Re-release,439735,0,439735,2017.csv,2017,0.0,1.0
11738,Something in the Air,439726,0,439726,2011.csv,2011,0.0,1.0
11739,Hidden Universe,439677,0,439677,2013.csv,2013,0.0,1.0
11740,F Tipi Film,439666,0,439666,2012.csv,2012,0.0,1.0
11741,Bitch Slap,439587,17365,422222,2010.csv,2010,0.03950298803194817,0.9604970119680518
11742,Triad,439263,0,439263,2012.csv,2012,0.0,1.0
11743,The 4 Movie,439134,0,439134,2011.csv,2011,0.0,1.0
11744,Causa & Efeito,438934,0,438934,2014.csv,2014,0.0,1.0
11745,Cuidado con lo que deseas,438748,0,438748,2020.csv,2020,0.0,1.0
11746,Silent Souls,438715,0,438715,2010.csv,2010,0.0,1.0
11747,My Sassy Hubby,438712,0,438712,2012.csv,2012,0.0,1.0
11748,Der kleine Medicus - Geheimnisvolle Mission im Körper 2016 Re-release,438691,0,438691,2016.csv,2016,0.0,1.0
11749,Disco 2019 Re-release,438514,0,438514,2019.csv,2019,0.0,1.0
11750,Microsex Office,438361,0,438361,2011.csv,2011,0.0,1.0
11751,Twist,438168,0,438168,2021.csv,2021,0.0,1.0
11752,Desert Dancer,438165,155271,282894,2014.csv,2014,0.3543665057683749,0.6456334942316251
11753,Kompensatsiya,437965,0,437965,2010.csv,2010,0.0,1.0
11754,Bastardi II 2010 Re-release,437907,0,437907,2010.csv,2010,0.0,1.0
11755,Panie Dulskie,437756,0,437756,2015.csv,2015,0.0,1.0
11756,CatVideoFest 2020,437625,437625,0,2020.csv,2020,1.0,0.0
11757,Vasco Live,437611,0,437611,2012.csv,2012,0.0,1.0
11758,Cold Tango,437592,0,437592,2017.csv,2017,0.0,1.0
11759,The Night Clerk,437286,0,437286,2011.csv,2011,0.0,1.0
11760,Balancing Act,437143,0,437143,2012.csv,2012,0.0,1.0
11761,Sotsugyo M ore-tachi no kanibaru,437086,0,437086,2016.csv,2016,0.0,1.0
11762,Queen of Hearts,437005,0,437005,2019.csv,2019,0.0,1.0
11763,Overdrive: Boy Meets Bicycle: Part 2,436810,0,436810,2017.csv,2017,0.0,1.0
11764,1965,436690,0,436690,2015.csv,2015,0.0,1.0
11765,Velaiilla Pattadhari 2,436124,0,436124,2017.csv,2017,0.0,1.0
11766,Butterfly House,435955,0,435955,2019.csv,2019,0.0,1.0
11767,Midnight Melody,435861,0,435861,2019.csv,2019,0.0,1.0
11768,My Kingdom,435759,36533,399226,2011.csv,2011,0.08383762584364293,0.916162374156357
11769,Panya Raenu 3 Rupu Rupee,435418,0,435418,2013.csv,2013,0.0,1.0
11770,Rosa Morena,435310,0,435310,2011.csv,2011,0.0,1.0
11771,Panic Attack,434811,0,434811,2018.csv,2018,0.0,1.0
11772,We the Animals,434743,400961,33782,2018.csv,2018,0.9222943210126443,0.07770567898735575
11773,Aanmodderfakker,434675,0,434675,2014.csv,2014,0.0,1.0
11774,What We Left Behind: Star Trek DS9,434437,382457,51980,2019.csv,2019,0.8803508909231949,0.11964910907680515
11775,Apostasy,434336,0,434336,2018.csv,2018,0.0,1.0
11776,The Forger,434317,0,434317,2015.csv,2015,0.0,1.0
11777,Vivarium,434030,0,434030,2020.csv,2020,0.0,1.0
11778,Hotel Gagarin,434029,0,434029,2018.csv,2018,0.0,1.0
11779,DCI 2018 Tour Premeire,434008,434008,0,2018.csv,2018,1.0,0.0
11780,Rosenwald,433924,433924,0,2015.csv,2015,1.0,0.0
11781,Early One Morning,433848,0,433848,2011.csv,2011,0.0,1.0
11782,Bjork: Biophilia Live,433686,127754,305932,2014.csv,2014,0.29457718256987775,0.7054228174301223
11783,Kalek Shanab,433614,0,433614,2019.csv,2019,0.0,1.0
11784,I Want Your Money,433588,433588,0,2010.csv,2010,1.0,0.0
11785,The Sower,433112,36233,396879,2018.csv,2018,0.08365734498236022,0.9163426550176398
11786,Bambukat,432288,0,432288,2016.csv,2016,0.0,1.0
11787,Une folle envie,432148,0,432148,2011.csv,2011,0.0,1.0
11788,Pyromaniac,431768,0,431768,2016.csv,2016,0.0,1.0
11789,Satan's Slaves,431730,0,431730,2018.csv,2018,0.0,1.0
11790,Eput,431671,0,431671,2016.csv,2016,0.0,1.0
11791,Tatara Samurai,431640,0,431640,2017.csv,2017,0.0,1.0
11792,The Dancer and the Thief 2011 Re-release,431493,0,431493,2011.csv,2011,0.0,1.0
11793,Ni Tú Ni Yo,431475,0,431475,2018.csv,2018,0.0,1.0
11794,The Girl from the Wardrobe,431220,0,431220,2013.csv,2013,0.0,1.0
11795,NGK,430902,0,430902,2019.csv,2019,0.0,1.0
11796,Very Big Shot,430767,0,430767,2015.csv,2015,0.0,1.0
11797,G'mor Evian!,430683,0,430683,2012.csv,2012,0.0,1.0
11798,Pauline détective,430574,0,430574,2012.csv,2012,0.0,1.0
11799,Harmony,430568,23248,407320,2015.csv,2015,0.0539937942438825,0.9460062057561175
11800,To See the Sea,430506,0,430506,2014.csv,2014,0.0,1.0
11801,Ghostbusters 2019 Re-release,430435,369612,60823,2019.csv,2019,0.8586941117706506,0.1413058882293494
11802,Andy Irons: Kissed by God,430393,285933,144460,2018.csv,2018,0.6643532771211428,0.3356467228788572
11803,Iron Man 2020 Re-release,430000,430000,0,2020.csv,2020,1.0,0.0
11804,The State-Mafia Pact,429961,0,429961,2014.csv,2014,0.0,1.0
11805,Sorelle Mai,429931,0,429931,2011.csv,2011,0.0,1.0
11806,Bairavaa,429872,0,429872,2017.csv,2017,0.0,1.0
11807,"Chien Pourri, la vie à Paris!",429793,0,429793,2020.csv,2020,0.0,1.0
11808,Doru,429595,0,429595,2017.csv,2017,0.0,1.0
11809,Traces of Sandalwood,429453,0,429453,2014.csv,2014,0.0,1.0
11810,Kapi Lingjormailoakjao,429405,0,429405,2010.csv,2010,0.0,1.0
11811,Go Goa Gone,429350,298457,130893,2013.csv,2013,0.6951368347502038,0.30486316524979623
11812,On the Beach at Night Alone,429159,37489,391670,2017.csv,2017,0.08735457021756506,0.9126454297824349
11813,Infamous,429148,429148,0,2020.csv,2020,1.0,0.0
11814,Do It or Shut Up,429075,0,429075,2019.csv,2019,0.0,1.0
11815,Disc Fairy,429028,0,429028,2017.csv,2017,0.0,1.0
11816,4N1K 2,429007,0,429007,2018.csv,2018,0.0,1.0
11817,Neswen,428914,0,428914,2014.csv,2014,0.0,1.0
11818,Aravindha Sametha,428762,0,428762,2018.csv,2018,0.0,1.0
11819,Pen Fairy Impac Disc Fairy,428688,0,428688,2016.csv,2016,0.0,1.0
11820,My Happy Family,428468,0,428468,2017.csv,2017,0.0,1.0
11821,Distinction,428348,0,428348,2018.csv,2018,0.0,1.0
11822,The Consul of Sodom,428293,0,428293,2010.csv,2010,0.0,1.0
11823,Brasil Animado,428280,0,428280,2011.csv,2011,0.0,1.0
11824,Kadin Isi Banka Soygunu,428217,0,428217,2014.csv,2014,0.0,1.0
11825,Bamse and the Witch's Daughter,428140,0,428140,2017.csv,2017,0.0,1.0
11826,Bikes,427667,0,427667,2019.csv,2019,0.0,1.0
11827,Gnome Alone 2019 Re-release,427533,0,427533,2019.csv,2019,0.0,1.0
11828,Panya Raenu,427458,0,427458,2011.csv,2011,0.0,1.0
11829,The Search,427440,0,427440,2014.csv,2014,0.0,1.0
11830,The Treasure,427431,0,427431,2017.csv,2017,0.0,1.0
11831,Grabbers,427335,0,427335,2012.csv,2012,0.0,1.0
11832,The Origin of Violence,427073,0,427073,2016.csv,2016,0.0,1.0
11833,Le correspondant,427051,0,427051,2016.csv,2016,0.0,1.0
11834,The Domain,426975,0,426975,2019.csv,2019,0.0,1.0
11835,All the Freckles in the World,426801,0,426801,2019.csv,2019,0.0,1.0
11836,Payback,426775,0,426775,2015.csv,2015,0.0,1.0
11837,Blackway,426491,27079,399412,2016.csv,2016,0.06349254732221782,0.9365074526777821
11838,Happy Bhaag Jayegi,426345,351840,74505,2016.csv,2016,0.825247158990958,0.17475284100904198
11839,Rilu Rilu Fairilu: Yosei no Door,426298,0,426298,2017.csv,2017,0.0,1.0
11840,Bungaeman,426191,0,426191,2016.csv,2016,0.0,1.0
11841,The Metropolitan Opera HD Live: Verdi: Macbeth,426158,0,426158,2014.csv,2014,0.0,1.0
11842,Kirk Yalan,425958,0,425958,2019.csv,2019,0.0,1.0
11843,You Came Back,425813,0,425813,2020.csv,2020,0.0,1.0
11844,Chia danshi!!,425733,0,425733,2019.csv,2019,0.0,1.0
11845,Sky Tour: The Movie,425427,0,425427,2020.csv,2020,0.0,1.0
11846,Sweet Home 2015 Re-release,425345,0,425345,2015.csv,2015,0.0,1.0
11847,Killing Sarai,425332,425332,0,2019.csv,2019,1.0,0.0
11848,The Spooks,425292,0,425292,2016.csv,2016,0.0,1.0
11849,Thou Shalt Not Hate,425244,0,425244,2020.csv,2020,0.0,1.0
11850,Vertigo 2018 Re-release,425152,394212,30940,2018.csv,2018,0.9272260273972602,0.07277397260273973
11851,Tour de France,425144,0,425144,2016.csv,2016,0.0,1.0
11852,Dreamchild,425047,0,425047,2020.csv,2020,0.0,1.0
11853,Ambarsariya,424961,0,424961,2016.csv,2016,0.0,1.0
11854,Bang Rajan 2,424808,0,424808,2010.csv,2010,0.0,1.0
11855,Mr. Hayhill,424570,0,424570,2011.csv,2011,0.0,1.0
11856,Blood of My Blood,424494,0,424494,2015.csv,2015,0.0,1.0
11857,1919 Yu Gwan-sun,424481,0,424481,2019.csv,2019,0.0,1.0
11858,Sound of My Voice,424088,408015,16073,2012.csv,2012,0.9620998472015242,0.037900152798475785
11859,Microhabitat,424025,0,424025,2018.csv,2018,0.0,1.0
11860,Monolith,423981,0,423981,2017.csv,2017,0.0,1.0
11861,Viva,423976,178008,245968,2016.csv,2016,0.41985395399739606,0.5801460460026039
11862,Never Trust a Stranger,423946,0,423946,2015.csv,2015,0.0,1.0
11863,Montparnasse Bienvenüe,423747,0,423747,2017.csv,2017,0.0,1.0
11864,Reality,423619,0,423619,2015.csv,2015,0.0,1.0
11865,Fraktus - Das letzte Kapitel der Musikgeschichte,423477,0,423477,2012.csv,2012,0.0,1.0
11866,Jensen & Jensen,423322,0,423322,2011.csv,2011,0.0,1.0
11867,God Help the Girl,423306,102757,320549,2014.csv,2014,0.2427487444071192,0.7572512555928808
11868,Die Hard 2020 Re-release,423221,325000,98221,2020.csv,2020,0.7679203064120164,0.23207969358798358
11869,El Babysitter,423119,0,423119,2013.csv,2013,0.0,1.0
11870,AlJazeera 2,423067,0,423067,2014.csv,2014,0.0,1.0
11871,Cash Flow,422802,0,422802,2012.csv,2012,0.0,1.0
11872,Cirque du Soleil in Cinema: KURIOS - Cabinet of Curiosities,422760,413039,9721,2018.csv,2018,0.9770058662125083,0.02299413378749172
11873,Mississippi Grind,422746,130541,292205,2015.csv,2015,0.3087929868053157,0.6912070131946842
11874,Behaving Badly,422697,0,422697,2014.csv,2014,0.0,1.0
11875,Ben-Hur 2019 Re-release,422622,422622,0,2019.csv,2019,1.0,0.0
11876,Super,422618,327716,94902,2011.csv,2011,0.7754425982802436,0.22455740171975638
11877,Confetti Harvest,422500,0,422500,2014.csv,2014,0.0,1.0
11878,Dragevokteren,422456,0,422456,2020.csv,2020,0.0,1.0
11879,Settai,422247,87838,334409,2013.csv,2013,0.20802516062873153,0.7919748393712684
11880,The Dark and the Wicked,422174,157252,264922,2020.csv,2020,0.3724814886752855,0.6275185113247145
11881,Mad Max: Fury Road 2016 Re-release,421986,421986,0,2016.csv,2016,1.0,0.0
11882,On Air: Storia di un Successo,421624,0,421624,2016.csv,2016,0.0,1.0
11883,She's Beautiful When She's Angry,421573,421573,0,2014.csv,2014,1.0,0.0
11884,Bellbird,421494,0,421494,2019.csv,2019,0.0,1.0
11885,The Bounce Back,421404,321910,99494,2016.csv,2016,0.7638987764710349,0.23610122352896507
11886,Die abhandene Welt,421308,0,421308,2015.csv,2015,0.0,1.0
11887,The Cinderella Addiction,421202,0,421202,2021.csv,2021,0.0,1.0
11888,SIX60: Till the Lights Go Out,421163,0,421163,2020.csv,2020,0.0,1.0
11889,Knysna,421072,0,421072,2014.csv,2014,0.0,1.0
11890,La prima pietra,420807,0,420807,2018.csv,2018,0.0,1.0
11891,Arschkalt,420737,0,420737,2011.csv,2011,0.0,1.0
11892,A Yakuza's Daughter Never Cries,420602,0,420602,2010.csv,2010,0.0,1.0
11893,Good Game: The Beginning,420559,0,420559,2018.csv,2018,0.0,1.0
11894,En fuera de juego,420332,0,420332,2012.csv,2012,0.0,1.0
11895,The Jack in the Box,420315,0,420315,2020.csv,2020,0.0,1.0
11896,Una donna per la vita,420202,0,420202,2012.csv,2012,0.0,1.0
11897,The Cold Blue,420177,420177,0,2019.csv,2019,1.0,0.0
11898,Hop Dedik,420009,0,420009,2011.csv,2011,0.0,1.0
11899,Voiceless,419952,419952,0,2016.csv,2016,1.0,0.0
11900,Childish Games,419559,0,419559,2012.csv,2012,0.0,1.0
11901,Masha e orso: Nuovi amici,419205,0,419205,2016.csv,2016,0.0,1.0
11902,Almost 18,419125,0,419125,2012.csv,2012,0.0,1.0
11903,Bring on the Melody,418787,0,418787,2017.csv,2017,0.0,1.0
11904,La venganza de Ira Vamp,418467,0,418467,2010.csv,2010,0.0,1.0
11905,Comrade Drakulich,418389,0,418389,2019.csv,2019,0.0,1.0
11906,Head,418337,0,418337,2011.csv,2011,0.0,1.0
11907,Willy's Wonderland,418286,418286,0,2021.csv,2021,1.0,0.0
11908,Bangaru Bullodu,418267,0,418267,2021.csv,2021,0.0,1.0
11909,The Garden of Words,418256,0,418256,2013.csv,2013,0.0,1.0
11910,Il tuttofare,418073,0,418073,2018.csv,2018,0.0,1.0
11911,Kadaram Kondan,417940,0,417940,2019.csv,2019,0.0,1.0
11912,Mattook Fi Bangkook,417922,0,417922,2010.csv,2010,0.0,1.0
11913,Mr Unbelievable,417846,0,417846,2015.csv,2015,0.0,1.0
11914,Frankenstein 2018 Re-release,417783,417783,0,2018.csv,2018,1.0,0.0
11915,Space Battleship Yamato 2202: Warriors of Love - Ch. 1,417770,0,417770,2017.csv,2017,0.0,1.0
11916,Happy Phirr Bhag Jayegi,417669,103385,314284,2018.csv,2018,0.2475285453313509,0.7524714546686491
11917,Manje Bistre 2,417525,0,417525,2019.csv,2019,0.0,1.0
11918,Goddotan: Kisu gaman senshuken the Movie,417410,0,417410,2013.csv,2013,0.0,1.0
11919,Bolshoi Ballet: Le Corsaire,417152,190192,226960,2019.csv,2019,0.4559297330469469,0.544070266953053
11920,The Experiment 2010 Re-release,417147,0,417147,2010.csv,2010,0.0,1.0
11921,Dirty Wars,416853,384473,32380,2013.csv,2013,0.922322737271892,0.07767726272810799
11922,Ellen: Die storie van Ellen Pakkies,416835,0,416835,2018.csv,2018,0.0,1.0
11923,Tales of Halloween,416792,0,416792,2015.csv,2015,0.0,1.0
11924,Spirit Touch Seventh Senses,416698,0,416698,2017.csv,2017,0.0,1.0
11925,Heaven in the Dark,416649,0,416649,2016.csv,2016,0.0,1.0
11926,Puppy Love,416454,0,416454,2017.csv,2017,0.0,1.0
11927,Manifesto,416389,161101,255288,2017.csv,2017,0.3869002303134809,0.6130997696865191
11928,Status Update,416178,4764,411414,2018.csv,2018,0.011447025071003272,0.9885529749289967
11929,The Metropolitan Opera HD Live: Rossini: La donna del lago,416102,0,416102,2015.csv,2015,0.0,1.0
11930,Premature,415863,0,415863,2014.csv,2014,0.0,1.0
11931,The Kill Team,415772,0,415772,2019.csv,2019,0.0,1.0
11932,Sofia,415435,0,415435,2018.csv,2018,0.0,1.0
11933,Farewell,415426,0,415426,2010.csv,2010,0.0,1.0
11934,Pretville,415102,0,415102,2012.csv,2012,0.0,1.0
11935,The Ghoul: Horror At The Howling Field,414862,0,414862,2020.csv,2020,0.0,1.0
11936,Orange Honey,414849,0,414849,2012.csv,2012,0.0,1.0
11937,Whiplash 2020 Re-release,414706,0,414706,2020.csv,2020,0.0,1.0
11938,Sand Storm,414698,86800,327898,2016.csv,2016,0.20930894289338264,0.7906910571066174
11939,Paradise Hills,414515,0,414515,2019.csv,2019,0.0,1.0
11940,Hello Cairo,414429,0,414429,2011.csv,2011,0.0,1.0
11941,Una canzone per te,413920,0,413920,2010.csv,2010,0.0,1.0
11942,The Ottoman Lieutenant,413844,240978,172866,2017.csv,2017,0.5822918780989939,0.4177081219010062
11943,Jai Mummy Di,413764,0,413764,2020.csv,2020,0.0,1.0
11944,Tulsa,413378,413378,0,2020.csv,2020,1.0,0.0
11945,Boyka: Undisputed,413334,0,413334,2017.csv,2017,0.0,1.0
11946,The Mafia Kills Only in Summer 2015 Re-release,413236,37134,376102,2015.csv,2015,0.08986148351063315,0.9101385164893668
11947,Autumn Promise,413088,0,413088,2019.csv,2019,0.0,1.0
11948,The Moth Diaries,413035,3838,409197,2012.csv,2012,0.009292190734441392,0.9907078092655586
11949,Vekh Baraatan Challiyan,412905,0,412905,2017.csv,2017,0.0,1.0
11950,Unbranded,412792,410185,2607,2015.csv,2015,0.9936844706292758,0.006315529370724239
11951,Rage,411967,5594,406373,2010.csv,2010,0.013578757521840342,0.9864212424781597
11952,The Teacher's Diary 2016 Re-release,411301,0,411301,2016.csv,2016,0.0,1.0
11953,Jakhalsdans,411116,0,411116,2010.csv,2010,0.0,1.0
11954,R,411097,0,411097,2010.csv,2010,0.0,1.0
11955,Sibel,410774,0,410774,2019.csv,2019,0.0,1.0
11956,Jhootha Kahin Ka,410647,0,410647,2019.csv,2019,0.0,1.0
11957,R... Rajkumar,410495,166503,243992,2013.csv,2013,0.4056151719265764,0.5943848280734235
11958,The Den,410129,0,410129,2013.csv,2013,0.0,1.0
11959,Blue Sky Bones,410000,0,410000,2014.csv,2014,0.0,1.0
11960,A Style of Men in Beijing,410000,0,410000,2013.csv,2013,0.0,1.0
11961,Hopelessly Devout,409976,0,409976,2018.csv,2018,0.0,1.0
11962,Buy Me,409913,0,409913,2018.csv,2018,0.0,1.0
11963,Bob the Builder: Mega Machines,409712,0,409712,2017.csv,2017,0.0,1.0
11964,The Lord of the Rings: The Fellowship of the Ring 2017 Re-release,409422,0,409422,2017.csv,2017,0.0,1.0
11965,Zengo,409418,0,409418,2020.csv,2020,0.0,1.0
11966,Songbird,409321,0,409321,2020.csv,2020,0.0,1.0
11967,Pat a Mat znovu v akci,409198,0,409198,2018.csv,2018,0.0,1.0
11968,Badlapur,409166,409166,0,2015.csv,2015,1.0,0.0
11969,Song One,408918,32251,376667,2015.csv,2015,0.0788691131229244,0.9211308868770756
11970,Belle du Seigneur,408909,0,408909,2012.csv,2012,0.0,1.0
11971,Vesku from Finland,408805,0,408805,2010.csv,2010,0.0,1.0
11972,The Reliant,408747,408747,0,2019.csv,2019,1.0,0.0
11973,Sleeping Beauty,408680,36578,372102,2011.csv,2011,0.08950278946853284,0.9104972105314671
11974,Wacken 3D,408535,0,408535,2014.csv,2014,0.0,1.0
11975,Me and My Umbrella,408388,0,408388,2010.csv,2010,0.0,1.0
11976,Randy Cunningham: 9th Grade Ninja: Bash Johnson: 11th Grade Ninja,408375,0,408375,2016.csv,2016,0.0,1.0
11977,Léto s gentlemanem,408371,0,408371,2019.csv,2019,0.0,1.0
11978,Aikatsu! Music Award: Minna de Shou wo MoracchaimaShow! 2016 Re-release,408350,0,408350,2016.csv,2016,0.0,1.0
11979,Flavors of Youth,408244,0,408244,2018.csv,2018,0.0,1.0
11980,The 5th Quarter,408159,408159,0,2011.csv,2011,1.0,0.0
11981,Atlantics,407933,0,407933,2019.csv,2019,0.0,1.0
11982,"Love, Kennedy",407871,407871,0,2017.csv,2017,1.0,0.0
11983,The Taking of Deborah Logan,407782,0,407782,2015.csv,2015,0.0,1.0
11984,Project 577,407743,0,407743,2012.csv,2012,0.0,1.0
11985,Hedi,406960,0,406960,2016.csv,2016,0.0,1.0
11986,Please Stand By,406732,9868,396864,2018.csv,2018,0.024261675993037184,0.9757383240069628
11987,Gekijouban Fate/Stay Night: Unlimited Blade Works,406602,0,406602,2010.csv,2010,0.0,1.0
11988,Just a Little Chemistry,406588,0,406588,2015.csv,2015,0.0,1.0
11989,Madonna's Pig,406559,0,406559,2011.csv,2011,0.0,1.0
11990,Ethir Neechal,406486,0,406486,2013.csv,2013,0.0,1.0
11991,Chasing Trane: The John Coltrane Documentary,406284,406284,0,2017.csv,2017,1.0,0.0
11992,Gabrielle,406256,5534,400722,2013.csv,2013,0.013621952660391477,0.9863780473396085
11993,The Square 2010 Re-release,406116,406116,0,2010.csv,2010,1.0,0.0
11994,Finally Found Someone,405968,0,405968,2017.csv,2017,0.0,1.0
11995,The Hunting Ground,405917,405917,0,2015.csv,2015,1.0,0.0
11996,The Tempest,405861,277943,127918,2010.csv,2010,0.6848231291008497,0.3151768708991502
11997,Your Eyes on Me,405856,0,405856,2020.csv,2020,0.0,1.0
11998,Boy 7,405616,0,405616,2015.csv,2015,0.0,1.0
11999,Ainbo,405519,0,405519,2021.csv,2021,0.0,1.0
12000,Sheep's Clothing,405508,0,405508,2014.csv,2014,0.0,1.0
12001,Stake Land,405380,33245,372135,2011.csv,2011,0.08200947259361586,0.9179905274063841
12002,The Laws of Thermodynamics,405269,0,405269,2018.csv,2018,0.0,1.0
12003,Happy Magic,405268,10697,394571,2011.csv,2011,0.02639487943780412,0.9736051205621958
12004,The Last Runway,405016,0,405016,2018.csv,2018,0.0,1.0
12005,The Philadelphia Story 2018 Re-release,404524,404524,0,2018.csv,2018,1.0,0.0
12006,Think Like a Dog,404438,0,404438,2020.csv,2020,0.0,1.0
12007,Jan Palach,404245,0,404245,2018.csv,2018,0.0,1.0
12008,"SuperManager, or Hack of the Fate",404117,0,404117,2011.csv,2011,0.0,1.0
12009,Socios por accidente 2,404117,0,404117,2015.csv,2015,0.0,1.0
12010,The Oath,403852,401463,2389,2018.csv,2018,0.9940844665867694,0.005915533413230589
12011,God's Pocket,403713,169976,233737,2014.csv,2014,0.4210317725711087,0.5789682274288913
12012,Vdrebezgi,403557,0,403557,2011.csv,2011,0.0,1.0
12013,Meet Me in St. Louis 75th Anniversary,403521,403521,0,2019.csv,2019,1.0,0.0
12014,Kosarkar Naj Bo 2,402851,0,402851,2019.csv,2019,0.0,1.0
12015,The Apu Trilogy,402723,402723,0,2015.csv,2015,1.0,0.0
12016,Bliss,402707,0,402707,2012.csv,2012,0.0,1.0
12017,Sabit Kanca 2,402700,0,402700,2014.csv,2014,0.0,1.0
12018,At First Site,402490,0,402490,2011.csv,2011,0.0,1.0
12019,7 Años de Matrimonio,402103,0,402103,2013.csv,2013,0.0,1.0
12020,Drinking Buddies,401914,343341,58573,2013.csv,2013,0.8542648427275487,0.14573515727245132
12021,Zoe,401912,0,401912,2018.csv,2018,0.0,1.0
12022,Tu hijo,401899,0,401899,2018.csv,2018,0.0,1.0
12023,Exes Baggage,401582,0,401582,2018.csv,2018,0.0,1.0
12024,PriPara: Everyone's Yearning Let's Go PriPari 2017 Re-release,401489,0,401489,2017.csv,2017,0.0,1.0
12025,My Sweet Orange Tree,401443,0,401443,2013.csv,2013,0.0,1.0
12026,Cold Sweat,401341,0,401341,2011.csv,2011,0.0,1.0
12027,Freetown,401328,401328,0,2015.csv,2015,1.0,0.0
12028,Iron Sky: The Coming Race,400900,0,400900,2019.csv,2019,0.0,1.0
12029,"Hello, Dolly!",400881,400881,0,2019.csv,2019,1.0,0.0
12030,The Mine,400538,0,400538,2016.csv,2016,0.0,1.0
12031,4L,400530,0,400530,2019.csv,2019,0.0,1.0
12032,Anna,400471,0,400471,2015.csv,2015,0.0,1.0
12033,Hranari,400341,0,400341,2011.csv,2011,0.0,1.0
12034,365 Days of Happiness,400283,0,400283,2011.csv,2011,0.0,1.0
12035,Racer and the Jailbird,400026,46337,353689,2017.csv,2017,0.11583497072690276,0.8841650292730973
12036,Ashan Khargeen,399981,0,399981,2016.csv,2016,0.0,1.0
12037,Our Youth,399868,0,399868,2018.csv,2018,0.0,1.0
12038,Home Care,399790,0,399790,2015.csv,2015,0.0,1.0
12039,Laurence Anyways,399784,0,399784,2012.csv,2012,0.0,1.0
12040,The Humbling,399666,0,399666,2015.csv,2015,0.0,1.0
12041,I Belong,399643,0,399643,2012.csv,2012,0.0,1.0
12042,Before Sunrise 2016 Re-release,399543,0,399543,2016.csv,2016,0.0,1.0
12043,Born2Drive,399500,0,399500,2019.csv,2019,0.0,1.0
12044,Berserk: The Golden Age Arc III - The Advent,399445,0,399445,2013.csv,2013,0.0,1.0
12045,Dumplin',399198,0,399198,2019.csv,2019,0.0,1.0
12046,Mio's Cookbook,399142,0,399142,2020.csv,2020,0.0,1.0
12047,Pa' las que sea papá,399052,0,399052,2018.csv,2018,0.0,1.0
12048,Patatje Oorlog,398821,0,398821,2011.csv,2011,0.0,1.0
12049,West Side Story 2018 Re-release,398670,398670,0,2018.csv,2018,1.0,0.0
12050,She Dies Tomorrow,398663,398663,0,2020.csv,2020,1.0,0.0
12051,The Long Falling,398494,0,398494,2011.csv,2011,0.0,1.0
12052,Gokaiger Goseiger Super Sentai 199 Hero Great Battle 2012 Re-release,398127,0,398127,2012.csv,2012,0.0,1.0
12053,Coziness,397906,0,397906,2019.csv,2019,0.0,1.0
12054,Space Mutiny,397887,397887,0,2018.csv,2018,1.0,0.0
12055,Berlin Syndrome,397783,28660,369123,2017.csv,2017,0.07204933343053876,0.9279506665694612
12056,Hunger 2012 Re-release,397707,0,397707,2012.csv,2012,0.0,1.0
12057,Childhood,397544,0,397544,2017.csv,2017,0.0,1.0
12058,Sadda Haq,397535,0,397535,2013.csv,2013,0.0,1.0
12059,Krull 2018 Re-release,397157,397157,0,2018.csv,2018,1.0,0.0
12060,Amin,397146,0,397146,2018.csv,2018,0.0,1.0
12061,Martyrs,397072,0,397072,2016.csv,2016,0.0,1.0
12062,Hermanitos del fin del mundo,396995,0,396995,2011.csv,2011,0.0,1.0
12063,Big Daddy's House: Veggie Mania,396947,0,396947,2011.csv,2011,0.0,1.0
12064,Flirting Scholar 2,396871,0,396871,2010.csv,2010,0.0,1.0
12065,La vida empieza hoy,396820,0,396820,2010.csv,2010,0.0,1.0
12066,Guernica,396764,0,396764,2016.csv,2016,0.0,1.0
12067,Mark of the Devil,396624,0,396624,2020.csv,2020,0.0,1.0
12068,Kiss Me,396596,0,396596,2011.csv,2011,0.0,1.0
12069,Hometown - Stories from a Century,396530,0,396530,2018.csv,2018,0.0,1.0
12070,The Adventures of Panda Warrior,396386,0,396386,2013.csv,2013,0.0,1.0
12071,Pop Redemption,396221,0,396221,2013.csv,2013,0.0,1.0
12072,Fanie Fourie's Lobola,395764,0,395764,2013.csv,2013,0.0,1.0
12073,Advantages of Travelling by Train,395690,0,395690,2019.csv,2019,0.0,1.0
12074,Mayakkam Enna,395638,0,395638,2011.csv,2011,0.0,1.0
12075,Memlekette demokrasi var,395497,0,395497,2010.csv,2010,0.0,1.0
12076,AniMen: Triton Force,395220,0,395220,2011.csv,2011,0.0,1.0
12077,Larin izbor: Izgubljeni princ,395077,0,395077,2012.csv,2012,0.0,1.0
12078,El Diesel,394887,0,394887,2018.csv,2018,0.0,1.0
12079,Muse Drones World Tour,394831,0,394831,2018.csv,2018,0.0,1.0
12080,Exam,394717,0,394717,2010.csv,2010,0.0,1.0
12081,Kryptonite,394522,0,394522,2015.csv,2015,0.0,1.0
12082,No Doubt,394485,0,394485,2010.csv,2010,0.0,1.0
12083,Make Me Shudder 2: Shudder Me Mae Nak,394373,0,394373,2014.csv,2014,0.0,1.0
12084,Kunigo nauda velniai gaudo,394170,0,394170,2015.csv,2015,0.0,1.0
12085,God Bless America,393880,122550,271330,2012.csv,2012,0.3111353711790393,0.6888646288209607
12086,Sofia the First: The Mystic Isles,393828,0,393828,2017.csv,2017,0.0,1.0
12087,I nöd eller lust,393751,0,393751,2015.csv,2015,0.0,1.0
12088,Into the Abyss,393714,223880,169834,2011.csv,2011,0.5686361165719278,0.43136388342807214
12089,Bubblegum,393693,0,393693,2017.csv,2017,0.0,1.0
12090,Bacalar,393492,0,393492,2011.csv,2011,0.0,1.0
12091,Thomas & Friends: The Great Race,393396,0,393396,2016.csv,2016,0.0,1.0
12092,The BBQ,393354,0,393354,2018.csv,2018,0.0,1.0
12093,3 Storeys,393331,0,393331,2018.csv,2018,0.0,1.0
12094,The Great Beauty 2020 Re-release,393284,0,393284,2013.csv,2013,0.0,1.0
12095,Turquaze,393082,0,393082,2010.csv,2010,0.0,1.0
12096,Incidencias,393060,0,393060,2016.csv,2016,0.0,1.0
12097,Sherlock: The Final Problem,392512,0,392512,2017.csv,2017,0.0,1.0
12098,The Legend of Muay Thai: 9 Satra,392295,0,392295,2018.csv,2018,0.0,1.0
12099,Bana Adini Sor,392088,0,392088,2015.csv,2015,0.0,1.0
12100,Te3n,391957,331507,60450,2016.csv,2016,0.8457738986674559,0.15422610133254414
12101,Fireworks,391940,0,391940,2019.csv,2019,0.0,1.0
12102,Black Heaven,391882,0,391882,2010.csv,2010,0.0,1.0
12103,Wang Mao,391730,0,391730,2016.csv,2016,0.0,1.0
12104,Tiny Furniture,391674,391674,0,2010.csv,2010,1.0,0.0
12105,Cheba Louisa,391655,0,391655,2013.csv,2013,0.0,1.0
12106,Barbie Video Game Hero,391583,0,391583,2017.csv,2017,0.0,1.0
12107,The Secret Society of Souptown,391572,0,391572,2015.csv,2015,0.0,1.0
12108,Black Butterfly,391431,0,391431,2017.csv,2017,0.0,1.0
12109,"I, Anna",391413,0,391413,2012.csv,2012,0.0,1.0
12110,Punjab Nahi Jaungi,390998,0,390998,2017.csv,2017,0.0,1.0
12111,Adventure in Time and Space,390928,0,390928,2018.csv,2018,0.0,1.0
12112,The Escape,390881,14018,376863,2018.csv,2018,0.03586257710147078,0.9641374228985292
12113,The Truffle Hunters,390792,0,390792,2021.csv,2021,0.0,1.0
12114,Derailed,390756,0,390756,2016.csv,2016,0.0,1.0
12115,The Last Prosecco,390416,0,390416,2017.csv,2017,0.0,1.0
12116,Kick Ass Girls,390233,0,390233,2013.csv,2013,0.0,1.0
12117,Detropia,390024,390024,0,2012.csv,2012,1.0,0.0
12118,Klara - Don't Be Afraid to Follow Your Dream,390016,0,390016,2010.csv,2010,0.0,1.0
12119,Fierce,389978,0,389978,2020.csv,2020,0.0,1.0
12120,Paw Patrol: Sea Patrol,389945,0,389945,2018.csv,2018,0.0,1.0
12121,Cosimo and Nicole,389907,0,389907,2012.csv,2012,0.0,1.0
12122,Quand je serai petit,389798,0,389798,2012.csv,2012,0.0,1.0
12123,As Needed,389762,0,389762,2018.csv,2018,0.0,1.0
12124,Tum Milo Toh Sahi,389646,0,389646,2010.csv,2010,0.0,1.0
12125,Return to Ithaca,389501,0,389501,2014.csv,2014,0.0,1.0
12126,La mia banda suona il pop,389470,0,389470,2020.csv,2020,0.0,1.0
12127,Anfang 80,389327,0,389327,2011.csv,2011,0.0,1.0
12128,Once Upon a Time in Mumbaai Dobara,389237,0,389237,2013.csv,2013,0.0,1.0
12129,The Last Call,389113,0,389113,2013.csv,2013,0.0,1.0
12130,Eltern,388853,0,388853,2013.csv,2013,0.0,1.0
12131,Sul più bello,388737,0,388737,2020.csv,2020,0.0,1.0
12132,Possessions,388635,0,388635,2012.csv,2012,0.0,1.0
12133,Singh Saab the Great,388622,225668,162954,2013.csv,2013,0.580687660503008,0.4193123394969919
12134,Step Up China,388518,0,388518,2019.csv,2019,0.0,1.0
12135,Taking It Back,388499,0,388499,2013.csv,2013,0.0,1.0
12136,The Strange Case of Wilhelm Reich,388475,0,388475,2013.csv,2013,0.0,1.0
12137,Keep the Lights On,388331,246112,142219,2012.csv,2012,0.6337686149187163,0.3662313850812838
12138,The Referee,388078,0,388078,2013.csv,2013,0.0,1.0
12139,Atacada: la teoría del dolor,388076,0,388076,2015.csv,2015,0.0,1.0
12140,Amore Mio,387912,0,387912,2015.csv,2015,0.0,1.0
12141,Voevoda,387904,0,387904,2017.csv,2017,0.0,1.0
12142,Mamas & Papas,387850,0,387850,2010.csv,2010,0.0,1.0
12143,Laung Laachi,387773,0,387773,2018.csv,2018,0.0,1.0
12144,Walking Past the Future,387766,0,387766,2018.csv,2018,0.0,1.0
12145,The Dog,387463,0,387463,2010.csv,2010,0.0,1.0
12146,Tropicália,387448,0,387448,2012.csv,2012,0.0,1.0
12147,Stavka na lyubov,387143,0,387143,2016.csv,2016,0.0,1.0
12148,Grand Hotel,386997,0,386997,2016.csv,2016,0.0,1.0
12149,Body of Water,386919,0,386919,2011.csv,2011,0.0,1.0
12150,"Westwood: Punk, Icon, Activist",386856,58979,327877,2018.csv,2018,0.15245724507310213,0.8475427549268979
12151,Acts of Violence,386790,0,386790,2018.csv,2018,0.0,1.0
12152,The Haunted Cinema 2,386634,0,386634,2017.csv,2017,0.0,1.0
12153,Hitchcock/Truffaut,386471,260430,126041,2015.csv,2015,0.6738668619378945,0.3261331380621056
12154,Exists,386350,0,386350,2014.csv,2014,0.0,1.0
12155,Special Female Force,386261,0,386261,2016.csv,2016,0.0,1.0
12156,Isabelle,386250,0,386250,2018.csv,2018,0.0,1.0
12157,The Wedding Guest,386166,386166,0,2019.csv,2019,1.0,0.0
12158,Brazilok,385831,0,385831,2017.csv,2017,0.0,1.0
12159,How to Talk to Girls at Parties,385733,84809,300924,2018.csv,2018,0.21986451768451235,0.7801354823154877
12160,Black Out,385731,0,385731,2012.csv,2012,0.0,1.0
12161,Sakli Hayatlar,385512,0,385512,2011.csv,2011,0.0,1.0
12162,Proigrannoe mesto,385454,0,385454,2018.csv,2018,0.0,1.0
12163,Fire in Babylon,385451,0,385451,2011.csv,2011,0.0,1.0
12164,Hostile,385428,0,385428,2018.csv,2018,0.0,1.0
12165,Harmony 2015 Re-release,385280,0,385280,2015.csv,2015,0.0,1.0
12166,Each and Every Moment,385229,0,385229,2018.csv,2018,0.0,1.0
12167,Yunus Emre: Askin Sesi,384789,0,384789,2014.csv,2014,0.0,1.0
12168,Samurai Cop,384756,384756,0,2017.csv,2017,1.0,0.0
12169,The Snake Brothers,384725,0,384725,2015.csv,2015,0.0,1.0
12170,Bethlehem,384670,201700,182970,2014.csv,2014,0.5243455429329035,0.47565445706709647
12171,Mary Poppins 2018 Re-release,384644,0,384644,2018.csv,2018,0.0,1.0
12172,I Am Woman,384551,0,384551,2020.csv,2020,0.0,1.0
12173,The Secret World of Arrietty 2019 Re-release,384289,384289,0,2019.csv,2019,1.0,0.0
12174,Opera de Paris: Barber of Seville,384162,0,384162,2014.csv,2014,0.0,1.0
12175,Place des Victoires,384145,0,384145,2019.csv,2019,0.0,1.0
12176,For a Handful of Kisses,384083,0,384083,2014.csv,2014,0.0,1.0
12177,ABNKKBSNPLAko?!,384007,0,384007,2014.csv,2014,0.0,1.0
12178,Still the Water,383948,0,383948,2014.csv,2014,0.0,1.0
12179,Lover for a Day,383872,0,383872,2017.csv,2017,0.0,1.0
12180,The Prado Museum: A Collection of Wonders,383676,0,383676,2019.csv,2019,0.0,1.0
12181,"Coconut, the Little Dragon 2017 Re-release",383647,0,383647,2017.csv,2017,0.0,1.0
12182,The Numbers Station,383488,0,383488,2013.csv,2013,0.0,1.0
12183,Dream Home,383158,0,383158,2010.csv,2010,0.0,1.0
12184,The Stolen Princess 2020 Re-release,383116,0,383116,2020.csv,2020,0.0,1.0
12185,Non me lo dire,382931,0,382931,2012.csv,2012,0.0,1.0
12186,House of the Rising Sons,382703,0,382703,2018.csv,2018,0.0,1.0
12187,Bone Tomahawk,382579,0,382579,2015.csv,2015,0.0,1.0
12188,Alle utlendinger har lukka gardiner,382459,0,382459,2020.csv,2020,0.0,1.0
12189,Isolados,382371,0,382371,2014.csv,2014,0.0,1.0
12190,The Mermaid Princess,382326,0,382326,2016.csv,2016,0.0,1.0
12191,Yellowbird 2017 Re-release,382319,0,382319,2017.csv,2017,0.0,1.0
12192,Paseo de Oficina,382127,0,382127,2012.csv,2012,0.0,1.0
12193,Digimon Adventure tri. Part 5: Coexistence,382119,52339,329780,2017.csv,2017,0.1369704202094112,0.8630295797905888
12194,Z for Zachariah,381839,121461,260378,2015.csv,2015,0.3180947991169053,0.6819052008830947
12195,My Beloved Enemy,381668,0,381668,2018.csv,2018,0.0,1.0
12196,In the Dark,381663,0,381663,2014.csv,2014,0.0,1.0
12197,Beef. Russian Hip-Hop,381571,0,381571,2019.csv,2019,0.0,1.0
12198,Rhino Season,381529,0,381529,2012.csv,2012,0.0,1.0
12199,The Blue Tiger,381214,0,381214,2012.csv,2012,0.0,1.0
12200,Ghost in the Shell: The New Movie 2017 Re-release,381095,0,381095,2017.csv,2017,0.0,1.0
12201,Soul Contract,381071,0,381071,2018.csv,2018,0.0,1.0
12202,Killing Love,381059,0,381059,2014.csv,2014,0.0,1.0
12203,Tequila,381057,0,381057,2011.csv,2011,0.0,1.0
12204,When Will You Return?,380909,0,380909,2017.csv,2017,0.0,1.0
12205,A Few Less Men,380806,0,380806,2017.csv,2017,0.0,1.0
12206,Lasa y Zabala,380562,0,380562,2014.csv,2014,0.0,1.0
12207,Radiance,380560,0,380560,2017.csv,2017,0.0,1.0
12208,Flower,380553,328188,52365,2018.csv,2018,0.8623976161007797,0.13760238389922033
12209,The Head Hunter,380448,0,380448,2019.csv,2019,0.0,1.0
12210,Hinterdupfing,380414,0,380414,2014.csv,2014,0.0,1.0
12211,Does Everyone Cheat?,380358,0,380358,2010.csv,2010,0.0,1.0
12212,Four More Years,380302,0,380302,2010.csv,2010,0.0,1.0
12213,RSC Live: Measure For Measure,380289,0,380289,2019.csv,2019,0.0,1.0
12214,Andelé vsedního dne,380111,0,380111,2014.csv,2014,0.0,1.0
12215,Jane and Emma,380030,380030,0,2018.csv,2018,1.0,0.0
12216,Tian xin qiao ke li,380000,0,380000,2013.csv,2013,0.0,1.0
12217,Promise Time,380000,0,380000,2012.csv,2012,0.0,1.0
12218,Ch/B,379990,0,379990,2015.csv,2015,0.0,1.0
12219,Asuran,379728,0,379728,2019.csv,2019,0.0,1.0
12220,30 Years Ago,379702,0,379702,2016.csv,2016,0.0,1.0
12221,Laz Vampir Tirakula,379520,0,379520,2012.csv,2012,0.0,1.0
12222,"Kolobanga. Hello, the Internet!",379371,0,379371,2017.csv,2017,0.0,1.0
12223,Twilight's Kiss,379273,0,379273,2020.csv,2020,0.0,1.0
12224,Ai Uta: Yakusoku no Nakuhito,379028,0,379028,2019.csv,2019,0.0,1.0
12225,Daughter of Mine,379010,10628,368382,2018.csv,2018,0.02804147647819319,0.9719585235218068
12226,I'll Push You: A Real-Life Inspiration,378899,378899,0,2017.csv,2017,1.0,0.0
12227,Mazlum Kuzey,378764,0,378764,2015.csv,2015,0.0,1.0
12228,Snatch Up,378719,0,378719,2018.csv,2018,0.0,1.0
12229,Home Alone 2018 Re-release,378439,0,378439,2018.csv,2018,0.0,1.0
12230,Trudnosti vyzhivaniya,378387,0,378387,2019.csv,2019,0.0,1.0
12231,Haunted Dormitory: White Paper Girl,378192,0,378192,2017.csv,2017,0.0,1.0
12232,Delirium 2018 Re-release,377909,0,377909,2018.csv,2018,0.0,1.0
12233,Shahid,377803,12153,365650,2013.csv,2013,0.03216755822478911,0.9678324417752109
12234,La Chasse a l'Ours,377759,0,377759,2018.csv,2018,0.0,1.0
12235,Miss Hokusai,377702,222670,155032,2015.csv,2015,0.589538842791407,0.410461157208593
12236,Paris-Willouby,377507,0,377507,2016.csv,2016,0.0,1.0
12237,Daughter,377470,0,377470,2015.csv,2015,0.0,1.0
12238,El sendero de la anaconda,377421,0,377421,2019.csv,2019,0.0,1.0
12239,Attack on Titan: Smoke Signal,377334,377334,0,2018.csv,2018,1.0,0.0
12240,My Dear Elephant,376898,0,376898,2019.csv,2019,0.0,1.0
12241,Age of Cannibals,376702,0,376702,2014.csv,2014,0.0,1.0
12242,Le talent de mes amis,376522,889,375633,2015.csv,2015,0.0023610838144915835,0.9976389161855084
12243,The Scent of Mandarin,376499,0,376499,2015.csv,2015,0.0,1.0
12244,My House,376363,0,376363,2014.csv,2014,0.0,1.0
12245,Gardening with Soul,376331,0,376331,2013.csv,2013,0.0,1.0
12246,Riders of Justice,376314,0,376314,2021.csv,2021,0.0,1.0
12247,All About Yves,375950,0,375950,2019.csv,2019,0.0,1.0
12248,Dreamkatcher,375836,0,375836,2020.csv,2020,0.0,1.0
12249,A Patriotic Man,375834,0,375834,2013.csv,2013,0.0,1.0
12250,Fritzi: A Revolutionary Tale,375689,0,375689,2019.csv,2019,0.0,1.0
12251,Paul Kelly - Stories of Me,375661,0,375661,2012.csv,2012,0.0,1.0
12252,To Life,375520,0,375520,2014.csv,2014,0.0,1.0
12253,The Oddsockeaters 2018 Re-release,375384,0,375384,2018.csv,2018,0.0,1.0
12254,The Metropolitan Opera HD Live: Puccini: Turandot,375295,0,375295,2019.csv,2019,0.0,1.0
12255,Servant,375252,0,375252,2020.csv,2020,0.0,1.0
12256,Flamenco Flamenco,375145,0,375145,2010.csv,2010,0.0,1.0
12257,"Gostosas, Lindas e Sexies",374860,0,374860,2017.csv,2017,0.0,1.0
12258,Hijo De Mi Marido,374859,0,374859,2013.csv,2013,0.0,1.0
12259,Icing,374844,0,374844,2014.csv,2014,0.0,1.0
12260,General,374793,0,374793,2019.csv,2019,0.0,1.0
12261,Chronic,374704,9033,365671,2016.csv,2016,0.024107028481147787,0.9758929715188522
12262,The Bounty,374343,0,374343,2012.csv,2012,0.0,1.0
12263,Jurassic Park 2018 Re-release,374238,374238,0,2018.csv,2018,1.0,0.0
12264,Bad Buzz,374161,0,374161,2017.csv,2017,0.0,1.0
12265,Touken Ranbu: Hanamaru - Makuai Kaisouroku,374052,0,374052,2017.csv,2017,0.0,1.0
12266,My Little Sister,374035,0,374035,2019.csv,2019,0.0,1.0
12267,Cinema Paradiso 2020 Re-release,373967,0,373967,2020.csv,2020,0.0,1.0
12268,Koyelaanchal,373920,0,373920,2014.csv,2014,0.0,1.0
12269,Nobili bugie,373721,0,373721,2018.csv,2018,0.0,1.0
12270,Leaving the Scene,373666,0,373666,2019.csv,2019,0.0,1.0
12271,The Assignment,373455,0,373455,2017.csv,2017,0.0,1.0
12272,Adam Joan,373271,0,373271,2017.csv,2017,0.0,1.0
12273,The Conductor,372944,0,372944,2012.csv,2012,0.0,1.0
12274,Idealisten,372897,0,372897,2015.csv,2015,0.0,1.0
12275,I Lost Albert,372598,0,372598,2018.csv,2018,0.0,1.0
12276,Plastic Surgeon · Hunted Face,372581,0,372581,2016.csv,2016,0.0,1.0
12277,Pom Poko 2018 Re-release,372405,372405,0,2018.csv,2018,1.0,0.0
12278,Army of One,372194,0,372194,2016.csv,2016,0.0,1.0
12279,Eloise,372137,0,372137,2017.csv,2017,0.0,1.0
12280,Irresistible,371962,0,371962,2020.csv,2020,0.0,1.0
12281,Bloody Daisy,371951,0,371951,2019.csv,2019,0.0,1.0
12282,Ay büyürken uyuyamam,371915,0,371915,2011.csv,2011,0.0,1.0
12283,Stories of Love That Cannot Belong to This World,371762,0,371762,2017.csv,2017,0.0,1.0
12284,Fanny,371657,8735,362922,2013.csv,2013,0.023502853437443665,0.9764971465625564
12285,Break,371557,0,371557,2019.csv,2019,0.0,1.0
12286,Eteros ego,371528,0,371528,2017.csv,2017,0.0,1.0
12287,The Fraulein and the Sandman,371471,0,371471,2011.csv,2011,0.0,1.0
12288,Take Me Home,371379,0,371379,2016.csv,2016,0.0,1.0
12289,Hahaha,371295,0,371295,2010.csv,2010,0.0,1.0
12290,King of Prism: Shiny Seven Stars 3,371172,0,371172,2019.csv,2019,0.0,1.0
12291,The Nest,371094,0,371094,2019.csv,2019,0.0,1.0
12292,7 Boxes,370892,38106,332786,2013.csv,2013,0.10274149887298728,0.8972585011270127
12293,The Assistant,370692,0,370692,2015.csv,2015,0.0,1.0
12294,The Nutcracker Sweet,370591,0,370591,2015.csv,2015,0.0,1.0
12295,Rajapattai,370550,0,370550,2011.csv,2011,0.0,1.0
12296,The Banger,370388,0,370388,2020.csv,2020,0.0,1.0
12297,Time Share,370280,0,370280,2018.csv,2018,0.0,1.0
12298,Hava Nagila,370218,370218,0,2013.csv,2013,1.0,0.0
12299,Fimfarum: The Third Time Lucky 3D,370118,0,370118,2011.csv,2011,0.0,1.0
12300,The Crack: Inception,370021,0,370021,2019.csv,2019,0.0,1.0
12301,All'ultima spiaggia,369943,0,369943,2012.csv,2012,0.0,1.0
12302,"Ruben Brandt, Collector 2018 Re-release",369809,117963,251846,2018.csv,2018,0.31898358341738575,0.6810164165826142
12303,The Girl King,369798,0,369798,2015.csv,2015,0.0,1.0
12304,My Thoughts Are Silent,369623,0,369623,2019.csv,2019,0.0,1.0
12305,Big Boy,369617,0,369617,2010.csv,2010,0.0,1.0
12306,En helt vanlig dag på jobben,369406,0,369406,2010.csv,2010,0.0,1.0
12307,Bai Xue Gong Zhu Zhi Ai Ren Li Liang 2016 Re-release,369381,0,369381,2016.csv,2016,0.0,1.0
12308,Tera Intezaar,369233,0,369233,2017.csv,2017,0.0,1.0
12309,V Síti: Za Skolou,369226,0,369226,2020.csv,2020,0.0,1.0
12310,Soue Tafahom,369146,0,369146,2015.csv,2015,0.0,1.0
12311,Mooz-Lum,369129,369129,0,2011.csv,2011,1.0,0.0
12312,When Comedy Went to School,369065,369065,0,2013.csv,2013,1.0,0.0
12313,Code Geass: Akito the Exiled Final - To Beloved Ones,369062,0,369062,2016.csv,2016,0.0,1.0
12314,El Club de los Idealistas,368991,0,368991,2020.csv,2020,0.0,1.0
12315,Elcano & Magallanes: First Trip Around the World,368894,0,368894,2019.csv,2019,0.0,1.0
12316,The Best Plan Is No Plan,368694,0,368694,2013.csv,2013,0.0,1.0
12317,Blood Will Tell,368653,0,368653,2019.csv,2019,0.0,1.0
12318,Chun jie xin ling: Zhu meng yan yi quan,368543,0,368543,2017.csv,2017,0.0,1.0
12319,Zero 2,368432,0,368432,2010.csv,2010,0.0,1.0
12320,"Live Twice, Love Once",368430,0,368430,2019.csv,2019,0.0,1.0
12321,Pecking Order,368419,0,368419,2017.csv,2017,0.0,1.0
12322,The Void,368372,151042,217330,2017.csv,2017,0.41002573485498356,0.5899742651450165
12323,The Tough Guys,368276,0,368276,2013.csv,2013,0.0,1.0
12324,Tu mérites un amour,368121,0,368121,2019.csv,2019,0.0,1.0
12325,Benedict Ironbreaker: The Red Taxis,368036,0,368036,2014.csv,2014,0.0,1.0
12326,Dark Awakening,367925,0,367925,2015.csv,2015,0.0,1.0
12327,Gangster Payday,367920,0,367920,2014.csv,2014,0.0,1.0
12328,The Kid Detective,367890,364138,3752,2020.csv,2020,0.9898012993014216,0.010198700698578379
12329,Heli,367872,0,367872,2013.csv,2013,0.0,1.0
12330,Yellow Rose,367849,367849,0,2020.csv,2020,1.0,0.0
12331,Cunningham,367788,265102,102686,2019.csv,2019,0.7208011136850577,0.27919888631494233
12332,Horror Bathroom,367754,0,367754,2018.csv,2018,0.0,1.0
12333,Burraco fatale,367655,0,367655,2020.csv,2020,0.0,1.0
12334,Tell Tale,367586,0,367586,2010.csv,2010,0.0,1.0
12335,"Fafner In The Azure The Beyond Episodes 7, 8 And 9",367582,0,367582,2020.csv,2020,0.0,1.0
12336,Room 237,367406,296359,71047,2012.csv,2012,0.8066253681213699,0.1933746318786302
12337,Punch Line,367401,0,367401,2011.csv,2011,0.0,1.0
12338,Terrified,367173,0,367173,2018.csv,2018,0.0,1.0
12339,Backstabbing for Beginners,367000,0,367000,2018.csv,2018,0.0,1.0
12340,England Is Mine,366802,0,366802,2017.csv,2017,0.0,1.0
12341,The Metropolitan Opera HD Live: Wagner: Die Meistersinger von Nürnberg,366796,0,366796,2014.csv,2014,0.0,1.0
12342,Restiamo amici,366729,0,366729,2019.csv,2019,0.0,1.0
12343,Arthur 3: The War of the Two Worlds 2015 Re-release,366645,0,366645,2015.csv,2015,0.0,1.0
12344,Village People,366605,0,366605,2013.csv,2013,0.0,1.0
12345,Buppah Arigato,366559,0,366559,2016.csv,2016,0.0,1.0
12346,En Güzeli,366511,0,366511,2015.csv,2015,0.0,1.0
12347,Tigers Are Not Afraid,366460,0,366460,2017.csv,2017,0.0,1.0
12348,INXS: Baby Live at Wembly Stadium,366425,161750,204675,2019.csv,2019,0.44142730435969163,0.5585726956403084
12349,Laal Rang,366408,0,366408,2016.csv,2016,0.0,1.0
12350,Beny: Back to the Wild,365934,0,365934,2011.csv,2011,0.0,1.0
12351,The Entrepreneur,365872,0,365872,2012.csv,2012,0.0,1.0
12352,Grease 2010 Sing-a-long,365802,365802,0,2010.csv,2010,1.0,0.0
12353,Little Wing,365680,0,365680,2016.csv,2016,0.0,1.0
12354,Eat That Question,365540,355074,10466,2016.csv,2016,0.9713683864966899,0.02863161350331017
12355,Glen Campbell: I'll Be Me,365422,365422,0,2014.csv,2014,1.0,0.0
12356,Lords of Chaos,365353,253184,112169,2019.csv,2019,0.692984592982677,0.307015407017323
12357,Orpheline,365257,0,365257,2017.csv,2017,0.0,1.0
12358,A Reason to Live,365190,0,365190,2011.csv,2011,0.0,1.0
12359,Clemency,364952,364716,236,2019.csv,2019,0.9993533396172647,0.0006466603827352638
12360,Chefurs Raus!,364855,0,364855,2013.csv,2013,0.0,1.0
12361,BOSTON: An American Running Story,364369,364369,0,2017.csv,2017,1.0,0.0
12362,Hitsville: The Making of Motown,364013,0,364013,2019.csv,2019,0.0,1.0
12363,Second Origin,363922,0,363922,2015.csv,2015,0.0,1.0
12364,Lovely Molly 2013 Re-release,363794,0,363794,2013.csv,2013,0.0,1.0
12365,Adam,363793,0,363793,2020.csv,2020,0.0,1.0
12366,Midnight XII,363597,0,363597,2018.csv,2018,0.0,1.0
12367,Invisible Man,363595,0,363595,2015.csv,2015,0.0,1.0
12368,Cendrillon,363504,0,363504,2012.csv,2012,0.0,1.0
12369,Brillebjørn på ferie,363478,0,363478,2019.csv,2019,0.0,1.0
12370,London Road,363461,0,363461,2015.csv,2015,0.0,1.0
12371,Tillbaka till Bromma,363329,0,363329,2014.csv,2014,0.0,1.0
12372,Jig,363320,183790,179530,2011.csv,2011,0.5058626004624023,0.4941373995375977
12373,The Breadwinner,363307,312381,50926,2017.csv,2017,0.8598265378866908,0.14017346211330914
12374,Hostages,363259,0,363259,2017.csv,2017,0.0,1.0
12375,Brown Sugar,363099,0,363099,2010.csv,2010,0.0,1.0
12376,Breathless 2010 Re-release,363031,363031,0,2010.csv,2010,1.0,0.0
12377,Gold 2017 Re-release,363016,0,363016,2017.csv,2017,0.0,1.0
12378,Budapest Heist,362921,0,362921,2020.csv,2020,0.0,1.0
12379,Naughty Teenager,362606,0,362606,2019.csv,2019,0.0,1.0
12380,Seema Raja,362593,0,362593,2018.csv,2018,0.0,1.0
12381,Swing,362313,0,362313,2014.csv,2014,0.0,1.0
12382,Bullet Head,361965,0,361965,2017.csv,2017,0.0,1.0
12383,Persona 3 the Movie: #4 Winter of Rebirth,361950,0,361950,2016.csv,2016,0.0,1.0
12384,The Crossing,361715,0,361715,2012.csv,2012,0.0,1.0
12385,Hubert von Goisern - Brenna tuat's schon lang,361601,0,361601,2015.csv,2015,0.0,1.0
12386,Fakat Müzeyyen Bu Derin Bir Tutku,361458,0,361458,2014.csv,2014,0.0,1.0
12387,Polvo,361238,0,361238,2019.csv,2019,0.0,1.0
12388,Law of the Land,361117,0,361117,2017.csv,2017,0.0,1.0
12389,Princess Lost in Time,361028,0,361028,2020.csv,2020,0.0,1.0
12390,The Tobacconist,360996,0,360996,2019.csv,2019,0.0,1.0
12391,True Fiction,360988,0,360988,2018.csv,2018,0.0,1.0
12392,Parents in Progress,360844,0,360844,2019.csv,2019,0.0,1.0
12393,My Little Pony: Equestria Girls - Rainbow Rocks,360736,0,360736,2014.csv,2014,0.0,1.0
12394,Letters to God 2016 Re-release,360653,0,360653,2016.csv,2016,0.0,1.0
12395,Tsoi,360648,0,360648,2020.csv,2020,0.0,1.0
12396,Assassination Classroom,360475,0,360475,2015.csv,2015,0.0,1.0
12397,Dead Bite,360414,0,360414,2011.csv,2011,0.0,1.0
12398,These Final Hours,360234,0,360234,2014.csv,2014,0.0,1.0
12399,Os Saltimbancos Trapalhões: Rumo a Hollywood,360202,0,360202,2017.csv,2017,0.0,1.0
12400,Miss Kiet's Children,360197,0,360197,2016.csv,2016,0.0,1.0
12401,The Confession,360028,0,360028,2011.csv,2011,0.0,1.0
12402,Udta Punjab,359891,0,359891,2016.csv,2016,0.0,1.0
12403,Cinderella the Cat,359833,0,359833,2017.csv,2017,0.0,1.0
12404,Buladó,359807,0,359807,2020.csv,2020,0.0,1.0
12405,Souvenir,359798,11411,348387,2016.csv,2016,0.031715017871138805,0.9682849821288612
12406,Disney Junior HalloVeen Party!,359745,359745,0,2017.csv,2017,1.0,0.0
12407,Happy Ending,359542,313770,45772,2014.csv,2014,0.8726935935161956,0.1273064064838044
12408,K-12,359377,303230,56147,2019.csv,2019,0.8437657390428436,0.15623426095715642
12409,The Greatest 2013 Re-release,359363,0,359363,2013.csv,2013,0.0,1.0
12410,The Pact II,358981,0,358981,2014.csv,2014,0.0,1.0
12411,Sarkar 3,358928,249588,109340,2017.csv,2017,0.695370659296572,0.304629340703428
12412,Penguins,358864,0,358864,2013.csv,2013,0.0,1.0
12413,The Wages of Sin,358786,0,358786,2011.csv,2011,0.0,1.0
12414,Tokyo Fantasy: Sekai no Owari,358657,0,358657,2014.csv,2014,0.0,1.0
12415,Maestro,358616,0,358616,2014.csv,2014,0.0,1.0
12416,Love in Space,358486,34787,323699,2011.csv,2011,0.09703865701868414,0.9029613429813159
12417,Everly,358156,0,358156,2015.csv,2015,0.0,1.0
12418,Bel Canto,358048,125569,232479,2018.csv,2018,0.3507043748324247,0.6492956251675753
12419,Welcome to the Rileys,358014,158898,199116,2010.csv,2010,0.4438318054601217,0.5561681945398783
12420,Mozart's Don Giovanni Juan,357934,0,357934,2011.csv,2011,0.0,1.0
12421,Bears and Lola 2016 Re-release,357712,0,357712,2016.csv,2016,0.0,1.0
12422,Parental Guidance,357193,0,357193,2014.csv,2014,0.0,1.0
12423,La quietud,356237,0,356237,2018.csv,2018,0.0,1.0
12424,Pet Pals in Windland,356152,0,356152,2014.csv,2014,0.0,1.0
12425,Lagenda Budak Setan,356007,0,356007,2012.csv,2012,0.0,1.0
12426,Goodbye Mother,355938,0,355938,2019.csv,2019,0.0,1.0
12427,Bordo Bereliler Suriye,355830,0,355830,2017.csv,2017,0.0,1.0
12428,Karadedeler Olayi,355745,0,355745,2011.csv,2011,0.0,1.0
12429,A Butterfly Kiss,355663,0,355663,2011.csv,2011,0.0,1.0
12430,Working Girls,355614,0,355614,2020.csv,2020,0.0,1.0
12431,Eiga Juerupetto: Suîtsu dansu purinsesu,355395,0,355395,2012.csv,2012,0.0,1.0
12432,My Skinny Sister,355306,0,355306,2015.csv,2015,0.0,1.0
12433,Dark Inclusion,355280,0,355280,2016.csv,2016,0.0,1.0
12434,National Gallery,354971,253941,101030,2014.csv,2014,0.715385200481166,0.28461479951883395
12435,Hello I Must Be Going,354939,106709,248230,2012.csv,2012,0.3006403917292831,0.699359608270717
12436,The Invitation,354835,231737,123098,2016.csv,2016,0.6530838276945623,0.34691617230543775
12437,Hititya Madalyonun Sirri,354805,0,354805,2013.csv,2013,0.0,1.0
12438,Ilusión Nacional,354647,0,354647,2014.csv,2014,0.0,1.0
12439,Kaashmora,354631,327959,26672,2016.csv,2016,0.9247894290121281,0.0752105709878719
12440,"Yalda, a Night for Forgivness",354395,0,354395,2020.csv,2020,0.0,1.0
12441,Las Acacias,354391,6000,348391,2011.csv,2011,0.016930452522778514,0.9830695474772215
12442,Norwegian Ninja,354282,0,354282,2010.csv,2010,0.0,1.0
12443,The Tomorrow Man,354103,354103,0,2019.csv,2019,1.0,0.0
12444,La mia seconda volta,353954,0,353954,2019.csv,2019,0.0,1.0
12445,The Gigolo 2,353914,0,353914,2016.csv,2016,0.0,1.0
12446,Caprice,353885,0,353885,2015.csv,2015,0.0,1.0
12447,A Napoli non piove mai,353855,0,353855,2015.csv,2015,0.0,1.0
12448,This Beautiful Fantastic,353808,0,353808,2016.csv,2016,0.0,1.0
12449,Muj pribeh,353640,0,353640,2019.csv,2019,0.0,1.0
12450,Blade Runner The Final Cut (2015 re-release),353579,0,353579,2015.csv,2015,0.0,1.0
12451,Five Besties: Divorce Busting,353535,0,353535,2016.csv,2016,0.0,1.0
12452,Una cella in due,353508,0,353508,2011.csv,2011,0.0,1.0
12453,Girl$,353367,0,353367,2010.csv,2010,0.0,1.0
12454,The Convent,353326,0,353326,2019.csv,2019,0.0,1.0
12455,Shagird,352861,0,352861,2011.csv,2011,0.0,1.0
12456,Like Dandelion Dust,352810,352810,0,2010.csv,2010,1.0,0.0
12457,Four Warriors,352657,0,352657,2016.csv,2016,0.0,1.0
12458,Trippel Trappel Dierensinterklaas,352618,0,352618,2014.csv,2014,0.0,1.0
12459,Lights Out,352420,0,352420,2010.csv,2010,0.0,1.0
12460,The Bridge Curse,352336,0,352336,2020.csv,2020,0.0,1.0
12461,Butterflies,352082,0,352082,2018.csv,2018,0.0,1.0
12462,Long Strange Trip - The Untold Story of The Grateful Dead,351957,351957,0,2017.csv,2017,1.0,0.0
12463,Over the Edge,351723,0,351723,2012.csv,2012,0.0,1.0
12464,The Octonauts 2016 Re-release,351501,0,351501,2016.csv,2016,0.0,1.0
12465,Ahtta Mamma 3D,351234,0,351234,2011.csv,2011,0.0,1.0
12466,303,351216,0,351216,2018.csv,2018,0.0,1.0
12467,Strikdas,351188,0,351188,2015.csv,2015,0.0,1.0
12468,Come Home,351149,0,351149,2011.csv,2011,0.0,1.0
12469,The Battle of Britain at 75,351087,0,351087,2015.csv,2015,0.0,1.0
12470,Pinocchio 2016 Re-release,351035,0,351035,2016.csv,2016,0.0,1.0
12471,Vendeur,350965,0,350965,2016.csv,2016,0.0,1.0
12472,Sinbad: Pirates of the Seven Storms,350735,0,350735,2016.csv,2016,0.0,1.0
12473,Bitch Hug,350557,0,350557,2012.csv,2012,0.0,1.0
12474,Lethal Kittens,350515,0,350515,2020.csv,2020,0.0,1.0
12475,Chocante,350473,0,350473,2017.csv,2017,0.0,1.0
12476,Holiday,350368,0,350368,2010.csv,2010,0.0,1.0
12477,Tommaso,350367,0,350367,2016.csv,2016,0.0,1.0
12478,Aferim!,350110,108110,242000,2015.csv,2015,0.3087886664191254,0.6912113335808746
12479,Howards End 2016 Re-release,349993,160282,189711,2016.csv,2016,0.45795773058318306,0.5420422694168169
12480,Czech-Made Man,349947,0,349947,2011.csv,2011,0.0,1.0
12481,Tehran Taboo,349886,74758,275128,2017.csv,2017,0.21366387909204712,0.7863361209079529
12482,Military Academy 2,349743,0,349743,2013.csv,2013,0.0,1.0
12483,Direnis Karatay,349208,0,349208,2018.csv,2018,0.0,1.0
12484,Satanic,349183,252,348931,2016.csv,2016,0.0007216846180942371,0.9992783153819058
12485,"Bicicleta, cullera, poma",348880,0,348880,2010.csv,2010,0.0,1.0
12486,Sky Force 3D,348807,0,348807,2013.csv,2013,0.0,1.0
12487,Lovers Vanished,348797,0,348797,2010.csv,2010,0.0,1.0
12488,Apocalypse Now,348787,0,348787,2019.csv,2019,0.0,1.0
12489,Michael Ball & Alfie Boe Back Together,348660,0,348660,2020.csv,2020,0.0,1.0
12490,Jwanita,348441,0,348441,2015.csv,2015,0.0,1.0
12491,Russian Yug,348435,0,348435,2021.csv,2021,0.0,1.0
12492,"Tlatelolco, Verano de 68",348312,0,348312,2013.csv,2013,0.0,1.0
12493,The Valdemar Legacy II: The Forbidden Shadow,348272,0,348272,2011.csv,2011,0.0,1.0
12494,Pawn Shop,348198,0,348198,2013.csv,2013,0.0,1.0
12495,Uzaklarda Arama,347864,0,347864,2015.csv,2015,0.0,1.0
12496,My Salinger Year,347711,54730,292981,2021.csv,2021,0.15740082999962612,0.8425991700003739
12497,Pane e burlesque,347535,0,347535,2014.csv,2014,0.0,1.0
12498,Land of the Bears,347512,0,347512,2014.csv,2014,0.0,1.0
12499,Suicide the Ripple Effect,347468,347468,0,2018.csv,2018,1.0,0.0
12500,First Kill,347295,0,347295,2017.csv,2017,0.0,1.0
12501,Earwig and the Witch,347120,173704,173416,2021.csv,2021,0.5004148421295229,0.4995851578704771
12502,Algjör Sveppi og dularfulla hótelherbergið,347060,0,347060,2010.csv,2010,0.0,1.0
12503,Shadow,346997,0,346997,2010.csv,2010,0.0,1.0
12504,The Good Heart,346851,20930,325921,2010.csv,2010,0.06034291381601898,0.939657086183981
12505,The Vault,346729,5728,341001,2017.csv,2017,0.016520106480853922,0.9834798935191461
12506,Ride,346665,0,346665,2018.csv,2018,0.0,1.0
12507,Open Fire,346515,0,346515,2017.csv,2017,0.0,1.0
12508,Fight Club 2019 Re-release,346322,0,346322,2019.csv,2019,0.0,1.0
12509,Star Trek: The Motion Picture 2019 Re-release,346243,346243,0,2019.csv,2019,1.0,0.0
12510,Superegos,346215,0,346215,2014.csv,2014,0.0,1.0
12511,Don't Tell Me the Boy Was Mad,346154,0,346154,2015.csv,2015,0.0,1.0
12512,"God Exists, Her Name Is Petrunya",346105,0,346105,2019.csv,2019,0.0,1.0
12513,The Taste of Rice Flower,346069,0,346069,2018.csv,2018,0.0,1.0
12514,Sizeless Love,345904,0,345904,2020.csv,2020,0.0,1.0
12515,Triple Threat,345900,76289,269611,2019.csv,2019,0.2205521827117664,0.7794478172882336
12516,Animal Kingdom: Let's go Ape,345636,0,345636,2015.csv,2015,0.0,1.0
12517,Escape Route,345604,0,345604,2016.csv,2016,0.0,1.0
12518,Ghosts of War,345289,0,345289,2020.csv,2020,0.0,1.0
12519,Kabaneri of the Iron Fortress: The Battle of Unato,345066,0,345066,2019.csv,2019,0.0,1.0
12520,Dark Buildings (A Crack in the Wall),344561,0,344561,2018.csv,2018,0.0,1.0
12521,Beauty on Duty,344530,0,344530,2010.csv,2010,0.0,1.0
12522,Supernova,344495,234220,110275,2021.csv,2021,0.6798937575291368,0.32010624247086317
12523,My Horrible Grandma,344437,0,344437,2012.csv,2012,0.0,1.0
12524,Stestí je krásná vec,344395,0,344395,2020.csv,2020,0.0,1.0
12525,Zaman Makinesi 1973,344205,0,344205,2014.csv,2014,0.0,1.0
12526,Geuk-jang-pan Peu-raeng-ki-wa Chin-gu-deul: Saeng-myeong-ui Na-mu,344116,0,344116,2016.csv,2016,0.0,1.0
12527,De tu ventana a la mía,343885,0,343885,2012.csv,2012,0.0,1.0
12528,Il grande salto,343500,0,343500,2019.csv,2019,0.0,1.0
12529,Sommer der Gaukler,343484,0,343484,2011.csv,2011,0.0,1.0
12530,Love is the Word,343477,0,343477,2013.csv,2013,0.0,1.0
12531,Un début prometteur,343419,0,343419,2015.csv,2015,0.0,1.0
12532,Countdown to Canelo vs. Chavez Jr.,343387,343387,0,2017.csv,2017,1.0,0.0
12533,The Giants,343324,0,343324,2011.csv,2011,0.0,1.0
12534,Pekel'na Khorugva Abo Rizdvo Kozatske,343199,0,343199,2020.csv,2020,0.0,1.0
12535,Vulnerables,343138,0,343138,2012.csv,2012,0.0,1.0
12536,El Bulli: Cooking in Progress,343116,237181,105935,2011.csv,2011,0.6912560183727952,0.3087439816272048
12537,"Les aventures de Philibert, capitaine puceau",343113,0,343113,2011.csv,2011,0.0,1.0
12538,12 Chairs,343078,0,343078,2016.csv,2016,0.0,1.0
12539,The Idol,343059,0,343059,2016.csv,2016,0.0,1.0
12540,McDull: Pork of Music,343049,0,343049,2012.csv,2012,0.0,1.0
12541,Strange But True,343038,0,343038,2019.csv,2019,0.0,1.0
12542,Koch,342941,342941,0,2013.csv,2013,1.0,0.0
12543,Carmen & Lola,342699,0,342699,2018.csv,2018,0.0,1.0
12544,"Life, Animated",342664,255388,87276,2016.csv,2016,0.7453015198561856,0.25469848014381435
12545,Çalgi Çengi,342597,0,342597,2011.csv,2011,0.0,1.0
12546,I Kill Giants,342558,0,342558,2018.csv,2018,0.0,1.0
12547,Bone China,342539,0,342539,2019.csv,2019,0.0,1.0
12548,Sputnik,342490,18853,323637,2020.csv,2020,0.055046862682122104,0.9449531373178779
12549,Bolshoi Ballet: Swan Lake,342391,88905,253486,2018.csv,2018,0.25965927842729514,0.7403407215727049
12550,Inside The Boys,342389,0,342389,2018.csv,2018,0.0,1.0
12551,For Love's Sake,342330,0,342330,2012.csv,2012,0.0,1.0
12552,Nureyev: Lifting the Curtain,342255,165203,177052,2018.csv,2018,0.482689807307417,0.517310192692583
12553,Let Him Be a Basketball Player,342040,0,342040,2017.csv,2017,0.0,1.0
12554,Reckless,341998,0,341998,2014.csv,2014,0.0,1.0
12555,Tellement proches 2012 Re-release,341989,0,341989,2012.csv,2012,0.0,1.0
12556,Knife + Heart,341847,32516,309331,2018.csv,2018,0.09511857643916723,0.9048814235608328
12557,Un amor en tiempos de selfies,341796,0,341796,2014.csv,2014,0.0,1.0
12558,Saluda al diablo de mi parte,341779,0,341779,2011.csv,2011,0.0,1.0
12559,The Dirty Picture,341767,0,341767,2011.csv,2011,0.0,1.0
12560,The Humorist,341743,0,341743,2019.csv,2019,0.0,1.0
12561,Encounter Evil,341673,0,341673,2017.csv,2017,0.0,1.0
12562,Roepman,341660,0,341660,2011.csv,2011,0.0,1.0
12563,Feather,341602,0,341602,2016.csv,2016,0.0,1.0
12564,Escape from Planet Earth 2016 Re-release,341546,0,341546,2016.csv,2016,0.0,1.0
12565,Buoni a nulla,341470,0,341470,2014.csv,2014,0.0,1.0
12566,Whitney: Can I Be Me,341402,0,341402,2017.csv,2017,0.0,1.0
12567,Love and Other Troubles,341318,0,341318,2012.csv,2012,0.0,1.0
12568,The Noonday Witch,341202,0,341202,2016.csv,2016,0.0,1.0
12569,Cave,340858,0,340858,2016.csv,2016,0.0,1.0
12570,Star Wars: May the 4th Marathon,340670,0,340670,2014.csv,2014,0.0,1.0
12571,Zahradnictví: Nápadník,340635,0,340635,2017.csv,2017,0.0,1.0
12572,About Endlessness,340471,0,340471,2020.csv,2020,0.0,1.0
12573,Seytan-i Racim 2: Ifrit,340315,0,340315,2015.csv,2015,0.0,1.0
12574,The Great Bear 2013 Re-release,340174,0,340174,2013.csv,2013,0.0,1.0
12575,La vita possibile,340171,0,340171,2016.csv,2016,0.0,1.0
12576,Papa Was Not a Rolling Stone,339958,0,339958,2014.csv,2014,0.0,1.0
12577,SechsKies Eighteen,339931,0,339931,2018.csv,2018,0.0,1.0
12578,Bhoomi,339925,0,339925,2017.csv,2017,0.0,1.0
12579,Love a ru mi rai rak arai mai ru,339678,0,339678,2015.csv,2015,0.0,1.0
12580,Ala Changso,339673,0,339673,2018.csv,2018,0.0,1.0
12581,Blindsided,339525,0,339525,2013.csv,2013,0.0,1.0
12582,Awar Kalb,339487,0,339487,2018.csv,2018,0.0,1.0
12583,Fishtales,339486,0,339486,2017.csv,2017,0.0,1.0
12584,The Lady in the Car with Glasses and a Gun,339461,2167,337294,2015.csv,2015,0.006383649373565741,0.9936163506264343
12585,Watching,339357,0,339357,2019.csv,2019,0.0,1.0
12586,The House of Us,339356,0,339356,2019.csv,2019,0.0,1.0
12587,The Green Prince,339208,258237,80971,2014.csv,2014,0.7612939553312422,0.2387060446687578
12588,Happy People: A Year in the Taiga,338987,338987,0,2013.csv,2013,1.0,0.0
12589,Mamá Ya Crecí,338923,0,338923,2014.csv,2014,0.0,1.0
12590,Kelinka Sabina 2,338873,0,338873,2016.csv,2016,0.0,1.0
12591,Red Hook Summer,338803,338803,0,2012.csv,2012,1.0,0.0
12592,The Music of Silence,338778,0,338778,2018.csv,2018,0.0,1.0
12593,King of Forest,338690,0,338690,2017.csv,2017,0.0,1.0
12594,The Journey Home 2016 Re-release,338690,0,338690,2016.csv,2016,0.0,1.0
12595,Is It Wrong to Try to Pick Up Girls in a Dungeon - Arrow of the Orion,338632,271489,67143,2019.csv,2019,0.80172281414633,0.19827718585367007
12596,Silencio,338596,158723,179873,2018.csv,2018,0.46876808940448206,0.531231910595518
12597,Lousy Bastards,338546,0,338546,2014.csv,2014,0.0,1.0
12598,Vot eto lyubov!,338274,0,338274,2013.csv,2013,0.0,1.0
12599,Bu Son Olsun,338167,0,338167,2012.csv,2012,0.0,1.0
12600,Red Cheongsam,338127,0,338127,2016.csv,2016,0.0,1.0
12601,Laal Kaptaan,338088,0,338088,2019.csv,2019,0.0,1.0
12602,Hans Zimmer: Live in Prague,338043,0,338043,2017.csv,2017,0.0,1.0
12603,Porco Rosso 2010 Re-release,337951,0,337951,2010.csv,2010,0.0,1.0
12604,Fight for Love,337786,0,337786,2017.csv,2017,0.0,1.0
12605,Detention Letter,337770,0,337770,2017.csv,2017,0.0,1.0
12606,Ice Mother,337553,0,337553,2017.csv,2017,0.0,1.0
12607,The Haunted Graduation Photo 2,337323,0,337323,2017.csv,2017,0.0,1.0
12608,Dark Horse,337150,166228,170922,2012.csv,2012,0.4930387068070592,0.5069612931929408
12609,Laavan Phere,337086,0,337086,2018.csv,2018,0.0,1.0
12610,Voyage of Time: The IMAX Experience,337038,55409,281629,2016.csv,2016,0.16439985995644407,0.8356001400435559
12611,24,336771,0,336771,2016.csv,2016,0.0,1.0
12612,Barbara,336491,0,336491,2013.csv,2013,0.0,1.0
12613,Howl 2015 Re-release,336420,0,336420,2015.csv,2015,0.0,1.0
12614,Kings of Pastry,336386,336386,0,2010.csv,2010,1.0,0.0
12615,Foxter & Max,336334,0,336334,2019.csv,2019,0.0,1.0
12616,Diane,336166,336166,0,2019.csv,2019,1.0,0.0
12617,Sailor Moon R: The Movie: The Promise of the Rose/Sailor Moon S: The Movie - Hearts in Ice,335697,335697,0,2018.csv,2018,1.0,0.0
12618,Heaven and Hell,335642,0,335642,2012.csv,2012,0.0,1.0
12619,Igazából apa,335590,0,335590,2010.csv,2010,0.0,1.0
12620,The Devil's Scarab,335164,0,335164,2016.csv,2016,0.0,1.0
12621,Freaks,335050,276591,58459,2019.csv,2019,0.8255215639456798,0.17447843605432026
12622,Russ Taff: I Still Believe,334983,334983,0,2018.csv,2018,1.0,0.0
12623,Bhavesh Joshi Superhero,334723,57376,277347,2018.csv,2018,0.1714133776286661,0.828586622371334
12624,When a Tree Falls,334715,0,334715,2015.csv,2015,0.0,1.0
12625,Des lendemains qui chantent,334515,0,334515,2014.csv,2014,0.0,1.0
12626,Anthropocene: The Human Epoch,334162,104806,229356,2019.csv,2019,0.3136382951981374,0.6863617048018625
12627,Als wir träumten,334069,0,334069,2015.csv,2015,0.0,1.0
12628,The Emperor's New Groove 2021 Re-release,334000,334000,0,2021.csv,2021,1.0,0.0
12629,A Silent Voice: The Movie 2019 Re-release,333984,333984,0,2019.csv,2019,1.0,0.0
12630,La profezia dell'armadillo,333955,0,333955,2018.csv,2018,0.0,1.0
12631,Çakal,333857,0,333857,2010.csv,2010,0.0,1.0
12632,10 000 timmar,333749,0,333749,2014.csv,2014,0.0,1.0
12633,Iskateli priklyucheniy,333696,0,333696,2012.csv,2012,0.0,1.0
12634,Marriage Story,333686,0,333686,2019.csv,2019,0.0,1.0
12635,Kuklali Kösk,333631,0,333631,2019.csv,2019,0.0,1.0
12636,Ballet 422,333554,333554,0,2015.csv,2015,1.0,0.0
12637,Slim & I,333432,0,333432,2020.csv,2020,0.0,1.0
12638,Shine,333388,333388,0,2018.csv,2018,1.0,0.0
12639,Something from Nothing: The Art of Rap,333388,288000,45388,2012.csv,2012,0.8638583272343335,0.13614167276566644
12640,I Am Eleven,333355,0,333355,2012.csv,2012,0.0,1.0
12641,Hollywood in my Huis,333327,0,333327,2015.csv,2015,0.0,1.0
12642,HAIKYU!! The Winner and the Loser,333148,0,333148,2016.csv,2016,0.0,1.0
12643,Linsanity,332990,302645,30345,2013.csv,2013,0.9088711372713896,0.09112886272861047
12644,20 Cigarettes,332955,0,332955,2010.csv,2010,0.0,1.0
12645,Fun Mom Dinner,332886,0,332886,2017.csv,2017,0.0,1.0
12646,10 Minutes Gone,332731,0,332731,2019.csv,2019,0.0,1.0
12647,Host,332673,0,332673,2020.csv,2020,0.0,1.0
12648,Youth Dinner,332596,0,332596,2017.csv,2017,0.0,1.0
12649,Don't Hang Up,332571,0,332571,2017.csv,2017,0.0,1.0
12650,The Way to Live,332551,0,332551,2011.csv,2011,0.0,1.0
12651,Redirected,332537,0,332537,2014.csv,2014,0.0,1.0
12652,Her Sey Seninle Güzel,332480,0,332480,2018.csv,2018,0.0,1.0
12653,Deja Vu,332446,0,332446,2018.csv,2018,0.0,1.0
12654,Delisin Delisin,332401,0,332401,2014.csv,2014,0.0,1.0
12655,The Ultimate Winner,332363,0,332363,2011.csv,2011,0.0,1.0
12656,Kurt Josef Wagle og legenden om Fjordheksa,332292,0,332292,2010.csv,2010,0.0,1.0
12657,C'è tempo,332266,0,332266,2019.csv,2019,0.0,1.0
12658,Rita & Crocodile,332261,0,332261,2018.csv,2018,0.0,1.0
12659,Volcano 2013 Re-release,332179,0,332179,2013.csv,2013,0.0,1.0
12660,Shores of Hope,332059,0,332059,2012.csv,2012,0.0,1.0
12661,Midnight Soul Road,332041,0,332041,2017.csv,2017,0.0,1.0
12662,The Beautiful Lie,331844,0,331844,2018.csv,2018,0.0,1.0
12663,Shamitabh,331821,324597,7224,2015.csv,2015,0.9782292259983545,0.021770774001645465
12664,Eureka Seven Hi-Evolution: Anemone,331737,0,331737,2018.csv,2018,0.0,1.0
12665,The Blue Elephant 2014 Re-release,331717,0,331717,2014.csv,2014,0.0,1.0
12666,Welcome Home,331704,0,331704,2018.csv,2018,0.0,1.0
12667,Scary Notes,331519,0,331519,2016.csv,2016,0.0,1.0
12668,A Drop of the Grapevine,331346,0,331346,2014.csv,2014,0.0,1.0
12669,Litus.,331343,0,331343,2019.csv,2019,0.0,1.0
12670,Blinky Bill the Movie 2018 Re-release,331341,0,331341,2018.csv,2018,0.0,1.0
12671,Pilecki,331263,0,331263,2015.csv,2015,0.0,1.0
12672,Poilsiautojai: pavydo zaidynes,331201,0,331201,2017.csv,2017,0.0,1.0
12673,Occupation: Rainfall,331091,0,331091,2021.csv,2021,0.0,1.0
12674,Jawani Phir Nahi Ani 2,331048,0,331048,2018.csv,2018,0.0,1.0
12675,3688,330980,0,330980,2015.csv,2015,0.0,1.0
12676,A March to Remember,330735,0,330735,2019.csv,2019,0.0,1.0
12677,Maria Wern: Inte ens det förflutna,330432,0,330432,2012.csv,2012,0.0,1.0
12678,Return to Montauk,330267,0,330267,2017.csv,2017,0.0,1.0
12679,Disco Singh,330226,0,330226,2014.csv,2014,0.0,1.0
12680,Kogus akademisi,330066,0,330066,2013.csv,2013,0.0,1.0
12681,"Paolo Conte, via con me",330052,0,330052,2020.csv,2020,0.0,1.0
12682,Gambler Husband Vs. Gambler Wife 2013 Re-release,330000,0,330000,2013.csv,2013,0.0,1.0
12683,Garbage Prince,329613,0,329613,2011.csv,2011,0.0,1.0
12684,Portrait of Beauty,329612,0,329612,2019.csv,2019,0.0,1.0
12685,Money and Love,329555,0,329555,2016.csv,2016,0.0,1.0
12686,Velke dobrodruzstvi Ctyrlistku,329549,0,329549,2019.csv,2019,0.0,1.0
12687,Long Moonlight,329488,0,329488,2011.csv,2011,0.0,1.0
12688,King of Triads,329456,0,329456,2010.csv,2010,0.0,1.0
12689,Acid,329405,0,329405,2018.csv,2018,0.0,1.0
12690,Don Pasquale,329400,0,329400,2019.csv,2019,0.0,1.0
12691,Ghost Graduation 2013 Re-release,329397,0,329397,2013.csv,2013,0.0,1.0
12692,Malacopa,329285,0,329285,2018.csv,2018,0.0,1.0
12693,Sermon on the Mount,329199,0,329199,2017.csv,2017,0.0,1.0
12694,Zun Yi Conference,329103,0,329103,2016.csv,2016,0.0,1.0
12695,The Big Fight Live: IBF Welterweight Title: Errol Spence Jr. vs. Mikey Garcia,328979,328979,0,2019.csv,2019,1.0,0.0
12696,Mel Karade Rabba,328887,0,328887,2010.csv,2010,0.0,1.0
12697,Ladies vs. Ricky Bahl,328870,0,328870,2011.csv,2011,0.0,1.0
12698,The Legend of 1900 2020 Re-release,328821,0,328821,2020.csv,2020,0.0,1.0
12699,Get Her... If You Can,328789,0,328789,2019.csv,2019,0.0,1.0
12700,Kolbøttefabrikken,328487,0,328487,2014.csv,2014,0.0,1.0
12701,Det grå guld,328116,0,328116,2013.csv,2013,0.0,1.0
12702,Limonata,328039,0,328039,2015.csv,2015,0.0,1.0
12703,The Last Sentence,328005,62506,265499,2012.csv,2012,0.19056416822914285,0.8094358317708572
12704,GOLD,327919,0,327919,2018.csv,2018,0.0,1.0
12705,Spud 3: Learning to Fly,327791,0,327791,2014.csv,2014,0.0,1.0
12706,Rumbos,327747,0,327747,2016.csv,2016,0.0,1.0
12707,Hip Hop-eration,327534,0,327534,2014.csv,2014,0.0,1.0
12708,Plot 35,327453,0,327453,2017.csv,2017,0.0,1.0
12709,Elaine Stritch: Shoot Me,327452,327452,0,2014.csv,2014,1.0,0.0
12710,First Kiss,327436,0,327436,2012.csv,2012,0.0,1.0
12711,"Loving You, Loving Me",327426,0,327426,2011.csv,2011,0.0,1.0
12712,#Anne Frank Parallel Stories,327285,0,327285,2019.csv,2019,0.0,1.0
12713,The Eternal Life of Alexander Christoforov,327101,0,327101,2018.csv,2018,0.0,1.0
12714,Sinbad and Mermaid Princess,326961,0,326961,2017.csv,2017,0.0,1.0
12715,Heartstone,326736,0,326736,2017.csv,2017,0.0,1.0
12716,El-Ablah Tam-Tam,326685,0,326685,2018.csv,2018,0.0,1.0
12717,Susters,326415,0,326415,2018.csv,2018,0.0,1.0
12718,Ko,326238,0,326238,2011.csv,2011,0.0,1.0
12719,Masha and the Bear: Bolshoe puteshestvie,326179,0,326179,2020.csv,2020,0.0,1.0
12720,Can't See Me Love You,326131,0,326131,2018.csv,2018,0.0,1.0
12721,You Will Be My Son 2012 Re-release,326061,285151,40910,2012.csv,2012,0.8745326794679523,0.12546732053204768
12722,Formosa Betrayed,326034,225341,100693,2010.csv,2010,0.6911579773888613,0.3088420226111387
12723,Lucy in the Sky,325950,319976,5974,2019.csv,2019,0.9816720355882804,0.018327964411719588
12724,Na uklady nie ma rady,325906,0,325906,2017.csv,2017,0.0,1.0
12725,"Yo soy así, Tita de Buenos Aires",325785,0,325785,2017.csv,2017,0.0,1.0
12726,Open Seas,325661,0,325661,2018.csv,2018,0.0,1.0
12727,The Central Park Five,325653,325653,0,2012.csv,2012,1.0,0.0
12728,Copperman,325638,0,325638,2019.csv,2019,0.0,1.0
12729,Obedience,325632,0,325632,2016.csv,2016,0.0,1.0
12730,Crimi Clowns: De Movie,325532,0,325532,2013.csv,2013,0.0,1.0
12731,Rock and Roll '68,325367,0,325367,2013.csv,2013,0.0,1.0
12732,The Opera House,325235,320079,5156,2018.csv,2018,0.9841468476639968,0.015853152336003196
12733,Lotte and the Moonstone Secret 2012 Re-release,325151,0,325151,2012.csv,2012,0.0,1.0
12734,Camp,324977,324977,0,2013.csv,2013,1.0,0.0
12735,Juan of the Dead,324834,18000,306834,2012.csv,2012,0.05541291859842258,0.9445870814015774
12736,Invisible Evidence,324791,0,324791,2020.csv,2020,0.0,1.0
12737,Así es la suerte 2011 Re-release,324648,0,324648,2011.csv,2011,0.0,1.0
12738,Teefa In Trouble,324633,0,324633,2018.csv,2018,0.0,1.0
12739,Another Life,324599,0,324599,2014.csv,2014,0.0,1.0
12740,Der Blunzenkönig,324598,0,324598,2015.csv,2015,0.0,1.0
12741,The Adventures of Jurassic Pet: Chapter 1,324444,0,324444,2019.csv,2019,0.0,1.0
12742,My Sweet Pepper Land,324440,0,324440,2014.csv,2014,0.0,1.0
12743,Jabariya Jodi,324435,0,324435,2019.csv,2019,0.0,1.0
12744,Red Hill,324424,21087,303337,2010.csv,2010,0.06499827386383251,0.9350017261361675
12745,First Time,324263,0,324263,2012.csv,2012,0.0,1.0
12746,Eski köye yeni adet,324242,0,324242,2018.csv,2018,0.0,1.0
12747,Memento 2020 Re-release,323982,0,323982,2020.csv,2020,0.0,1.0
12748,Hey Bro,323930,0,323930,2015.csv,2015,0.0,1.0
12749,The Bolshoi Ballet: Live From Moscow - The Nutcracker,323928,323928,0,2018.csv,2018,1.0,0.0
12750,Belle comme la femme d'un autre,323832,0,323832,2014.csv,2014,0.0,1.0
12751,7 jours pas plus,323784,0,323784,2017.csv,2017,0.0,1.0
12752,The Cured,323776,26630,297146,2018.csv,2018,0.08224822099229097,0.917751779007709
12753,The Poison Rose,323754,0,323754,2019.csv,2019,0.0,1.0
12754,Three Worlds,323748,3952,319796,2012.csv,2012,0.012207025217144198,0.9877929747828558
12755,Sword of Trust,323369,322421,948,2019.csv,2019,0.9970683646236962,0.002931635376303851
12756,A mano disarmata,323244,0,323244,2019.csv,2019,0.0,1.0
12757,Damsel,323235,305136,18099,2018.csv,2018,0.944006682444661,0.055993317555339
12758,Dutch,323167,323167,0,2021.csv,2021,1.0,0.0
12759,Ilk Opucuk,323134,0,323134,2017.csv,2017,0.0,1.0
12760,Citizen Jane: Battle for the City,323124,313411,9713,2017.csv,2017,0.9699403325039304,0.03005966749606962
12761,Azmah Maliah,323017,0,323017,2020.csv,2020,0.0,1.0
12762,Sin memoria,322748,0,322748,2011.csv,2011,0.0,1.0
12763,Do You Love Me As I Love You,322594,0,322594,2020.csv,2020,0.0,1.0
12764,Za niebieskimi drzwiami,322593,0,322593,2016.csv,2016,0.0,1.0
12765,Jawazat Mary,322529,0,322529,2014.csv,2014,0.0,1.0
12766,The Day He Arrives,322348,13746,308602,2011.csv,2011,0.042643354387184036,0.957356645612816
12767,The Self Portrait,322339,0,322339,2020.csv,2020,0.0,1.0
12768,A Secret Between Us,322334,0,322334,2013.csv,2013,0.0,1.0
12769,Ghoul,322173,0,322173,2014.csv,2014,0.0,1.0
12770,Insomnia Lover,322075,0,322075,2016.csv,2016,0.0,1.0
12771,The Land of Oz,322067,0,322067,2015.csv,2015,0.0,1.0
12772,Catch the Wind,322016,0,322016,2017.csv,2017,0.0,1.0
12773,Achille Tarallo,321986,0,321986,2018.csv,2018,0.0,1.0
12774,Permanent Nobara,321914,0,321914,2010.csv,2010,0.0,1.0
12775,Nocturama,321768,30157,291611,2016.csv,2016,0.09372280649411999,0.90627719350588
12776,The River in Me,321704,0,321704,2019.csv,2019,0.0,1.0
12777,The Trust,321650,0,321650,2016.csv,2016,0.0,1.0
12778,Mulheres Alteradas,321555,0,321555,2018.csv,2018,0.0,1.0
12779,Against the Devil,321551,0,321551,2020.csv,2020,0.0,1.0
12780,Paraíso perdido,321528,0,321528,2016.csv,2016,0.0,1.0
12781,Redcon-1,321492,0,321492,2018.csv,2018,0.0,1.0
12782,SüperTürk,321423,0,321423,2012.csv,2012,0.0,1.0
12783,The Colony,321248,0,321248,2013.csv,2013,0.0,1.0
12784,Denis,321140,0,321140,2013.csv,2013,0.0,1.0
12785,Double Trouble,321081,44788,276293,2012.csv,2012,0.13949128101631675,0.8605087189836832
12786,Saamy Square,321072,0,321072,2018.csv,2018,0.0,1.0
12787,Green Days,320868,0,320868,2011.csv,2011,0.0,1.0
12788,Acts of Vengeance,320705,0,320705,2017.csv,2017,0.0,1.0
12789,Woodstock,320610,126562,194048,2019.csv,2019,0.39475375066279905,0.605246249337201
12790,A Film Unfinished,320486,320486,0,2010.csv,2010,1.0,0.0
12791,Sub khu ku lok,320411,0,320411,2012.csv,2012,0.0,1.0
12792,Geetha Govindam,320366,0,320366,2018.csv,2018,0.0,1.0
12793,Circle of Atonement,320315,0,320315,2015.csv,2015,0.0,1.0
12794,Il grande spirito,320035,0,320035,2019.csv,2019,0.0,1.0
12795,The English Teacher,320013,104810,215203,2013.csv,2013,0.3275179445835013,0.6724820554164987
12796,Black Mirror,320000,0,320000,2013.csv,2013,0.0,1.0
12797,Deception of the Novelist,319674,0,319674,2019.csv,2019,0.0,1.0
12798,Beats,319595,0,319595,2019.csv,2019,0.0,1.0
12799,Negociador,319362,0,319362,2015.csv,2015,0.0,1.0
12800,Cin Kuyusu,319360,0,319360,2015.csv,2015,0.0,1.0
12801,Operazione vacanze,319265,0,319265,2012.csv,2012,0.0,1.0
12802,Hy Sinh Doi Trai,319246,0,319246,2015.csv,2015,0.0,1.0
12803,Zahradnictví: Dezertér,319237,0,319237,2017.csv,2017,0.0,1.0
12804,Meeting Gorbachev,319230,251837,67393,2019.csv,2019,0.7888888888888889,0.2111111111111111
12805,Elena 2015 Re-release,319223,0,319223,2015.csv,2015,0.0,1.0
12806,Chubby,319152,0,319152,2014.csv,2014,0.0,1.0
12807,Dive Olly Dive and the Pirate Treasure,318928,0,318928,2014.csv,2014,0.0,1.0
12808,You Are Here: A Come From Away Story,318885,318885,0,2019.csv,2019,1.0,0.0
12809,Around the World with Peppa,318674,0,318674,2016.csv,2016,0.0,1.0
12810,Thillalangadi,318633,0,318633,2010.csv,2010,0.0,1.0
12811,The Yellow Handkerchief,318623,318623,0,2010.csv,2010,1.0,0.0
12812,Happy Little Submarine: 20000 Leagues under the Sea 2019 Re-release,318567,0,318567,2019.csv,2019,0.0,1.0
12813,Elastic,318547,0,318547,2016.csv,2016,0.0,1.0
12814,The Little Penguin Pororo's Racing Adventure 2014 Re-release,318502,0,318502,2014.csv,2014,0.0,1.0
12815,Hangman's Game,318438,0,318438,2017.csv,2017,0.0,1.0
12816,West of Memphis,318317,310154,8163,2012.csv,2012,0.9743557522846722,0.025644247715327802
12817,Ask Dr. Ruth,318230,297195,21035,2019.csv,2019,0.9339000094271439,0.06609999057285611
12818,Baskin,318155,0,318155,2016.csv,2016,0.0,1.0
12819,The Student,318123,1126,316997,2016.csv,2016,0.003539511446830314,0.9964604885531697
12820,Not Today,318121,318121,0,2013.csv,2013,1.0,0.0
12821,Bekikang: Ang nanay kong beki,318095,0,318095,2013.csv,2013,0.0,1.0
12822,Today's Special,317831,317831,0,2010.csv,2010,1.0,0.0
12823,Eliminators,317827,0,317827,2017.csv,2017,0.0,1.0
12824,Domino,317776,0,317776,2019.csv,2019,0.0,1.0
12825,Inch'Allah,317656,9840,307816,2013.csv,2013,0.030976905835243155,0.9690230941647568
12826,Okko's Inn,317547,134787,182760,2018.csv,2018,0.42446315033680054,0.5755368496631995
12827,My Little Monster 2019 Re-release,317538,0,317538,2019.csv,2019,0.0,1.0
12828,Sauvage / Wild,317536,61604,255932,2018.csv,2018,0.19400634888642548,0.8059936511135746
12829,Joomoonjin,317433,0,317433,2010.csv,2010,0.0,1.0
12830,Günah Keçisi,317411,0,317411,2011.csv,2011,0.0,1.0
12831,A Thief's Daughter,317244,0,317244,2019.csv,2019,0.0,1.0
12832,The Island Inside,317155,0,317155,2010.csv,2010,0.0,1.0
12833,The Third Wish,317055,0,317055,2017.csv,2017,0.0,1.0
12834,6 Days,316946,0,316946,2017.csv,2017,0.0,1.0
12835,5 Days of War,316944,17479,299465,2011.csv,2011,0.05514854359129689,0.9448514564087032
12836,Still 2,316815,0,316815,2014.csv,2014,0.0,1.0
12837,Tasha Tudor: A Still Water Story,316753,0,316753,2018.csv,2018,0.0,1.0
12838,San Martín: El cruce de Los Andes,316613,0,316613,2011.csv,2011,0.0,1.0
12839,AmeriGeddon,316554,316554,0,2016.csv,2016,1.0,0.0
12840,To Love or Not to Love,316528,0,316528,2017.csv,2017,0.0,1.0
12841,Corpo Celeste 2011 Re-release,316504,8919,307585,2011.csv,2011,0.028179738644693274,0.9718202613553067
12842,Cantantes en Guerra,316478,0,316478,2017.csv,2017,0.0,1.0
12843,A Unicorn Adventure,316358,0,316358,2017.csv,2017,0.0,1.0
12844,December tale or S.Mykolay's Adventures,316210,0,316210,2018.csv,2018,0.0,1.0
12845,El cartel de la papa,316201,0,316201,2015.csv,2015,0.0,1.0
12846,How Strange to Be Named Federico,316137,0,316137,2013.csv,2013,0.0,1.0
12847,The Riot and the Dance,316103,316103,0,2018.csv,2018,1.0,0.0
12848,David and Goliath,316100,316100,0,2015.csv,2015,1.0,0.0
12849,Soledad y Larguirucho,315938,0,315938,2012.csv,2012,0.0,1.0
12850,Rock Marí,315909,0,315909,2010.csv,2010,0.0,1.0
12851,Un amor,315805,0,315805,2011.csv,2011,0.0,1.0
12852,The Tree of Blood,315750,0,315750,2018.csv,2018,0.0,1.0
12853,Royal Shakespeare Company: The Taming of the Shrew,315238,0,315238,2019.csv,2019,0.0,1.0
12854,Josh Groban Bridges Live from Madison Square Garden,315173,315173,0,2019.csv,2019,1.0,0.0
12855,Message from the King,315132,0,315132,2017.csv,2017,0.0,1.0
12856,Easy,315081,0,315081,2017.csv,2017,0.0,1.0
12857,Las Caras del Diablo,315079,0,315079,2010.csv,2010,0.0,1.0
12858,Obit.,315049,315049,0,2017.csv,2017,1.0,0.0
12859,A esmorga,315047,0,315047,2014.csv,2014,0.0,1.0
12860,Hochzeitspolka,314997,0,314997,2010.csv,2010,0.0,1.0
12861,Love Lasts Three Years 2014 Re-release,314901,0,314901,2014.csv,2014,0.0,1.0
12862,The Express,314854,0,314854,2018.csv,2018,0.0,1.0
12863,Dead Awake 2017 Re-release,314791,0,314791,2017.csv,2017,0.0,1.0
12864,Amnestie,314774,0,314774,2019.csv,2019,0.0,1.0
12865,Chiaohu and the Mother Tree,314667,0,314667,2016.csv,2016,0.0,1.0
12866,Tell No One,314543,0,314543,2012.csv,2012,0.0,1.0
12867,N'apcaz simdi?,314240,0,314240,2012.csv,2012,0.0,1.0
12868,Fuck Up,314224,0,314224,2012.csv,2012,0.0,1.0
12869,Time Out of Mind,314082,166775,147307,2015.csv,2015,0.5309919065721691,0.46900809342783095
12870,Aya of Yop City,314047,0,314047,2013.csv,2013,0.0,1.0
12871,Faber in Sardegna & L'ultimo concerto di Fabrizio De André,313989,0,313989,2015.csv,2015,0.0,1.0
12872,Where is the Township,313957,0,313957,2017.csv,2017,0.0,1.0
12873,Sickos,313837,0,313837,2014.csv,2014,0.0,1.0
12874,Wonderland,313808,0,313808,2017.csv,2017,0.0,1.0
12875,Persona non grata,313797,0,313797,2019.csv,2019,0.0,1.0
12876,Hidden 2012 Re-release,313768,0,313768,2012.csv,2012,0.0,1.0
12877,Children Gone to Poland,313600,0,313600,2018.csv,2018,0.0,1.0
12878,Robinson Crusoe ve Cuma,313567,0,313567,2015.csv,2015,0.0,1.0
12879,Rakshadhikari Baiju Oppu,313486,0,313486,2017.csv,2017,0.0,1.0
12880,Christine,313465,298525,14940,2016.csv,2016,0.9523391766225895,0.04766082337741056
12881,War Witch,313387,70544,242843,2012.csv,2012,0.22510187084977998,0.77489812915022
12882,Zhgi!,313100,0,313100,2017.csv,2017,0.0,1.0
12883,The Bolshoi Ballet: Live From Moscow - Romeo and Juliet,313088,313088,0,2018.csv,2018,1.0,0.0
12884,Gaturro 2012 Re-release,312939,0,312939,2012.csv,2012,0.0,1.0
12885,Berberian Sound Studio,312757,38493,274264,2012.csv,2012,0.1230763819834568,0.8769236180165432
12886,The Hornet's Nest,312706,312706,0,2014.csv,2014,1.0,0.0
12887,Black Sea 2016 Re-release,312686,0,312686,2016.csv,2016,0.0,1.0
12888,Fair Play,312678,0,312678,2014.csv,2014,0.0,1.0
12889,The Woodsman and the Rain,312542,0,312542,2012.csv,2012,0.0,1.0
12890,Pretty Princess,312295,0,312295,2018.csv,2018,0.0,1.0
12891,Will It Snow for Christmas? 2011 Re-release,312189,0,312189,2011.csv,2011,0.0,1.0
12892,Dreamland,312052,0,312052,2020.csv,2020,0.0,1.0
12893,Old Beast,311678,0,311678,2017.csv,2017,0.0,1.0
12894,Zulu Wedding,311640,0,311640,2019.csv,2019,0.0,1.0
12895,Nightmare of Darkness,311586,0,311586,2018.csv,2018,0.0,1.0
12896,Yeu La Phai Xai Chieu,311481,0,311481,2016.csv,2016,0.0,1.0
12897,David Lynch: The Art Life,311470,171419,140051,2017.csv,2017,0.5503547693196776,0.44964523068032236
12898,Oldies But Goldies,311280,0,311280,2012.csv,2012,0.0,1.0
12899,Plácido Domingo Gala,311246,52502,258744,2019.csv,2019,0.16868329231540324,0.8313167076845968
12900,Kill Zombie!,311245,0,311245,2012.csv,2012,0.0,1.0
12901,Südafrika: Der Kinofilm,311092,0,311092,2016.csv,2016,0.0,1.0
12902,Dancing in Jaffa,311001,151098,159903,2014.csv,2014,0.48584409696431846,0.5141559030356816
12903,Being Elmo: A Puppeteer's Journey,310812,304052,6760,2011.csv,2011,0.9782505179980181,0.021749482001981905
12904,Indivisible,310797,0,310797,2016.csv,2016,0.0,1.0
12905,October,310320,0,310320,2018.csv,2018,0.0,1.0
12906,Kobiety bez wstydu,310297,0,310297,2016.csv,2016,0.0,1.0
12907,My Family and the Wolf,310286,0,310286,2019.csv,2019,0.0,1.0
12908,I Am Eleven 2014 Re-release,310116,310116,0,2014.csv,2014,1.0,0.0
12909,I Do Bidoo Bidoo: Heto nApo sila!,310020,0,310020,2012.csv,2012,0.0,1.0
12910,Wolf,310005,0,310005,2013.csv,2013,0.0,1.0
12911,Krasotka!,309966,0,309966,2020.csv,2020,0.0,1.0
12912,Lord of the Dance in 3D,309951,0,309951,2011.csv,2011,0.0,1.0
12913,Kanashimi no wasurekata: Documentary of Nogizaka 46,309932,0,309932,2015.csv,2015,0.0,1.0
12914,New Perfect Two,309845,0,309845,2012.csv,2012,0.0,1.0
12915,Learn by Heart,309597,0,309597,2015.csv,2015,0.0,1.0
12916,Klumpfisken,309587,0,309587,2014.csv,2014,0.0,1.0
12917,Dendera,309509,0,309509,2011.csv,2011,0.0,1.0
12918,Un Papá Pirata,309505,0,309505,2019.csv,2019,0.0,1.0
12919,Tueurs,309477,0,309477,2017.csv,2017,0.0,1.0
12920,Haraamkhor,309264,0,309264,2017.csv,2017,0.0,1.0
12921,Kala Shah Kala,309199,0,309199,2019.csv,2019,0.0,1.0
12922,Masterpiece Mystery: Dalgliesh: Cover Her Face 2,308903,0,308903,2016.csv,2016,0.0,1.0
12923,CIA: Comrade in America,308850,0,308850,2017.csv,2017,0.0,1.0
12924,Peter Pan: The Quest for the Never Book,308834,0,308834,2018.csv,2018,0.0,1.0
12925,Angus Buchan's Ordinary People,308745,0,308745,2012.csv,2012,0.0,1.0
12926,Mieletön elokuu,308745,0,308745,2013.csv,2013,0.0,1.0
12927,Darbareye Elly,308667,0,308667,2010.csv,2010,0.0,1.0
12928,Caleuche: El llamado del Mar,308429,0,308429,2012.csv,2012,0.0,1.0
12929,The Amazing Catfish,308349,11342,297007,2014.csv,2014,0.03678299589101959,0.9632170041089804
12930,"The First, the Last",308276,0,308276,2016.csv,2016,0.0,1.0
12931,"Psychomagic, A Healing Art",308233,0,308233,2019.csv,2019,0.0,1.0
12932,Dream Team,308225,0,308225,2019.csv,2019,0.0,1.0
12933,A Wedding on the Execution Ground,308216,0,308216,2019.csv,2019,0.0,1.0
12934,Merchants of Doubt,308156,308156,0,2015.csv,2015,1.0,0.0
12935,Our Patriots,308121,0,308121,2017.csv,2017,0.0,1.0
12936,A Esperança é a Última que Morre,307804,0,307804,2015.csv,2015,0.0,1.0
12937,Gelecekten Bir Gün,307782,0,307782,2010.csv,2010,0.0,1.0
12938,Bolts & Blip: Battle of the Lunar League,307723,0,307723,2012.csv,2012,0.0,1.0
12939,The Metropolitan Opera HD Live: MET Opera: Magic Flute,307686,307686,0,2018.csv,2018,1.0,0.0
12940,The 33D Invader,307575,0,307575,2011.csv,2011,0.0,1.0
12941,The Lord of the Rings: The Return of the King 2017 Re-release,307481,0,307481,2017.csv,2017,0.0,1.0
12942,Zustrich odnoklasnykiv,307242,0,307242,2019.csv,2019,0.0,1.0
12943,Na Baykal,307200,0,307200,2012.csv,2012,0.0,1.0
12944,Planeta Cesko,307057,0,307057,2018.csv,2018,0.0,1.0
12945,High Society,307025,0,307025,2014.csv,2014,0.0,1.0
12946,The Easy Way Out,307017,0,307017,2015.csv,2015,0.0,1.0
12947,Garo the Movie: Red Requiem,307016,0,307016,2010.csv,2010,0.0,1.0
12948,"Robbi, Tobbi und das Fliewatüüt",306688,0,306688,2016.csv,2016,0.0,1.0
12949,Mrs Right Guy,306636,0,306636,2016.csv,2016,0.0,1.0
12950,Linglong Wells,306411,0,306411,2018.csv,2018,0.0,1.0
12951,Half of a Yellow Sun,306393,54529,251864,2014.csv,2014,0.17797077609475412,0.8220292239052459
12952,The Mercy 2018 Re-release,306205,29538,276667,2018.csv,2018,0.09646478666253,0.90353521333747
12953,Monsters: Dark Continent,306004,0,306004,2015.csv,2015,0.0,1.0
12954,Under the Sun,305993,105036,200957,2016.csv,2016,0.3432627543767341,0.6567372456232659
12955,Çok Uzak Fazla Yakin,305969,0,305969,2016.csv,2016,0.0,1.0
12956,The Eyes Diary,305876,0,305876,2014.csv,2014,0.0,1.0
12957,Back to the 90s,305757,0,305757,2015.csv,2015,0.0,1.0
12958,The Third Wife,305755,84933,220822,2019.csv,2019,0.27778123006982713,0.7222187699301729
12959,Les papas du dimanche,305738,0,305738,2012.csv,2012,0.0,1.0
12960,My Kontrabida Girl,305718,0,305718,2012.csv,2012,0.0,1.0
12961,4 Kings,305295,0,305295,2014.csv,2014,0.0,1.0
12962,Hajwala 2,305114,0,305114,2018.csv,2018,0.0,1.0
12963,Purani Jeans,305113,0,305113,2014.csv,2014,0.0,1.0
12964,Holy Lands,304998,0,304998,2018.csv,2018,0.0,1.0
12965,Amar no es querer,304991,0,304991,2011.csv,2011,0.0,1.0
12966,The Visitor 2011 Re-release,304902,0,304902,2011.csv,2011,0.0,1.0
12967,Memoria de mis putas tristes,304877,0,304877,2012.csv,2012,0.0,1.0
12968,The Kingmaker,304840,122587,182253,2019.csv,2019,0.4021355465162052,0.5978644534837948
12969,Un Français,304761,0,304761,2015.csv,2015,0.0,1.0
12970,This Is England 2011 Re-release,304710,0,304710,2011.csv,2011,0.0,1.0
12971,Showtime Championship Boxing: Deontay Wilder vs. Tyson Fury,304482,304482,0,2018.csv,2018,1.0,0.0
12972,L'endemà,304384,0,304384,2014.csv,2014,0.0,1.0
12973,Goodbye Mama,304151,0,304151,2011.csv,2011,0.0,1.0
12974,Attila,303997,0,303997,2020.csv,2020,0.0,1.0
12975,Meine Schwestern,303966,0,303966,2014.csv,2014,0.0,1.0
12976,Microbe & Gasoline,303787,63802,239985,2015.csv,2015,0.21002215368004556,0.7899778463199545
12977,Paradise Stop,303702,0,303702,2011.csv,2011,0.0,1.0
12978,N.H 10,303587,303587,0,2015.csv,2015,1.0,0.0
12979,Alamar,303574,61613,241961,2010.csv,2010,0.20295875140822336,0.7970412485917766
12980,12 Chòm Sao: Ve Duong Cho Yêu Chay,303504,0,303504,2015.csv,2015,0.0,1.0
12981,Inheritance,303408,0,303408,2020.csv,2020,0.0,1.0
12982,Nessun Dorma,303338,0,303338,2016.csv,2016,0.0,1.0
12983,My Little Brother,303219,0,303219,2017.csv,2017,0.0,1.0
12984,PAW Patrol,303032,0,303032,2016.csv,2016,0.0,1.0
12985,The Bolshoi Ballet: Live From Moscow - Giselle,302681,302681,0,2018.csv,2018,1.0,0.0
12986,The Lord of the Rings: The Two Towers 2017 Re-release,302597,0,302597,2017.csv,2017,0.0,1.0
12987,Kabadadaari,302563,0,302563,2021.csv,2021,0.0,1.0
12988,Bumm Bumm Bole,302507,0,302507,2010.csv,2010,0.0,1.0
12989,Always and Forever,302335,197464,104871,2019.csv,2019,0.6531298063406487,0.3468701936593514
12990,Naan Mahaan Alla,302309,0,302309,2010.csv,2010,0.0,1.0
12991,The Night Clerk,302127,0,302127,2020.csv,2020,0.0,1.0
12992,And Tomorrow the Entire World,302101,0,302101,2020.csv,2020,0.0,1.0
12993,La clinique de l'amour!,302101,0,302101,2012.csv,2012,0.0,1.0
12994,Summer Snow,302072,0,302072,2015.csv,2015,0.0,1.0
12995,Deccal 2,301933,0,301933,2017.csv,2017,0.0,1.0
12996,One Night in Taipei,301845,0,301845,2015.csv,2015,0.0,1.0
12997,The Unknown Known,301604,276497,25107,2014.csv,2014,0.9167550828238352,0.08324491717616478
12998,Godha,301447,0,301447,2017.csv,2017,0.0,1.0
12999,"Love, Not Yet",301327,0,301327,2011.csv,2011,0.0,1.0
13000,Doctor Lisa,301186,0,301186,2020.csv,2020,0.0,1.0
13001,Save Yourselves!,301162,301162,0,2020.csv,2020,1.0,0.0
13002,Four Warriors: The Underworld,301159,0,301159,2019.csv,2019,0.0,1.0
13003,Ceasefire,301087,0,301087,2017.csv,2017,0.0,1.0
13004,Barcelona Summer Night,301021,0,301021,2013.csv,2013,0.0,1.0
13005,Wintervention,301015,0,301015,2011.csv,2011,0.0,1.0
13006,Grandmother,300886,0,300886,2010.csv,2010,0.0,1.0
13007,Pelle Politibil går i vannet 2013 Re-release,300864,0,300864,2013.csv,2013,0.0,1.0
13008,Cliffs of Freedom,300842,72476,228366,2019.csv,2019,0.2409105111653293,0.7590894888346706
13009,The Ring,300741,0,300741,2017.csv,2017,0.0,1.0
13010,Vuil Wasgoed,300632,0,300632,2017.csv,2017,0.0,1.0
13011,Three-60,300539,0,300539,2013.csv,2013,0.0,1.0
13012,Octonauts Season 4: GUP-S,300520,0,300520,2016.csv,2016,0.0,1.0
13013,Sag Salim,300466,0,300466,2012.csv,2012,0.0,1.0
13014,Fear of Falling,300463,0,300463,2012.csv,2012,0.0,1.0
13015,My Ex and Whys,300412,0,300412,2017.csv,2017,0.0,1.0
13016,Manikarnika: The Queen of Jhansi,300337,0,300337,2019.csv,2019,0.0,1.0
13017,Underground,300264,0,300264,2013.csv,2013,0.0,1.0
13018,Midnight Dreamers,300158,0,300158,2018.csv,2018,0.0,1.0
13019,Mau Mau Maria,299929,0,299929,2014.csv,2014,0.0,1.0
13020,On the Path,299911,0,299911,2010.csv,2010,0.0,1.0
13021,Older Than Ireland,299773,0,299773,2018.csv,2018,0.0,1.0
13022,The New Pinocchio,299712,0,299712,2017.csv,2017,0.0,1.0
13023,Sunset Blvd. 2018 Re-release,299645,299645,0,2018.csv,2018,1.0,0.0
13024,Never Rarely Sometimes Always,299588,16565,283023,2020.csv,2020,0.055292601839860074,0.9447073981601399
13025,Abominable 2021 Re-release,299583,110000,189583,2021.csv,2021,0.36717704275609764,0.6328229572439024
13026,La planque,299572,0,299572,2011.csv,2011,0.0,1.0
13027,Sevkat Yerimdar,299440,0,299440,2013.csv,2013,0.0,1.0
13028,Gremlins 2020 Re-release,299113,295000,4113,2020.csv,2020,0.986249343893445,0.013750656106555048
13029,Deep in the Wood,299064,0,299064,2015.csv,2015,0.0,1.0
13030,Life Risking Romance,298900,0,298900,2016.csv,2016,0.0,1.0
13031,Hansel & Gretel Get Baked,298688,0,298688,2014.csv,2014,0.0,1.0
13032,Ankara Yazi Veda Mektubu,298646,0,298646,2016.csv,2016,0.0,1.0
13033,Here Is Harold,298244,0,298244,2014.csv,2014,0.0,1.0
13034,Oceans: Our Blue Planet,298135,0,298135,2018.csv,2018,0.0,1.0
13035,Sanz: Lo que fui es lo que soy,298110,0,298110,2018.csv,2018,0.0,1.0
13036,Filthy,298075,0,298075,2017.csv,2017,0.0,1.0
13037,National Theatre Live: Obsession,298051,0,298051,2017.csv,2017,0.0,1.0
13038,Freies Land,297983,0,297983,2020.csv,2020,0.0,1.0
13039,Anna Karenina,297809,0,297809,2017.csv,2017,0.0,1.0
13040,Gekijouban Selector Destructed WIXOSS,297796,0,297796,2016.csv,2016,0.0,1.0
13041,Órbita 9,297682,0,297682,2017.csv,2017,0.0,1.0
13042,Four Suns,297424,0,297424,2012.csv,2012,0.0,1.0
13043,Promise of Pisa,297388,0,297388,2019.csv,2019,0.0,1.0
13044,Jinn,297381,202348,95033,2014.csv,2014,0.6804335179449931,0.3195664820550069
13045,The Last Death,297323,0,297323,2012.csv,2012,0.0,1.0
13046,Planet Dinosaur,297245,0,297245,2018.csv,2018,0.0,1.0
13047,The Queen of Crime,297209,0,297209,2016.csv,2016,0.0,1.0
13048,Verraaiers,297105,0,297105,2013.csv,2013,0.0,1.0
13049,John Day,297003,0,297003,2013.csv,2013,0.0,1.0
13050,Broken Promises 4-Ever,296956,0,296956,2018.csv,2018,0.0,1.0
13051,Azazil 2: Büyü,296880,0,296880,2016.csv,2016,0.0,1.0
13052,Blackmail,296860,0,296860,2018.csv,2018,0.0,1.0
13053,The Story of Yu-Looking for Power,296807,0,296807,2018.csv,2018,0.0,1.0
13054,Bad Investigate,296755,0,296755,2018.csv,2018,0.0,1.0
13055,Kaptaan,296715,203790,92925,2016.csv,2016,0.6868206865173652,0.31317931348263484
13056,Black Sabbath: The End Of The End,296642,0,296642,2017.csv,2017,0.0,1.0
13057,Cold War 2018 Re-release,296501,0,296501,2018.csv,2018,0.0,1.0
13058,Anjaan,296477,0,296477,2014.csv,2014,0.0,1.0
13059,The Vault,296473,0,296473,2021.csv,2021,0.0,1.0
13060,Kings Bay,296392,0,296392,2017.csv,2017,0.0,1.0
13061,Labyrinthus,295931,0,295931,2014.csv,2014,0.0,1.0
13062,The We and the I,295930,42172,253758,2012.csv,2012,0.1425066738755787,0.8574933261244213
13063,Harry Potter and the Sorcerer's Stone 2018 Re-release,295917,295917,0,2018.csv,2018,1.0,0.0
13064,Naiyaandi,295856,0,295856,2013.csv,2013,0.0,1.0
13065,Kurt Josef Wagle og mordmysteriet på Hurtigruta,295848,0,295848,2017.csv,2017,0.0,1.0
13066,Baczynski,295762,0,295762,2013.csv,2013,0.0,1.0
13067,Armi Alive!,295731,0,295731,2015.csv,2015,0.0,1.0
13068,The Experiment 2010 Re-release,295722,0,295722,2010.csv,2010,0.0,1.0
13069,Midnight Ruins,295719,0,295719,2019.csv,2019,0.0,1.0
13070,1 Kezban 1 Mahmut: Adana Yollarinda,295684,0,295684,2016.csv,2016,0.0,1.0
13071,Baby Dolls,295472,0,295472,2019.csv,2019,0.0,1.0
13072,The Star Maker,295400,0,295400,2012.csv,2012,0.0,1.0
13073,Jatt James Bond,295327,0,295327,2014.csv,2014,0.0,1.0
13074,Chic!,295295,5587,289708,2015.csv,2015,0.018920062987859598,0.9810799370121404
13075,4 Black Suits,295186,0,295186,2010.csv,2010,0.0,1.0
13076,The Tenth Man,295129,63564,231565,2016.csv,2016,0.21537700463187284,0.7846229953681272
13077,Deliver Us from Evil 2020 Final Cut,295107,0,295107,2020.csv,2020,0.0,1.0
13078,Love.com,295052,0,295052,2017.csv,2017,0.0,1.0
13079,Sons of Soil,295039,0,295039,2012.csv,2012,0.0,1.0
13080,Never Leave Me,295033,0,295033,2018.csv,2018,0.0,1.0
13081,Ám Anh,294953,0,294953,2016.csv,2016,0.0,1.0
13082,Sinister Circle 2017 Re-release,294883,0,294883,2017.csv,2017,0.0,1.0
13083,Aurora Borealis: Északi fény,294713,0,294713,2017.csv,2017,0.0,1.0
13084,Pure as Snow,294710,0,294710,2019.csv,2019,0.0,1.0
13085,Aftershock,294696,58510,236186,2013.csv,2013,0.19854358389662569,0.8014564161033744
13086,Shakira in Concert: El Dorado World Tour,294677,271586,23091,2019.csv,2019,0.9216396257597301,0.07836037424026986
13087,Khodorkovsky,294599,39522,255077,2011.csv,2011,0.1341552415317092,0.8658447584682908
13088,Special Treatment,294483,8856,285627,2010.csv,2010,0.0300730432656554,0.9699269567343446
13089,La Llorona,294404,0,294404,2020.csv,2020,0.0,1.0
13090,Naked Soldier,294384,0,294384,2012.csv,2012,0.0,1.0
13091,W. - The Killer of Flanders Fields,294348,0,294348,2014.csv,2014,0.0,1.0
13092,Shinigami: The Death Handler,294271,0,294271,2020.csv,2020,0.0,1.0
13093,44 Inch Chest 2010 Re-release,294245,39033,255212,2010.csv,2010,0.1326547604887084,0.8673452395112916
13094,In Darkness 2018 Re-release,294126,0,294126,2018.csv,2018,0.0,1.0
13095,An Irrepressible Woman,294102,0,294102,2020.csv,2020,0.0,1.0
13096,Innocence,294039,294039,0,2014.csv,2014,1.0,0.0
13097,The Recipe,293898,0,293898,2010.csv,2010,0.0,1.0
13098,My Best Bodyguard,293866,0,293866,2010.csv,2010,0.0,1.0
13099,Hanni & Nanni 3 2014 Re-release,293734,0,293734,2014.csv,2014,0.0,1.0
13100,Thale,293652,0,293652,2012.csv,2012,0.0,1.0
13101,Doctor Stranger,293497,0,293497,2013.csv,2013,0.0,1.0
13102,New Initial D the Movie: Legend 3 - Dream,293276,0,293276,2016.csv,2016,0.0,1.0
13103,Tigers,293274,0,293274,2017.csv,2017,0.0,1.0
13104,Libre échange,293115,0,293115,2010.csv,2010,0.0,1.0
13105,The Giant Spider Invasion,293053,293053,0,2019.csv,2019,1.0,0.0
13106,Dawn Raid,292930,0,292930,2021.csv,2021,0.0,1.0
13107,Resistance,292888,7464,285424,2020.csv,2020,0.025484144109693806,0.9745158558903062
13108,Pianomania,292870,49852,243018,2010.csv,2010,0.17021886843992215,0.8297811315600778
13109,Stonewall,292669,187674,104995,2015.csv,2015,0.6412500128131097,0.35874998718689033
13110,Himitsu kessha Takano Tsume The Movie 3,292467,0,292467,2010.csv,2010,0.0,1.0
13111,Romantic Road,292399,0,292399,2020.csv,2020,0.0,1.0
13112,Naa Peru Surya Naa Illu India,292395,0,292395,2018.csv,2018,0.0,1.0
13113,Granny Poetry Club,292342,0,292342,2019.csv,2019,0.0,1.0
13114,Death of Me,292271,0,292271,2020.csv,2020,0.0,1.0
13115,Golosa bolshoy strany,292208,0,292208,2016.csv,2016,0.0,1.0
13116,Rock My Heart,292180,0,292180,2017.csv,2017,0.0,1.0
13117,Mesrine: Public Enemy No. 1 2010 Re-release,292150,275387,16763,2010.csv,2010,0.9426219407838439,0.05737805921615608
13118,The Last Five Years,292092,145427,146665,2015.csv,2015,0.4978808046779782,0.5021191953220219
13119,Dreams of a Life,291898,8405,283493,2011.csv,2011,0.02879430485991682,0.9712056951400831
13120,"Kidnapping, Caucasian Style",291766,0,291766,2014.csv,2014,0.0,1.0
13121,The Godfather: Part II 45th Anniversary,291754,291754,0,2019.csv,2019,1.0,0.0
13122,Catch .44,291742,0,291742,2012.csv,2012,0.0,1.0
13123,Kuningas Litmanen,291632,0,291632,2012.csv,2012,0.0,1.0
13124,Jackie & Oopjen,291632,0,291632,2020.csv,2020,0.0,1.0
13125,I'd Receive the Worst News from Your Beautiful Lips,291599,0,291599,2012.csv,2012,0.0,1.0
13126,The Man in 3B,291513,291513,0,2015.csv,2015,1.0,0.0
13127,Los Bando,291495,0,291495,2018.csv,2018,0.0,1.0
13128,Game Over,291424,0,291424,2012.csv,2012,0.0,1.0
13129,Awoken,291390,0,291390,2020.csv,2020,0.0,1.0
13130,Waste Land,291307,187716,103591,2010.csv,2010,0.644392342099572,0.3556076579004281
13131,Big Bad Wolves,291239,33232,258007,2014.csv,2014,0.11410559712126467,0.8858944028787353
13132,Rose of Betrayal,291192,0,291192,2018.csv,2018,0.0,1.0
13133,First Mission,291151,0,291151,2010.csv,2010,0.0,1.0
13134,The Star on WuLing Mountain,291100,0,291100,2019.csv,2019,0.0,1.0
13135,Exeter,291097,0,291097,2015.csv,2015,0.0,1.0
13136,Patriotai,290907,0,290907,2016.csv,2016,0.0,1.0
13137,All Is Silence,290894,0,290894,2012.csv,2012,0.0,1.0
13138,Dominee Tienie,290812,0,290812,2019.csv,2019,0.0,1.0
13139,Punyalan Private Limited,290502,0,290502,2017.csv,2017,0.0,1.0
13140,More Than Funny,290498,290498,0,2018.csv,2018,1.0,0.0
13141,Super Kindergarten,290308,0,290308,2016.csv,2016,0.0,1.0
13142,Todas las canciones hablan de mí,290142,0,290142,2010.csv,2010,0.0,1.0
13143,Illégal,290108,651,289457,2010.csv,2010,0.0022439918926744525,0.9977560081073256
13144,Jimmy Vestvood: Amerikan Hero,290080,230069,60011,2016.csv,2016,0.7931225868725869,0.20687741312741312
13145,Haikyu!! The Movie: Ending and Beginning 2017 Re-release,290065,0,290065,2017.csv,2017,0.0,1.0
13146,Best F(r)iends: Volume 1,290064,252410,37654,2018.csv,2018,0.8701872690164929,0.1298127309835071
13147,Lupt,289845,0,289845,2018.csv,2018,0.0,1.0
13148,Where I've Never Lived,289698,0,289698,2017.csv,2017,0.0,1.0
13149,The Snow White,289687,0,289687,2010.csv,2010,0.0,1.0
13150,Boss Engira Baskaran,289672,0,289672,2010.csv,2010,0.0,1.0
13151,The Zoya Factor,289631,128831,160800,2019.csv,2019,0.4448108109974416,0.5551891890025584
13152,Soul House,289564,0,289564,2016.csv,2016,0.0,1.0
13153,Breathing,289527,0,289527,2017.csv,2017,0.0,1.0
13154,Best Night Ever,289511,0,289511,2014.csv,2014,0.0,1.0
13155,Vinnaithaandi Varuvaayaa,289489,0,289489,2010.csv,2010,0.0,1.0
13156,The Silence of Others,289455,67986,221469,2018.csv,2018,0.2348758874436441,0.7651241125563559
13157,Juan y Eva,289246,0,289246,2011.csv,2011,0.0,1.0
13158,Ghinionistul,289145,0,289145,2017.csv,2017,0.0,1.0
13159,Bad Girl,289143,0,289143,2012.csv,2012,0.0,1.0
13160,Vasilisa,289138,0,289138,2014.csv,2014,0.0,1.0
13161,Halam Geldi,289013,0,289013,2014.csv,2014,0.0,1.0
13162,Hastrman,288985,0,288985,2018.csv,2018,0.0,1.0
13163,The Goya Murders,288959,0,288959,2019.csv,2019,0.0,1.0
13164,Welcome to New York,288837,0,288837,2014.csv,2014,0.0,1.0
13165,Apocalypse Now 2019 Re-release,288823,0,288823,2019.csv,2019,0.0,1.0
13166,Bha Ji in Problem,288811,0,288811,2013.csv,2013,0.0,1.0
13167,Antarctica: A Year on Ice,288757,288757,0,2014.csv,2014,1.0,0.0
13168,Above and Beyond,288751,288751,0,2015.csv,2015,1.0,0.0
13169,Cut Bank,288591,0,288591,2015.csv,2015,0.0,1.0
13170,Sachin - A Billion Dreams,288557,0,288557,2017.csv,2017,0.0,1.0
13171,The Last of Robin Hood,288545,288545,0,2014.csv,2014,1.0,0.0
13172,Skinning,288512,0,288512,2010.csv,2010,0.0,1.0
13173,Saga of Tanya the Evil - The Movie,288460,288460,0,2019.csv,2019,1.0,0.0
13174,Another Woman,288422,0,288422,2016.csv,2016,0.0,1.0
13175,Last Train Home,288328,288328,0,2010.csv,2010,1.0,0.0
13176,Lock Up,288197,0,288197,2010.csv,2010,0.0,1.0
13177,Gyeongju,288139,0,288139,2014.csv,2014,0.0,1.0
13178,Rock the Casbah,288128,0,288128,2013.csv,2013,0.0,1.0
13179,Cody the Robosapien,288055,0,288055,2013.csv,2013,0.0,1.0
13180,Muerte en alto contraste,288032,0,288032,2010.csv,2010,0.0,1.0
13181,The Kid from the Big Apple,287895,0,287895,2016.csv,2016,0.0,1.0
13182,Kickboxer: Vengeance,287779,0,287779,2016.csv,2016,0.0,1.0
13183,Zombie TV,287737,0,287737,2014.csv,2014,0.0,1.0
13184,Countdown to Zero,287711,272040,15671,2010.csv,2010,0.9455321485796511,0.05446785142034889
13185,Generation Wealth,287709,237709,50000,2018.csv,2018,0.8262132919025821,0.17378670809741786
13186,Piccoli crimini coniugali,287689,0,287689,2017.csv,2017,0.0,1.0
13187,Citizens of the World,287545,0,287545,2020.csv,2020,0.0,1.0
13188,"Farewell, My Love",287404,0,287404,2018.csv,2018,0.0,1.0
13189,In My Blood It Runs,287354,0,287354,2020.csv,2020,0.0,1.0
13190,Zenská pomsta,287350,0,287350,2020.csv,2020,0.0,1.0
13191,Calamity Jane,287349,0,287349,2020.csv,2020,0.0,1.0
13192,Adam misin!,287328,0,287328,2016.csv,2016,0.0,1.0
13193,Skate Kitchen,287307,236799,50508,2018.csv,2018,0.824201986028882,0.175798013971118
13194,Panic: Ghost Apartment,287293,0,287293,2018.csv,2018,0.0,1.0
13195,The Last Hammer Blow,287248,0,287248,2015.csv,2015,0.0,1.0
13196,Phee Ha Ayothaya,287128,0,287128,2015.csv,2015,0.0,1.0
13197,The Workhorse & the Bigmouth,287104,0,287104,2013.csv,2013,0.0,1.0
13198,El Guachiman,287054,0,287054,2011.csv,2011,0.0,1.0
13199,Silence,286942,0,286942,2011.csv,2011,0.0,1.0
13200,Mijn vader is een detective: De wet van 3,286807,0,286807,2011.csv,2011,0.0,1.0
13201,Post Mortem,286702,9750,276952,2010.csv,2010,0.03400743629273601,0.9659925637072639
13202,End of Summer,286549,0,286549,2018.csv,2018,0.0,1.0
13203,Mad Bastards,286531,0,286531,2011.csv,2011,0.0,1.0
13204,The Interrupters,286457,282448,4009,2011.csv,2011,0.9860048803136248,0.013995119686375268
13205,Den Sidste Rejse,286342,0,286342,2011.csv,2011,0.0,1.0
13206,Bibapbarurra,286327,0,286327,2018.csv,2018,0.0,1.0
13207,Tom Turbo,286220,0,286220,2013.csv,2013,0.0,1.0
13208,The Silent Mountain,286009,0,286009,2014.csv,2014,0.0,1.0
13209,The Fury,286005,0,286005,2016.csv,2016,0.0,1.0
13210,I Want to Live,285916,0,285916,2018.csv,2018,0.0,1.0
13211,Year of the Dog,285872,0,285872,2018.csv,2018,0.0,1.0
13212,Deli Dumrul,285843,0,285843,2017.csv,2017,0.0,1.0
13213,Feng Menglong's Legend,285714,0,285714,2017.csv,2017,0.0,1.0
13214,Manje Bistre,285656,0,285656,2017.csv,2017,0.0,1.0
13215,"Dis ek, Anna",285344,0,285344,2015.csv,2015,0.0,1.0
13216,But Deliver Us from Evil,285169,285169,0,2018.csv,2018,1.0,0.0
13217,All in Good Time,285116,0,285116,2012.csv,2012,0.0,1.0
13218,Alex & Eve,284934,0,284934,2015.csv,2015,0.0,1.0
13219,Happy Hour,284886,0,284886,2018.csv,2018,0.0,1.0
13220,Bring Back the Dead,284876,0,284876,2015.csv,2015,0.0,1.0
13221,Siam Square,284842,0,284842,2017.csv,2017,0.0,1.0
13222,The Silence 2012 Re-release,284471,100214,184257,2012.csv,2012,0.35228195492686426,0.6477180450731358
13223,Here Comes Fortune,284390,0,284390,2010.csv,2010,0.0,1.0
13224,Pob na pluak,284384,0,284384,2014.csv,2014,0.0,1.0
13225,Troe,284356,0,284356,2020.csv,2020,0.0,1.0
13226,Ginger's Tale,284298,0,284298,2021.csv,2021,0.0,1.0
13227,Khalid: Free Spirit,284229,284229,0,2019.csv,2019,1.0,0.0
13228,South of the Border,284214,198600,85614,2010.csv,2010,0.6987692372648778,0.3012307627351221
13229,Trash,284200,0,284200,2020.csv,2020,0.0,1.0
13230,Family Business,284150,0,284150,2018.csv,2018,0.0,1.0
13231,The Anonymous People,284147,284147,0,2013.csv,2013,1.0,0.0
13232,Unresolved Sexual Tension 2011 Re-release,284138,0,284138,2011.csv,2011,0.0,1.0
13233,Our Women,284111,0,284111,2012.csv,2012,0.0,1.0
13234,The Kindergarten Teacher,284065,36190,247875,2014.csv,2014,0.12740041891820533,0.8725995810817947
13235,Robin,284041,0,284041,2012.csv,2012,0.0,1.0
13236,Believe,283995,0,283995,2013.csv,2013,0.0,1.0
13237,Spinning Man,283755,0,283755,2018.csv,2018,0.0,1.0
13238,Budapest Noir,283704,0,283704,2017.csv,2017,0.0,1.0
13239,The Child,283324,0,283324,2012.csv,2012,0.0,1.0
13240,Six Minutes to Midnight,283301,102085,181216,2020.csv,2020,0.3603411212808991,0.6396588787191009
13241,No Surrender,283280,0,283280,2018.csv,2018,0.0,1.0
13242,"Sea, No Sex & Sun",283211,0,283211,2012.csv,2012,0.0,1.0
13243,Sufna,283196,0,283196,2020.csv,2020,0.0,1.0
13244,Extreme Crisis,283070,0,283070,2019.csv,2019,0.0,1.0
13245,Manny Lewis,283050,0,283050,2015.csv,2015,0.0,1.0
13246,Pleasant Goat and Big Big Wolf 2,282842,0,282842,2010.csv,2010,0.0,1.0
13247,Imperium,282817,0,282817,2016.csv,2016,0.0,1.0
13248,Losing Lerato,282791,0,282791,2019.csv,2019,0.0,1.0
13249,Exhibition on Screen: Van Gogh & Japan,282624,0,282624,2019.csv,2019,0.0,1.0
13250,Undisputed 3: Redemption,282548,0,282548,2010.csv,2010,0.0,1.0
13251,Don't Heal Me,282513,0,282513,2021.csv,2021,0.0,1.0
13252,Azem 3: Cin Tohumu,282496,0,282496,2016.csv,2016,0.0,1.0
13253,600 Miles,282456,0,282456,2015.csv,2015,0.0,1.0
13254,Disney's Newsies: The Broadway Musical! 2018 Re-release,282429,282429,0,2018.csv,2018,1.0,0.0
13255,American Skin,282332,282332,0,2021.csv,2021,1.0,0.0
13256,The Chainbreakers,282320,0,282320,2017.csv,2017,0.0,1.0
13257,The Bull,282276,0,282276,2019.csv,2019,0.0,1.0
13258,The Ancient Woods,282264,0,282264,2018.csv,2018,0.0,1.0
13259,Healing,282258,0,282258,2014.csv,2014,0.0,1.0
13260,Created Equal: Clarence Thomas in His Own Words,282149,282149,0,2020.csv,2020,1.0,0.0
13261,Tumbledown,282083,135026,147057,2016.csv,2016,0.47867471630690256,0.5213252836930974
13262,Supermarket,282072,0,282072,2012.csv,2012,0.0,1.0
13263,An Open Heart,281935,0,281935,2013.csv,2013,0.0,1.0
13264,Zhong gui,281934,0,281934,2011.csv,2011,0.0,1.0
13265,Ho Mann Jahaan,281926,208611,73315,2016.csv,2016,0.7399494902917787,0.2600505097082213
13266,Think Big Big,281918,0,281918,2019.csv,2019,0.0,1.0
13267,Dear Alice,281862,0,281862,2010.csv,2010,0.0,1.0
13268,Listen,281807,0,281807,2020.csv,2020,0.0,1.0
13269,Golak Bugni Bank Te Batua,281795,0,281795,2018.csv,2018,0.0,1.0
13270,Mahmut & Meryem,281786,0,281786,2013.csv,2013,0.0,1.0
13271,Le grand jour,281684,0,281684,2015.csv,2015,0.0,1.0
13272,Sons of Rizk,281607,0,281607,2015.csv,2015,0.0,1.0
13273,Seaside Motel,281487,0,281487,2010.csv,2010,0.0,1.0
13274,One for the Road,281426,0,281426,2010.csv,2010,0.0,1.0
13275,Mike Wallace Is Here,281245,281245,0,2019.csv,2019,1.0,0.0
13276,Despido procedente,281157,0,281157,2017.csv,2017,0.0,1.0
13277,"If I Want to Whistle, I Whistle",280892,12135,268757,2010.csv,2010,0.04320165757657748,0.9567983424234225
13278,The Saint,280831,0,280831,2017.csv,2017,0.0,1.0
13279,The White Sound 2010 Re-release,280807,0,280807,2010.csv,2010,0.0,1.0
13280,Octaman,280710,280710,0,2019.csv,2019,1.0,0.0
13281,Mystery Road,280702,0,280702,2013.csv,2013,0.0,1.0
13282,I Do... Until I Don't,280668,280668,0,2017.csv,2017,1.0,0.0
13283,The Wild Ones,280598,0,280598,2012.csv,2012,0.0,1.0
13284,Chorar de Rir,280527,0,280527,2019.csv,2019,0.0,1.0
13285,Pater,280477,0,280477,2011.csv,2011,0.0,1.0
13286,Bosch: The Garden of Dreams,280468,0,280468,2016.csv,2016,0.0,1.0
13287,Final Recipe,280437,0,280437,2016.csv,2016,0.0,1.0
13288,Summer Window,280408,0,280408,2011.csv,2011,0.0,1.0
13289,The Bee Gees: How Can You Mend a Broken Heart,280367,0,280367,2020.csv,2020,0.0,1.0
13290,Bastardi II 2011 Re-release,280242,0,280242,2011.csv,2011,0.0,1.0
13291,Le jeu de la vérité,280150,0,280150,2014.csv,2014,0.0,1.0
13292,The Black Power Mixtape 1967-1975,280025,273749,6276,2011.csv,2011,0.9775877153825552,0.02241228461744487
13293,Mahabharat,280024,0,280024,2013.csv,2013,0.0,1.0
13294,Vojna akademija 5,280011,0,280011,2019.csv,2019,0.0,1.0
13295,I Want You,280000,0,280000,2013.csv,2013,0.0,1.0
13296,Walk Like a Panther,279995,0,279995,2018.csv,2018,0.0,1.0
13297,The Silence of the Marsh,279983,0,279983,2020.csv,2020,0.0,1.0
13298,Angry Indian Goddesses,279979,0,279979,2016.csv,2016,0.0,1.0
13299,Love is Not Blind,279822,0,279822,2012.csv,2012,0.0,1.0
13300,The Dead and the Others,279810,0,279810,2019.csv,2019,0.0,1.0
13301,Daana Paani,279681,0,279681,2018.csv,2018,0.0,1.0
13302,Wonders of the Sea,279415,100780,178635,2018.csv,2018,0.360682139469964,0.6393178605300359
13303,Yamada: Samurai of Ayothaya,279415,0,279415,2010.csv,2010,0.0,1.0
13304,Havenhurst,279372,0,279372,2016.csv,2016,0.0,1.0
13305,Cinni: Uyanis,279308,0,279308,2016.csv,2016,0.0,1.0
13306,"Lovely, Still",279170,127564,151606,2010.csv,2010,0.4569402156392163,0.5430597843607837
13307,The Watchmaker's Apprentice,279165,0,279165,2019.csv,2019,0.0,1.0
13308,Mahanati,279078,0,279078,2018.csv,2018,0.0,1.0
13309,"Lou Andreas-Salomé, The Audacity to be Free",278982,12875,266107,2017.csv,2017,0.04614993081990953,0.9538500691800905
13310,Fake Guardians,278865,0,278865,2017.csv,2017,0.0,1.0
13311,Schneider vs. Bax,278660,0,278660,2015.csv,2015,0.0,1.0
13312,Our Sunhi,278535,0,278535,2013.csv,2013,0.0,1.0
13313,10 Years,278336,203373,74963,2012.csv,2012,0.730674436652104,0.2693255633478961
13314,Ögrenci Isleri,278304,0,278304,2015.csv,2015,0.0,1.0
13315,An Enemy to Die For,278129,0,278129,2012.csv,2012,0.0,1.0
13316,The Showdown,277996,0,277996,2011.csv,2011,0.0,1.0
13317,Elena of Avalor,277986,0,277986,2017.csv,2017,0.0,1.0
13318,Population Boom,277973,0,277973,2013.csv,2013,0.0,1.0
13319,Censored,277969,0,277969,2019.csv,2019,0.0,1.0
13320,Day of the Dead: Bloodline,277922,0,277922,2018.csv,2018,0.0,1.0
13321,F for Far,277918,0,277918,2015.csv,2015,0.0,1.0
13322,Sky Ladder: The Art of Cai Guo-Qiang,277761,0,277761,2016.csv,2016,0.0,1.0
13323,Yugo and Lala 2015 Re-release,277699,0,277699,2015.csv,2015,0.0,1.0
13324,Bolshoi Ballet: The Golden Age,277666,171916,105750,2019.csv,2019,0.6191467446500472,0.38085325534995285
13325,The Summit,277651,243550,34101,2013.csv,2013,0.8771803451095079,0.12281965489049201
13326,Fireman Sam: Heroes of the Storm,277462,0,277462,2018.csv,2018,0.0,1.0
13327,Gone Fishing,277349,0,277349,2012.csv,2012,0.0,1.0
13328,Science Fair,277338,276195,1143,2018.csv,2018,0.9958786751184475,0.004121324881552474
13329,Divorzio a Las Vegas,277151,0,277151,2020.csv,2020,0.0,1.0
13330,See You Soon,277126,0,277126,2019.csv,2019,0.0,1.0
13331,Gajin svet,276921,0,276921,2018.csv,2018,0.0,1.0
13332,Yanlis Anlama,276894,0,276894,2017.csv,2017,0.0,1.0
13333,Nome di donna,276803,0,276803,2018.csv,2018,0.0,1.0
13334,300 Worte Deutsch,276792,0,276792,2015.csv,2015,0.0,1.0
13335,Run If You Can,276642,0,276642,2010.csv,2010,0.0,1.0
13336,Girl Dorm,276486,0,276486,2019.csv,2019,0.0,1.0
13337,Hotel Soul Good,276484,0,276484,2018.csv,2018,0.0,1.0
13338,True Grit 2019 Re-release,276418,276418,0,2019.csv,2019,1.0,0.0
13339,Gruber Is Leaving,276176,0,276176,2015.csv,2015,0.0,1.0
13340,Khoosee Deetaefan,276153,0,276153,2013.csv,2013,0.0,1.0
13341,With Trabants to the Last Breath,275920,0,275920,2016.csv,2016,0.0,1.0
13342,Eyes on Me: The Movie,275799,0,275799,2020.csv,2020,0.0,1.0
13343,Namma Veettu Pillai,275752,0,275752,2019.csv,2019,0.0,1.0
13344,Soldato semplice,275747,0,275747,2015.csv,2015,0.0,1.0
13345,Brasserie Romantiek 2014 Re-release,275334,0,275334,2014.csv,2014,0.0,1.0
13346,Our Infinite Further,275315,0,275315,2019.csv,2019,0.0,1.0
13347,Haru's Journey,274880,0,274880,2010.csv,2010,0.0,1.0
13348,Aspromonte: Land of the Forgotten,274858,0,274858,2019.csv,2019,0.0,1.0
13349,La meute,274839,0,274839,2010.csv,2010,0.0,1.0
13350,Where the Wind Settles,274774,0,274774,2015.csv,2015,0.0,1.0
13351,Life After Beth,274717,88273,186444,2014.csv,2014,0.3213233982607556,0.6786766017392444
13352,Hareket Sekiz,274700,0,274700,2019.csv,2019,0.0,1.0
13353,In Fear,274660,0,274660,2013.csv,2013,0.0,1.0
13354,Lovely Molly,274480,18464,256016,2012.csv,2012,0.06726901777907315,0.9327309822209269
13355,Din Tao: Leader of the Parade,274465,0,274465,2012.csv,2012,0.0,1.0
13356,Common Destiny,274390,0,274390,2019.csv,2019,0.0,1.0
13357,The Mojicons,274358,0,274358,2017.csv,2017,0.0,1.0
13358,Sultanin Sirri,274344,0,274344,2010.csv,2010,0.0,1.0
13359,The Biggest Rescue,274301,0,274301,2014.csv,2014,0.0,1.0
13360,Swallow,274259,33419,240840,2020.csv,2020,0.1218519720410269,0.8781480279589731
13361,"Projekt dziecko, czyli ojciec potrzebny od zaraz",274244,0,274244,2010.csv,2010,0.0,1.0
13362,Lock Destination,274160,0,274160,2011.csv,2011,0.0,1.0
13363,Wilson City,274074,0,274074,2015.csv,2015,0.0,1.0
13364,Al Thalasa Yeshtghilonaha,273962,0,273962,2010.csv,2010,0.0,1.0
13365,In Syria,273873,0,273873,2017.csv,2017,0.0,1.0
13366,Ranmaru: Kamino shita wo motsu otoko,273798,0,273798,2016.csv,2016,0.0,1.0
13367,Inside,273748,0,273748,2012.csv,2012,0.0,1.0
13368,The King,273601,259291,14310,2018.csv,2018,0.9476975595849431,0.05230244041505696
13369,The Hippopotamus,273588,0,273588,2017.csv,2017,0.0,1.0
13370,Lux Æterna,273546,0,273546,2020.csv,2020,0.0,1.0
13371,Hardcore Comedy,273447,0,273447,2013.csv,2013,0.0,1.0
13372,Vulva 3.0,273343,0,273343,2014.csv,2014,0.0,1.0
13373,We'll Get Back to You,273291,0,273291,2017.csv,2017,0.0,1.0
13374,Becoming Who I Was,273265,0,273265,2017.csv,2017,0.0,1.0
13375,Super Deluxe,273191,0,273191,2019.csv,2019,0.0,1.0
13376,I Am Greta,273088,0,273088,2020.csv,2020,0.0,1.0
13377,The Path,273069,0,273069,2012.csv,2012,0.0,1.0
13378,Bob & Marys,273055,0,273055,2018.csv,2018,0.0,1.0
13379,Bendeyar,272999,0,272999,2011.csv,2011,0.0,1.0
13380,Slayer: The Repentless Killogy,272874,268727,4147,2019.csv,2019,0.9848025095831776,0.015197490416822416
13381,Chavela,272842,148666,124176,2017.csv,2017,0.5448794540429992,0.45512054595700074
13382,The Princess and the Pilot,272786,0,272786,2011.csv,2011,0.0,1.0
13383,Li and the Poet 2012 Re-release,272637,0,272637,2012.csv,2012,0.0,1.0
13384,A Burning Hot Summer,272484,0,272484,2011.csv,2011,0.0,1.0
13385,Black Death,272445,22554,249891,2010.csv,2010,0.0827836811099488,0.9172163188900512
13386,CBeebies Christmas Show: Thumbelina,272270,0,272270,2018.csv,2018,0.0,1.0
13387,The Tip of the Iceberg,272262,0,272262,2016.csv,2016,0.0,1.0
13388,A Special Day,272238,0,272238,2012.csv,2012,0.0,1.0
13389,I Am a Star,272085,0,272085,2018.csv,2018,0.0,1.0
13390,Black Brown White,272055,0,272055,2011.csv,2011,0.0,1.0
13391,Gustavo Enciklopedija,271943,0,271943,2014.csv,2014,0.0,1.0
13392,One Child Nation,271841,270128,1713,2019.csv,2019,0.993698522297961,0.0063014777020390595
13393,Come Out and Play,271735,2638,269097,2013.csv,2013,0.009707987561410933,0.9902920124385891
13394,Celia,271699,0,271699,2019.csv,2019,0.0,1.0
13395,The Tale of The Princess Kaguya 2019 Re-release,271681,271681,0,2019.csv,2019,1.0,0.0
13396,Love Actually 2020 Re-release,271401,0,271401,2020.csv,2020,0.0,1.0
13397,Alone/Together,271101,0,271101,2019.csv,2019,0.0,1.0
13398,A Wolf at the Door 2016 Re-release,270981,0,270981,2016.csv,2016,0.0,1.0
13399,Aloft,270971,53086,217885,2015.csv,2015,0.19591026345992746,0.8040897365400725
13400,Walled In,270888,0,270888,2010.csv,2010,0.0,1.0
13401,Baiyun Bridge,270827,0,270827,2016.csv,2016,0.0,1.0
13402,Love Pret-a-porte,270790,0,270790,2017.csv,2017,0.0,1.0
13403,Wong Ka Yan,270574,0,270574,2015.csv,2015,0.0,1.0
13404,Heaven's Lost Property the Movie: The Angeloid of Clockwork,270495,0,270495,2011.csv,2011,0.0,1.0
13405,Thomas & Friends: Blue Mountain Mystery,270383,0,270383,2012.csv,2012,0.0,1.0
13406,Gato negro,270273,0,270273,2014.csv,2014,0.0,1.0
13407,Araf 2,270201,0,270201,2019.csv,2019,0.0,1.0
13408,The Canyons,270185,56825,213360,2013.csv,2013,0.21031885559894148,0.7896811444010585
13409,Riphagen,270181,0,270181,2016.csv,2016,0.0,1.0
13410,Happy Life of Yang Guang,270000,0,270000,2013.csv,2013,0.0,1.0
13411,Exposed,269915,0,269915,2016.csv,2016,0.0,1.0
13412,Stalker,269881,269881,0,2017.csv,2017,1.0,0.0
13413,Shirin Farhad Ki Toh Nikal Padi,269845,155758,114087,2012.csv,2012,0.5772128444106802,0.4227871555893198
13414,Wawa No Cidal,269750,0,269750,2015.csv,2015,0.0,1.0
13415,The Magic Crystal,269695,0,269695,2011.csv,2011,0.0,1.0
13416,Kruty 1918,269622,0,269622,2019.csv,2019,0.0,1.0
13417,Cha cha cha,269432,0,269432,2013.csv,2013,0.0,1.0
13418,Bed & Breakfast: Love is a Happy Accident,269406,0,269406,2010.csv,2010,0.0,1.0
13419,Ein Tick anders,269341,0,269341,2011.csv,2011,0.0,1.0
13420,Coco,269174,0,269174,2018.csv,2018,0.0,1.0
13421,Maggie 2019 Re-release,269113,0,269113,2019.csv,2019,0.0,1.0
13422,"Hetalia: Axis Powers - Paint It, White!",269110,0,269110,2010.csv,2010,0.0,1.0
13423,Forensic,269095,0,269095,2020.csv,2020,0.0,1.0
13424,O Último Virgem,268979,0,268979,2016.csv,2016,0.0,1.0
13425,The Loneliest Planet,268933,129579,139354,2012.csv,2012,0.4818263284907393,0.5181736715092606
13426,Salur Kazan: Zoraki Kahraman,268791,0,268791,2017.csv,2017,0.0,1.0
13427,Weekend with Pops,268737,0,268737,2020.csv,2020,0.0,1.0
13428,Mune: Guardian of the Moon 2017 Re-release,268678,0,268678,2017.csv,2017,0.0,1.0
13429,The World Before Your Feet,268644,268644,0,2018.csv,2018,1.0,0.0
13430,Hidden Figures 2021 Re-release,268295,0,268295,2021.csv,2021,0.0,1.0
13431,Meri Pyaari Bindu,268067,0,268067,2017.csv,2017,0.0,1.0
13432,The Carer,267995,6208,261787,2016.csv,2016,0.023164611280061195,0.9768353887199388
13433,Conan O'Brien Can't Stop,267965,267965,0,2011.csv,2011,1.0,0.0
13434,Devil's Bride,267931,0,267931,2016.csv,2016,0.0,1.0
13435,Paul Sanchez Is Back!,267826,0,267826,2018.csv,2018,0.0,1.0
13436,An American in Paris 2020 Re-release,267824,267824,0,2020.csv,2020,1.0,0.0
13437,Corpus Christi: Playing with Redemption,267549,0,267549,2014.csv,2014,0.0,1.0
13438,Falcon Rising,267476,11774,255702,2014.csv,2014,0.04401890263051638,0.9559810973694837
13439,Chiapas the Heart of Coffee,267474,0,267474,2012.csv,2012,0.0,1.0
13440,Solo cose belle,267250,0,267250,2019.csv,2019,0.0,1.0
13441,The Devil's Dolls,267190,0,267190,2016.csv,2016,0.0,1.0
13442,Drive Hard,267030,0,267030,2014.csv,2014,0.0,1.0
13443,I'll Come Too,266866,0,266866,2018.csv,2018,0.0,1.0
13444,Munger Road,266689,266689,0,2011.csv,2011,1.0,0.0
13445,12A,266664,0,266664,2017.csv,2017,0.0,1.0
13446,Love Summer,266648,0,266648,2011.csv,2011,0.0,1.0
13447,When a City Falls,266564,0,266564,2011.csv,2011,0.0,1.0
13448,Arrebato,266407,0,266407,2014.csv,2014,0.0,1.0
13449,Jacinta,266230,0,266230,2017.csv,2017,0.0,1.0
13450,Layla M.,266010,0,266010,2016.csv,2016,0.0,1.0
13451,Ma fille,265988,0,265988,2018.csv,2018,0.0,1.0
13452,Waru,265893,0,265893,2017.csv,2017,0.0,1.0
13453,Divin enfant,265887,0,265887,2014.csv,2014,0.0,1.0
13454,Luzia: Cirque du Soleil in Cinema,265673,265673,0,2019.csv,2019,1.0,0.0
13455,Lovi Moment,265596,0,265596,2019.csv,2019,0.0,1.0
13456,Room 704,265515,0,265515,2016.csv,2016,0.0,1.0
13457,Félicité,265495,12433,253062,2017.csv,2017,0.04682950714702725,0.9531704928529727
13458,Bienvenue au Gondwana,265474,0,265474,2017.csv,2017,0.0,1.0
13459,Miss Tacuarembó,265336,0,265336,2010.csv,2010,0.0,1.0
13460,Out of Liberty,265279,265279,0,2019.csv,2019,1.0,0.0
13461,Travel Now! The Bottom of the Frog,265272,0,265272,2018.csv,2018,0.0,1.0
13462,Lingering,265265,0,265265,2020.csv,2020,0.0,1.0
13463,Thomas & Friends: Journey Beyond Sodor,265098,0,265098,2017.csv,2017,0.0,1.0
13464,"Asbury Park: Riot, Redemption, Rock & Roll",264983,167684,97299,2019.csv,2019,0.6328104067053358,0.36718959329466416
13465,Sterke verhalen,264783,0,264783,2010.csv,2010,0.0,1.0
13466,Doctor Who,264629,264629,0,2018.csv,2018,1.0,0.0
13467,Dan Carter: A Perfect 10,264611,0,264611,2019.csv,2019,0.0,1.0
13468,An Extremely Nutty Teacher,264560,0,264560,2011.csv,2011,0.0,1.0
13469,Bad Poems,264307,0,264307,2018.csv,2018,0.0,1.0
13470,Lars y el misterio del portal,264294,0,264294,2011.csv,2011,0.0,1.0
13471,Bodybuilder,264090,0,264090,2014.csv,2014,0.0,1.0
13472,Kikoriki: Team Invincible 2013 Re-release,263883,0,263883,2013.csv,2013,0.0,1.0
13473,"Good Luck, Dad",263814,0,263814,2018.csv,2018,0.0,1.0
13474,The Christening,263780,0,263780,2010.csv,2010,0.0,1.0
13475,"Daddy, Be with Me",263745,0,263745,2017.csv,2017,0.0,1.0
13476,All My Goodness,263728,0,263728,2017.csv,2017,0.0,1.0
13477,Phil Ochs: There But for Fortune,263723,263723,0,2011.csv,2011,1.0,0.0
13478,What a Country!,263668,0,263668,2019.csv,2019,0.0,1.0
13479,A Little Pond,263519,0,263519,2010.csv,2010,0.0,1.0
13480,Yin hun nan nu,263507,0,263507,2011.csv,2011,0.0,1.0
13481,Pete's Christmas,263493,0,263493,2013.csv,2013,0.0,1.0
13482,Open,263485,0,263485,2018.csv,2018,0.0,1.0
13483,Johnny Frank Garrett's Last Word,263360,0,263360,2017.csv,2017,0.0,1.0
13484,The Producers 2018 Re-release,263277,216807,46470,2018.csv,2018,0.8234938866668946,0.17650611333310542
13485,The Tortured 2014 Re-release,263084,0,263084,2014.csv,2014,0.0,1.0
13486,E Hedsod Padedsuk,262730,0,262730,2010.csv,2010,0.0,1.0
13487,The Rolling Stones: Havana Moon,262619,0,262619,2016.csv,2016,0.0,1.0
13488,Leonardo 500,262446,0,262446,2019.csv,2019,0.0,1.0
13489,Grand départ,262412,677,261735,2013.csv,2013,0.0025799125040013413,0.9974200874959986
13490,Augustine,262390,107352,155038,2013.csv,2013,0.40913144555813863,0.5908685544418614
13491,The Final Year,262286,191900,70386,2018.csv,2018,0.73164408317638,0.26835591682362003
13492,Kaatru Veliyidai,262212,0,262212,2017.csv,2017,0.0,1.0
13493,Tales from the Dark 1,262048,0,262048,2013.csv,2013,0.0,1.0
13494,Mr. Woosoo,261979,0,261979,2012.csv,2012,0.0,1.0
13495,Minimalism: A Documentary About the Important Things,261865,261865,0,2016.csv,2016,1.0,0.0
13496,Baseball Girl,261841,0,261841,2020.csv,2020,0.0,1.0
13497,Our Own Oslo,261779,0,261779,2011.csv,2011,0.0,1.0
13498,Baby Steps,261757,0,261757,2015.csv,2015,0.0,1.0
13499,Any Day Now,261747,201395,60352,2012.csv,2012,0.7694262016374591,0.23057379836254094
13500,Half Girlfriend,261597,0,261597,2017.csv,2017,0.0,1.0
13501,Let's Dance,261485,0,261485,2019.csv,2019,0.0,1.0
13502,Sardaarji 2,261306,0,261306,2016.csv,2016,0.0,1.0
13503,Parwaaz Hai Junoon,261304,0,261304,2018.csv,2018,0.0,1.0
13504,Spanish Movie 2012 Re-release,261081,0,261081,2012.csv,2012,0.0,1.0
13505,Danny's Doomsday,260861,0,260861,2014.csv,2014,0.0,1.0
13506,The Detectives,260827,0,260827,2014.csv,2014,0.0,1.0
13507,The Soul of Bread,260691,0,260691,2012.csv,2012,0.0,1.0
13508,Truth or Die,260588,0,260588,2012.csv,2012,0.0,1.0
13509,Eating You Alive,260534,260534,0,2018.csv,2018,1.0,0.0
13510,IRL (In Real Life),260491,0,260491,2013.csv,2013,0.0,1.0
13511,Her Smell,260481,255599,4882,2019.csv,2019,0.9812577500854189,0.0187422499145811
13512,Tatanka,260434,0,260434,2011.csv,2011,0.0,1.0
13513,Blondie,260419,0,260419,2012.csv,2012,0.0,1.0
13514,Revolution X: The Movie,260366,0,260366,2018.csv,2018,0.0,1.0
13515,The First Assignment,260294,0,260294,2011.csv,2011,0.0,1.0
13516,Max Adventures: Dinoterra,260247,0,260247,2014.csv,2014,0.0,1.0
13517,Star Raiders: The Adventures of Saber Raine,260234,260234,0,2019.csv,2019,1.0,0.0
13518,Beyond the Clouds 2019 Re-release,260114,0,260114,2019.csv,2019,0.0,1.0
13519,Ana Badi'a Ya Wadi'a,260039,0,260039,2011.csv,2011,0.0,1.0
13520,They Call Me Jeeg 2017 Re-release,260013,0,260013,2017.csv,2017,0.0,1.0
13521,Los Oriyinales,259974,0,259974,2017.csv,2017,0.0,1.0
13522,The Doorman,259883,0,259883,2020.csv,2020,0.0,1.0
13523,Tiro e Queda,259804,0,259804,2019.csv,2019,0.0,1.0
13524,No Ordinary Sheila,259707,0,259707,2017.csv,2017,0.0,1.0
13525,Superplokhie,259691,0,259691,2016.csv,2016,0.0,1.0
13526,Inconceivable,259635,0,259635,2017.csv,2017,0.0,1.0
13527,Modelar,259621,0,259621,2020.csv,2020,0.0,1.0
13528,Heaven,259323,259323,0,2020.csv,2020,1.0,0.0
13529,Seres: Genesis,259301,0,259301,2010.csv,2010,0.0,1.0
13530,Queen of Montreuil,259220,0,259220,2013.csv,2013,0.0,1.0
13531,Needle,259185,0,259185,2011.csv,2011,0.0,1.0
13532,Scribe,259135,0,259135,2017.csv,2017,0.0,1.0
13533,The Cave,258921,62625,196296,2019.csv,2019,0.24186914155282885,0.7581308584471711
13534,Rampage: Capital Punishment,258910,0,258910,2014.csv,2014,0.0,1.0
13535,Heartbeats,258806,0,258806,2010.csv,2010,0.0,1.0
13536,Vaselinetjie,258777,0,258777,2017.csv,2017,0.0,1.0
13537,The Unspoken,258760,0,258760,2016.csv,2016,0.0,1.0
13538,Shirley,258736,0,258736,2020.csv,2020,0.0,1.0
13539,Nodame Cantabile: The Movie II 2011 Re-release,258686,0,258686,2011.csv,2011,0.0,1.0
13540,Across the Universe 2018 Re-release,258618,258618,0,2018.csv,2018,1.0,0.0
13541,Big 2018 Re-release,258507,258507,0,2018.csv,2018,1.0,0.0
13542,Azú,258477,0,258477,2013.csv,2013,0.0,1.0
13543,The Magic Wardrobe,258429,0,258429,2011.csv,2011,0.0,1.0
13544,Up on the Wooftop,258425,0,258425,2015.csv,2015,0.0,1.0
13545,Kto ya?,258379,0,258379,2010.csv,2010,0.0,1.0
13546,"Boing, The Secret of Super Transformation",258369,0,258369,2018.csv,2018,0.0,1.0
13547,The Music Never Stopped,258223,258223,0,2011.csv,2011,1.0,0.0
13548,Steel,258114,0,258114,2012.csv,2012,0.0,1.0
13549,Van Goghs,258008,0,258008,2019.csv,2019,0.0,1.0
13550,Berlin Alexanderplatz,257901,0,257901,2020.csv,2020,0.0,1.0
13551,Roberto Carlos em Jerusalém,257814,0,257814,2019.csv,2019,0.0,1.0
13552,Girls' Generation,257650,0,257650,2016.csv,2016,0.0,1.0
13553,Amma Hófí,257430,0,257430,2020.csv,2020,0.0,1.0
13554,Fufu Fu-Fu-Nikki,257318,0,257318,2015.csv,2015,0.0,1.0
13555,My Last Five Girlfriends,257317,0,257317,2011.csv,2011,0.0,1.0
13556,Stratton,257212,0,257212,2017.csv,2017,0.0,1.0
13557,Chariots of Fire 2012 Re-release,257131,0,257131,2012.csv,2012,0.0,1.0
13558,Golden Years,257095,0,257095,2016.csv,2016,0.0,1.0
13559,It's All So Quiet,257090,0,257090,2013.csv,2013,0.0,1.0
13560,Mysteries of Lisbon,257065,110507,146558,2010.csv,2010,0.42987960243518175,0.5701203975648182
13561,Katka,257024,0,257024,2010.csv,2010,0.0,1.0
13562,Spiders,257019,0,257019,2013.csv,2013,0.0,1.0
13563,Dark Touch,256979,0,256979,2014.csv,2014,0.0,1.0
13564,Raja Natwarlal,256978,131105,125873,2014.csv,2014,0.5101798597545315,0.4898201402454685
13565,Fighter,256970,0,256970,2019.csv,2019,0.0,1.0
13566,Helicopter Eela,256952,71971,184981,2018.csv,2018,0.2800951150409415,0.7199048849590585
13567,We Are What We Are 2013 Re-release,256952,0,256952,2013.csv,2013,0.0,1.0
13568,The Dream Kids,256830,0,256830,2013.csv,2013,0.0,1.0
13569,The King of Football,256787,0,256787,2018.csv,2018,0.0,1.0
13570,Alive Inside: A Story of Music and Memory,256682,256682,0,2014.csv,2014,1.0,0.0
13571,Keep Running. Zombie Soldier!,256671,0,256671,2015.csv,2015,0.0,1.0
13572,Messner,256654,0,256654,2012.csv,2012,0.0,1.0
13573,The Food Guide to Love,256525,0,256525,2014.csv,2014,0.0,1.0
13574,Elanne Starlight,256440,0,256440,2016.csv,2016,0.0,1.0
13575,Resident Evil: Vendetta,256320,0,256320,2017.csv,2017,0.0,1.0
13576,Saint George,256281,0,256281,2017.csv,2017,0.0,1.0
13577,Jean-Michel Basquiat: The Radiant Child,256242,256242,0,2010.csv,2010,1.0,0.0
13578,Rabbit Hero,256241,0,256241,2015.csv,2015,0.0,1.0
13579,Pali Road,256229,0,256229,2016.csv,2016,0.0,1.0
13580,The Holy Land of Tyrol,256078,0,256078,2011.csv,2011,0.0,1.0
13581,The Woman Who Dreamed of a Man,255976,0,255976,2010.csv,2010,0.0,1.0
13582,Hope of Road,255779,0,255779,2018.csv,2018,0.0,1.0
13583,Pomnyu - ne pomnyu!,255566,0,255566,2016.csv,2016,0.0,1.0
13584,Dampak,255449,0,255449,2013.csv,2013,0.0,1.0
13585,Jinn 2014 Re-release,255317,0,255317,2014.csv,2014,0.0,1.0
13586,Snow White and the Three Little Pigs,255261,0,255261,2016.csv,2016,0.0,1.0
13587,Officer Down,255080,1463,253617,2013.csv,2013,0.005735455543358946,0.994264544456641
13588,The Muppet Christmas Carol 2020 Re-release,255064,100000,155064,2020.csv,2020,0.3920584637581156,0.6079415362418844
13589,Kon Khon,255058,0,255058,2011.csv,2011,0.0,1.0
13590,Friends Forever 2017 Re-release,254888,0,254888,2017.csv,2017,0.0,1.0
13591,All That Matters Is Past,254648,0,254648,2012.csv,2012,0.0,1.0
13592,Dean,254536,254536,0,2017.csv,2017,1.0,0.0
13593,The Robber,254489,83451,171038,2010.csv,2010,0.3279159413569938,0.6720840586430061
13594,Play the Flute,254475,254475,0,2019.csv,2019,1.0,0.0
13595,Women with Cows,254450,0,254450,2011.csv,2011,0.0,1.0
13596,Chasing,254421,0,254421,2016.csv,2016,0.0,1.0
13597,Rabid Dogs,254303,0,254303,2015.csv,2015,0.0,1.0
13598,Verbo,254247,0,254247,2011.csv,2011,0.0,1.0
13599,Route of Love,254185,0,254185,2019.csv,2019,0.0,1.0
13600,The Loved Ones,254170,0,254170,2010.csv,2010,0.0,1.0
13601,LokalFilmis,253878,0,253878,2015.csv,2015,0.0,1.0
13602,Fall in Love Like a Star 2015 Re-release,253785,212508,41277,2015.csv,2015,0.8373544535729062,0.1626455464270938
13603,Paayum Puli,253674,0,253674,2015.csv,2015,0.0,1.0
13604,Kapalak Kizi,253652,0,253652,2018.csv,2018,0.0,1.0
13605,Frankenstein,253514,0,253514,2015.csv,2015,0.0,1.0
13606,Wendy 2018 Re-release,253467,0,253467,2018.csv,2018,0.0,1.0
13607,The Bride and the Lover,253439,0,253439,2013.csv,2013,0.0,1.0
13608,Bing At Christmas,253343,0,253343,2019.csv,2019,0.0,1.0
13609,Mistaken for Strangers,253285,138991,114294,2014.csv,2014,0.5487533805791894,0.45124661942081057
13610,Tarapaty 2,253263,0,253263,2020.csv,2020,0.0,1.0
13611,Courage,253194,0,253194,2011.csv,2011,0.0,1.0
13612,The Night Watchmen,252917,0,252917,2015.csv,2015,0.0,1.0
13613,Leaving,252898,0,252898,2011.csv,2011,0.0,1.0
13614,Battlefield America,252805,172000,80805,2012.csv,2012,0.6803662902236902,0.3196337097763098
13615,The Octonauts,252738,0,252738,2015.csv,2015,0.0,1.0
13616,Dirty Dancing,252688,0,252688,2020.csv,2020,0.0,1.0
13617,Dört Köse,252656,0,252656,2017.csv,2017,0.0,1.0
13618,Holidays in the Sun,252564,0,252564,2014.csv,2014,0.0,1.0
13619,Footsteps in the Sand,252386,0,252386,2011.csv,2011,0.0,1.0
13620,Holmes & Watson. Madrid Days,252379,0,252379,2012.csv,2012,0.0,1.0
13621,Hockney,252346,0,252346,2014.csv,2014,0.0,1.0
13622,When Harry Met Sally... 30th Anniversary,252320,252320,0,2019.csv,2019,1.0,0.0
13623,I Got the Hook Up 2,252293,252293,0,2019.csv,2019,1.0,0.0
13624,The Human Centipede (First Sequence),252207,181467,70740,2010.csv,2010,0.7195161117653356,0.28048388823466436
13625,By a Sharp Knife,252098,0,252098,2019.csv,2019,0.0,1.0
13626,Deception 2020 Re-release,252039,0,252039,2020.csv,2020,0.0,1.0
13627,Viddana,251997,0,251997,2020.csv,2020,0.0,1.0
13628,Caterpillar,251922,4157,247765,2010.csv,2010,0.01650113924151126,0.9834988607584887
13629,Canal Street,251917,251917,0,2019.csv,2019,1.0,0.0
13630,Spell,251781,0,251781,2014.csv,2014,0.0,1.0
13631,Jiang Xin,251733,0,251733,2019.csv,2019,0.0,1.0
13632,Gook,251541,250130,1411,2017.csv,2017,0.994390576486537,0.005609423513463014
13633,'n Pawpaw Vir My Darling,251389,0,251389,2016.csv,2016,0.0,1.0
13634,Stunt School,251312,0,251312,2019.csv,2019,0.0,1.0
13635,Born to Win,250847,0,250847,2016.csv,2016,0.0,1.0
13636,Mohanlal,250635,0,250635,2018.csv,2018,0.0,1.0
13637,El futuro ya no es lo que era,250327,0,250327,2016.csv,2016,0.0,1.0
13638,Los bañeros más locos del mundo,250307,0,250307,2014.csv,2014,0.0,1.0
13639,Parque Mayer,250169,0,250169,2018.csv,2018,0.0,1.0
13640,Lost,250000,0,250000,2013.csv,2013,0.0,1.0
13641,Minha Fama de Mau,249971,0,249971,2019.csv,2019,0.0,1.0
13642,The Trials of Cate McCall,249601,0,249601,2014.csv,2014,0.0,1.0
13643,Familien Jul,249413,0,249413,2014.csv,2014,0.0,1.0
13644,Ask Nerede?,249279,0,249279,2015.csv,2015,0.0,1.0
13645,Henri 4,249187,0,249187,2010.csv,2010,0.0,1.0
13646,Maatr,249082,0,249082,2017.csv,2017,0.0,1.0
13647,The Wedding Year,249072,0,249072,2019.csv,2019,0.0,1.0
13648,Close Range,248978,0,248978,2015.csv,2015,0.0,1.0
13649,Tien Nu Khong Kieng Cu,248921,0,248921,2015.csv,2015,0.0,1.0
13650,The Chaperone 2019 Re-release,248633,0,248633,2019.csv,2019,0.0,1.0
13651,The Twilight Zone: A 60th Anniversary Celebration,248514,248514,0,2019.csv,2019,1.0,0.0
13652,Band Aid,248370,248370,0,2017.csv,2017,1.0,0.0
13653,Long Story Short,248355,0,248355,2015.csv,2015,0.0,1.0
13654,The Attacks of 26/11,248346,248346,0,2013.csv,2013,1.0,0.0
13655,These Days,248337,0,248337,2016.csv,2016,0.0,1.0
13656,Legendary Amazons,248280,0,248280,2011.csv,2011,0.0,1.0
13657,I peggiori,248126,0,248126,2017.csv,2017,0.0,1.0
13658,A Distant Neighbourhood/When We Leave,248110,0,248110,2010.csv,2010,0.0,1.0
13659,Azem 4: Alacakaranlik,247988,0,247988,2016.csv,2016,0.0,1.0
13660,The Chosen,247979,0,247979,2016.csv,2016,0.0,1.0
13661,Wild Oats,247949,40598,207351,2016.csv,2016,0.16373528427216888,0.8362647157278311
13662,Date a Live Movie: Mayuri Judgement,247826,0,247826,2015.csv,2015,0.0,1.0
13663,Doctor Who: The End of Time: Part One,247798,247798,0,2019.csv,2019,1.0,0.0
13664,Keep Going,247793,0,247793,2019.csv,2019,0.0,1.0
13665,The Team,247752,0,247752,2019.csv,2019,0.0,1.0
13666,Bus Palladium,247520,0,247520,2010.csv,2010,0.0,1.0
13667,Lilting,247377,27054,220323,2014.csv,2014,0.10936344122533623,0.8906365587746637
13668,Disney Junior Party,247274,0,247274,2015.csv,2015,0.0,1.0
13669,Rosemari,247269,0,247269,2016.csv,2016,0.0,1.0
13670,Taste of Spring,247237,0,247237,2010.csv,2010,0.0,1.0
13671,Sieranevada,247196,0,247196,2016.csv,2016,0.0,1.0
13672,The Galapagos Affair: Satan Came to Eden,247159,247159,0,2014.csv,2014,1.0,0.0
13673,Skazka. Est,247150,0,247150,2012.csv,2012,0.0,1.0
13674,El intercambio,246997,0,246997,2018.csv,2018,0.0,1.0
13675,Hacked,246996,0,246996,2020.csv,2020,0.0,1.0
13676,Treat Me Like Fire,246985,0,246985,2018.csv,2018,0.0,1.0
13677,Keep Surfing,246972,0,246972,2010.csv,2010,0.0,1.0
13678,Benimle Oynar misin?,246881,0,246881,2013.csv,2013,0.0,1.0
13679,Malefic,246819,0,246819,2015.csv,2015,0.0,1.0
13680,Walk with Me,246799,0,246799,2016.csv,2016,0.0,1.0
13681,Judgment Day,246782,0,246782,2013.csv,2013,0.0,1.0
13682,My Dog Tulip,246574,246574,0,2010.csv,2010,1.0,0.0
13683,The Notebook 2013 Re-release,246557,66559,179998,2013.csv,2013,0.2699538037857372,0.7300461962142628
13684,Kaakkaa Muttai,246551,0,246551,2015.csv,2015,0.0,1.0
13685,Anessa Mommy,246514,0,246514,2012.csv,2012,0.0,1.0
13686,Dastaan-E-Miri Piri,246411,0,246411,2019.csv,2019,0.0,1.0
13687,Cosmic Sin,246325,0,246325,2021.csv,2021,0.0,1.0
13688,The Love Witch,246218,228894,17324,2016.csv,2016,0.9296395876824602,0.07036041231753974
13689,Friendsgiving Day #1,246168,246168,0,2019.csv,2019,1.0,0.0
13690,Hot Summer Nights,246133,0,246133,2018.csv,2018,0.0,1.0
13691,Renkli Balik Yeni Dünyalar Kâsifi,246116,0,246116,2018.csv,2018,0.0,1.0
13692,Trust Me,246093,0,246093,2014.csv,2014,0.0,1.0
13693,Guilty of Romance,246091,0,246091,2011.csv,2011,0.0,1.0
13694,Harry Potter and the Deathly Hallows: Part 2 2020 Re-release,246044,0,246044,2020.csv,2020,0.0,1.0
13695,Shusenjo: The Main Battleground of the Comfort Women Issue,245947,0,245947,2019.csv,2019,0.0,1.0
13696,Oki's Movie,245903,0,245903,2010.csv,2010,0.0,1.0
13697,"Tuesday, After Christmas",245833,27813,218020,2010.csv,2010,0.1131377805258041,0.8868622194741959
13698,The Childhood of a Leader,245546,0,245546,2016.csv,2016,0.0,1.0
13699,Harry Potter and the Chamber of Secrets 2018 Re-release,245501,245501,0,2018.csv,2018,1.0,0.0
13700,American Woman,245416,236637,8779,2019.csv,2019,0.9642280861883495,0.03577191381165042
13701,Hayat Sana Güzel,245385,0,245385,2014.csv,2014,0.0,1.0
13702,Sleeping Sickness,245317,0,245317,2011.csv,2011,0.0,1.0
13703,Un conte peut en cacher un autre,245300,0,245300,2017.csv,2017,0.0,1.0
13704,Canim kardesim benim,245293,0,245293,2016.csv,2016,0.0,1.0
13705,Threesome,245155,0,245155,2014.csv,2014,0.0,1.0
13706,Hüddam,245105,0,245105,2015.csv,2015,0.0,1.0
13707,To the Ends of the World,245034,0,245034,2018.csv,2018,0.0,1.0
13708,The Fireflies Are Gone,245006,245006,0,2018.csv,2018,1.0,0.0
13709,BKO: Bangkok Knockout,244992,0,244992,2010.csv,2010,0.0,1.0
13710,"Klearchos, Marina, and the Short One",244952,0,244952,2015.csv,2015,0.0,1.0
13711,The Waiting Room,244951,244951,0,2012.csv,2012,1.0,0.0
13712,The Chessplayer,244806,0,244806,2017.csv,2017,0.0,1.0
13713,La Liga de los 5,244743,0,244743,2020.csv,2020,0.0,1.0
13714,Alma de Héroe,244739,0,244739,2019.csv,2019,0.0,1.0
13715,Low Season,244704,0,244704,2020.csv,2020,0.0,1.0
13716,Salvo,244686,0,244686,2013.csv,2013,0.0,1.0
13717,The Nightingale,244667,0,244667,2014.csv,2014,0.0,1.0
13718,Cheila: Una casa pa' Maíta,244505,0,244505,2010.csv,2010,0.0,1.0
13719,Fiksiki: Bolshoi Sekret,244439,0,244439,2017.csv,2017,0.0,1.0
13720,El Hijo,244401,0,244401,2019.csv,2019,0.0,1.0
13721,Yasamak Güzel Sey,244308,0,244308,2017.csv,2017,0.0,1.0
13722,Zejtra naporád,244274,0,244274,2014.csv,2014,0.0,1.0
13723,Niente può fermarci,244246,0,244246,2013.csv,2013,0.0,1.0
13724,Luca,244203,0,244203,2019.csv,2019,0.0,1.0
13725,Fascinating India 3D,244165,0,244165,2014.csv,2014,0.0,1.0
13726,Until the Birds Return,244065,0,244065,2017.csv,2017,0.0,1.0
13727,¿En dónde están los ladrones?,244047,0,244047,2017.csv,2017,0.0,1.0
13728,Tumbok,244040,0,244040,2011.csv,2011,0.0,1.0
13729,Sailor Suit and Machine Gun: Graduation,243965,0,243965,2016.csv,2016,0.0,1.0
13730,Noem My Skollie: Call Me Thief,243897,0,243897,2016.csv,2016,0.0,1.0
13731,The World of Us,243825,0,243825,2016.csv,2016,0.0,1.0
13732,Hung Ali And Sau Loc Coc,243825,0,243825,2015.csv,2015,0.0,1.0
13733,Term Life,243793,21256,222537,2016.csv,2016,0.08718872157937266,0.9128112784206274
13734,Kinshasa Symphony,243774,0,243774,2010.csv,2010,0.0,1.0
13735,Snowlidays,243770,0,243770,2019.csv,2019,0.0,1.0
13736,Prima di tutto,243714,0,243714,2012.csv,2012,0.0,1.0
13737,The Two Popes,243711,0,243711,2019.csv,2019,0.0,1.0
13738,My Uncle Rafael,243616,243616,0,2012.csv,2012,1.0,0.0
13739,Midsummer Night's Tango,243502,0,243502,2014.csv,2014,0.0,1.0
13740,Im weißen Rössl - Wehe Du singst!,243344,0,243344,2013.csv,2013,0.0,1.0
13741,Mahalai Tiang Kuen,243344,0,243344,2016.csv,2016,0.0,1.0
13742,"Hi, Fidelity",243340,0,243340,2011.csv,2011,0.0,1.0
13743,29 + 1,243251,0,243251,2017.csv,2017,0.0,1.0
13744,Rangeelay,243246,148418,94828,2013.csv,2013,0.6101559737878526,0.38984402621214737
13745,The Lullaby,242997,0,242997,2018.csv,2018,0.0,1.0
13746,The Great Bird Race,242951,0,242951,2012.csv,2012,0.0,1.0
13747,Survival of the Dead 2011 Re-release,242887,0,242887,2011.csv,2011,0.0,1.0
13748,Rogue,242884,0,242884,2020.csv,2020,0.0,1.0
13749,Love Is All,242850,0,242850,2011.csv,2011,0.0,1.0
13750,Out of Blue,242847,18779,224068,2019.csv,2019,0.07732852372069657,0.9226714762793035
13751,Capt'n Sharky,242781,0,242781,2018.csv,2018,0.0,1.0
13752,Black and White,242743,0,242743,2010.csv,2010,0.0,1.0
13753,My Perestroika,242707,242707,0,2011.csv,2011,1.0,0.0
13754,Can't Help Falling in Love,242563,0,242563,2017.csv,2017,0.0,1.0
13755,Sir-Ayet,242540,0,242540,2019.csv,2019,0.0,1.0
13756,Tevar,242453,236002,6451,2015.csv,2015,0.9733927812813205,0.026607218718679496
13757,Pinon Fijo Y La Magia De La Musica,242451,0,242451,2012.csv,2012,0.0,1.0
13758,Archive,242195,139593,102602,2020.csv,2020,0.576366151241768,0.423633848758232
13759,Tomorrow and Thereafter,242189,0,242189,2017.csv,2017,0.0,1.0
13760,Real: The Plan Behind History,242117,0,242117,2017.csv,2017,0.0,1.0
13761,Ophelia,242115,50722,191393,2019.csv,2019,0.2094954876814737,0.7905045123185264
13762,Shivaay,241862,0,241862,2016.csv,2016,0.0,1.0
13763,Konfetti,241791,0,241791,2014.csv,2014,0.0,1.0
13764,Road,241744,0,241744,2014.csv,2014,0.0,1.0
13765,The Rooms,241674,0,241674,2014.csv,2014,0.0,1.0
13766,Birds of Paradise 2013 Re-release,241638,0,241638,2013.csv,2013,0.0,1.0
13767,3 Days to Go,241617,0,241617,2019.csv,2019,0.0,1.0
13768,Die mit dem Bauch tanzen,241585,0,241585,2013.csv,2013,0.0,1.0
13769,Comment j'ai rencontré mon père,241565,0,241565,2017.csv,2017,0.0,1.0
13770,Shaolin 2013 Re-release,241479,0,241479,2013.csv,2013,0.0,1.0
13771,Hotell,241408,0,241408,2013.csv,2013,0.0,1.0
13772,Housebound,241347,0,241347,2014.csv,2014,0.0,1.0
13773,Paco,241320,0,241320,2010.csv,2010,0.0,1.0
13774,ASTRUP - Flammen over Jølster,241221,0,241221,2019.csv,2019,0.0,1.0
13775,Bekar Bekir,241207,0,241207,2017.csv,2017,0.0,1.0
13776,Comali,241157,0,241157,2019.csv,2019,0.0,1.0
13777,Blindsone,241031,0,241031,2018.csv,2018,0.0,1.0
13778,Brotherhood,240887,8979,231908,2010.csv,2010,0.03727473877793322,0.9627252612220668
13779,Uno per tutti,240833,0,240833,2015.csv,2015,0.0,1.0
13780,Psalm 21 2012 Re-release,240792,0,240792,2012.csv,2012,0.0,1.0
13781,The Border,240761,0,240761,2010.csv,2010,0.0,1.0
13782,Brothers of the Wind 2018 Re-release,240730,0,240730,2018.csv,2018,0.0,1.0
13783,Road to Ninja - Naruto the Movie 2014 Re-release,240687,43171,197516,2014.csv,2014,0.17936573225807792,0.820634267741922
13784,Dolceroma,240651,0,240651,2019.csv,2019,0.0,1.0
13785,The Days That Confused,240647,0,240647,2016.csv,2016,0.0,1.0
13786,Ruby Sparks 2018 Re-release,240540,0,240540,2018.csv,2018,0.0,1.0
13787,Ghost in the Shell Arise: Border 3 - Ghost Tears,240470,0,240470,2014.csv,2014,0.0,1.0
13788,Boulevard,240450,126150,114300,2015.csv,2015,0.5246412975670618,0.47535870243293826
13789,Pretty Butterflies,240368,0,240368,2012.csv,2012,0.0,1.0
13790,The Foreigner,240293,0,240293,2012.csv,2012,0.0,1.0
13791,Icebreaking,240233,0,240233,2019.csv,2019,0.0,1.0
13792,Carter High,240214,240214,0,2015.csv,2015,1.0,0.0
13793,On the Bride's Side,240181,0,240181,2014.csv,2014,0.0,1.0
13794,The Trip to Greece,240165,8340,231825,2020.csv,2020,0.03472612578852039,0.9652738742114796
13795,Of Horses and Men,239969,11894,228075,2013.csv,2013,0.04956473544499498,0.950435264555005
13796,Good Luck,239934,0,239934,2012.csv,2012,0.0,1.0
13797,My Grandpa Is an Alien,239884,0,239884,2019.csv,2019,0.0,1.0
13798,Peterburg. Tolko po lyubvi,239812,0,239812,2016.csv,2016,0.0,1.0
13799,I Believe in Miracles,239770,0,239770,2015.csv,2015,0.0,1.0
13800,The Startup: Accendi il tuo futuro,239735,0,239735,2017.csv,2017,0.0,1.0
13801,Omnipresent,239415,0,239415,2017.csv,2017,0.0,1.0
13802,Little Rose,239380,0,239380,2010.csv,2010,0.0,1.0
13803,Adventures of Gustavas,239364,0,239364,2015.csv,2015,0.0,1.0
13804,L'arte della felicità,239348,0,239348,2013.csv,2013,0.0,1.0
13805,"Endings, Beginnings",239231,0,239231,2019.csv,2019,0.0,1.0
13806,Dark River,239182,7714,231468,2018.csv,2018,0.03225159083877549,0.9677484091612245
13807,Babette's Feast 2012 Re-release,238982,0,238982,2012.csv,2012,0.0,1.0
13808,Ammar 2: Cin Istilasi,238902,0,238902,2016.csv,2016,0.0,1.0
13809,311 Enlarged to Show Detail 3,238791,238791,0,2019.csv,2019,1.0,0.0
13810,Crown Heights,238558,238558,0,2017.csv,2017,1.0,0.0
13811,Barcelona: A Love Untold,238540,0,238540,2016.csv,2016,0.0,1.0
13812,Theeran Adhigaram Ondru,238484,0,238484,2017.csv,2017,0.0,1.0
13813,RWBY: Argus Limited,238379,238379,0,2018.csv,2018,1.0,0.0
13814,Backyard Ashes,238271,0,238271,2013.csv,2013,0.0,1.0
13815,Red Obsession,238223,13199,225024,2013.csv,2013,0.05540606910331916,0.9445939308966809
13816,Love Bite,238177,0,238177,2012.csv,2012,0.0,1.0
13817,The Brass Teapot 2014 Re-release,238030,0,238030,2014.csv,2014,0.0,1.0
13818,Tony,238019,0,238019,2019.csv,2019,0.0,1.0
13819,Valstybes paslaptis,237918,0,237918,2019.csv,2019,0.0,1.0
13820,The House at the End of Time 2014 Re-release,237909,0,237909,2014.csv,2014,0.0,1.0
13821,Distractions,237906,0,237906,2015.csv,2015,0.0,1.0
13822,The Gate,237809,0,237809,2014.csv,2014,0.0,1.0
13823,American Satan,237708,237708,0,2017.csv,2017,1.0,0.0
13824,The Lord of the Rings: The Return of the King 2020 Re-release,237586,0,237586,2020.csv,2020,0.0,1.0
13825,Tokyo Godfathers 2020 Re-release,237571,237571,0,2020.csv,2020,1.0,0.0
13826,Alien Intrusion: Unmasking a Deception,237411,237411,0,2018.csv,2018,1.0,0.0
13827,Jungle Beat: The Movie,237312,0,237312,2020.csv,2020,0.0,1.0
13828,Shuddh Desi Romance,237249,0,237249,2013.csv,2013,0.0,1.0
13829,Star Wars: Episode IV - A New Hope 2020 Re-release,237148,0,237148,2020.csv,2020,0.0,1.0
13830,"Exhibition on Screen: Leonardo from the National Gallery, London",237071,0,237071,2012.csv,2012,0.0,1.0
13831,Polnische Ostern,237048,0,237048,2011.csv,2011,0.0,1.0
13832,Un Dios prohibido,236957,0,236957,2013.csv,2013,0.0,1.0
13833,Felicità,236880,0,236880,2020.csv,2020,0.0,1.0
13834,Tadao Ando - Samurai Architect,236829,0,236829,2019.csv,2019,0.0,1.0
13835,The Hunter's Prayer,236820,0,236820,2017.csv,2017,0.0,1.0
13836,Middle of Nowhere,236806,236806,0,2012.csv,2012,1.0,0.0
13837,Home Team,236550,0,236550,2017.csv,2017,0.0,1.0
13838,Remembrance,236246,0,236246,2013.csv,2013,0.0,1.0
13839,Intruders,236192,0,236192,2016.csv,2016,0.0,1.0
13840,The Only Way Out,236062,0,236062,2021.csv,2021,0.0,1.0
13841,Exhibition on Screen: Degas - Passion For Perfection,235954,0,235954,2019.csv,2019,0.0,1.0
13842,Timing,235716,0,235716,2015.csv,2015,0.0,1.0
13843,The Vice of Hope,235442,0,235442,2018.csv,2018,0.0,1.0
13844,Varda by Agnès,235370,160765,74605,2019.csv,2019,0.6830309725113651,0.3169690274886349
13845,India's Most Wanted,235351,176858,58493,2019.csv,2019,0.7514648333765312,0.24853516662346878
13846,Nothing for Mahala,235337,0,235337,2013.csv,2013,0.0,1.0
13847,Warsaw by Night,235249,0,235249,2015.csv,2015,0.0,1.0
13848,Tell Me How I Die,235208,0,235208,2017.csv,2017,0.0,1.0
13849,The Exorcist Extended Director's Cut,235134,235134,0,2010.csv,2010,1.0,0.0
13850,Journey to Greenland,235055,0,235055,2016.csv,2016,0.0,1.0
13851,Diamantino,235041,70088,164953,2018.csv,2018,0.29819478303785296,0.701805216962147
13852,Art and Craft,235037,235037,0,2014.csv,2014,1.0,0.0
13853,Uncle,234968,0,234968,2015.csv,2015,0.0,1.0
13854,The Extreme Tragic Story of Celal Tan and His Family,234818,0,234818,2011.csv,2011,0.0,1.0
13855,Rheingold - Gesichter eines Flusses,234533,0,234533,2014.csv,2014,0.0,1.0
13856,Blind Eyes Opened,234505,234505,0,2020.csv,2020,1.0,0.0
13857,3 Peas in a Pod,234434,0,234434,2013.csv,2013,0.0,1.0
13858,The Frighten Studio,234423,0,234423,2017.csv,2017,0.0,1.0
13859,Hounds of Love,234419,0,234419,2017.csv,2017,0.0,1.0
13860,After the Ball,234417,161820,72597,2015.csv,2015,0.6903082967532218,0.3096917032467782
13861,The Lies of the Victors,234376,0,234376,2015.csv,2015,0.0,1.0
13862,Kärlek deluxe,234337,0,234337,2014.csv,2014,0.0,1.0
13863,Po nebu bosikom,234164,0,234164,2015.csv,2015,0.0,1.0
13864,Fiddlesticks,234151,0,234151,2014.csv,2014,0.0,1.0
13865,Jonathan,234052,0,234052,2016.csv,2016,0.0,1.0
13866,Tempos,233968,0,233968,2020.csv,2020,0.0,1.0
13867,The Cat Vanishes,233892,0,233892,2011.csv,2011,0.0,1.0
13868,Little Shop of Horrors 2017 Re-release,233865,233865,0,2017.csv,2017,1.0,0.0
13869,Antes de la quema,233804,0,233804,2019.csv,2019,0.0,1.0
13870,Das Pferd auf dem Balkon,233715,0,233715,2012.csv,2012,0.0,1.0
13871,Superman 2018 Re-release,233585,233585,0,2018.csv,2018,1.0,0.0
13872,Mullewapp - Eine schöne Schweinerei,233553,0,233553,2017.csv,2017,0.0,1.0
13873,The Disciple,233528,0,233528,2010.csv,2010,0.0,1.0
13874,Alva Og Regnbuedragen,233397,0,233397,2020.csv,2020,0.0,1.0
13875,Vellam,233364,0,233364,2021.csv,2021,0.0,1.0
13876,Narcissus and Goldmund,233325,0,233325,2020.csv,2020,0.0,1.0
13877,Fort Ross,233290,0,233290,2014.csv,2014,0.0,1.0
13878,U311 Cherkasy,233284,0,233284,2020.csv,2020,0.0,1.0
13879,Seotaiji Band Live Tour,233223,0,233223,2010.csv,2010,0.0,1.0
13880,The Room 2020 Re-release,233166,0,233166,2020.csv,2020,0.0,1.0
13881,Suursuz Ask,233066,0,233066,2019.csv,2019,0.0,1.0
13882,Premier Boxing Champions: PBC on FOX: Spence vs. Porter,232973,232973,0,2019.csv,2019,1.0,0.0
13883,Little Tito and the Aliens,232931,0,232931,2018.csv,2018,0.0,1.0
13884,Lost and Found in Armenia,232857,122305,110552,2012.csv,2012,0.5252365185500114,0.47476348144998864
13885,Tamizh Padam 2.0,232835,0,232835,2018.csv,2018,0.0,1.0
13886,My Father Jack,232616,0,232616,2016.csv,2016,0.0,1.0
13887,Triple Trouble,232407,0,232407,2015.csv,2015,0.0,1.0
13888,The Report,232305,0,232305,2019.csv,2019,0.0,1.0
13889,Trainee Day,232289,0,232289,2016.csv,2016,0.0,1.0
13890,"Dis Koue Kos, Skat",232183,0,232183,2016.csv,2016,0.0,1.0
13891,Octav,232096,0,232096,2017.csv,2017,0.0,1.0
13892,7 Letters,232027,0,232027,2015.csv,2015,0.0,1.0
13893,Before the Vigil,232007,0,232007,2013.csv,2013,0.0,1.0
13894,Love Syndrome rak ngo ngo,231854,0,231854,2013.csv,2013,0.0,1.0
13895,Cinnamon,231738,0,231738,2013.csv,2013,0.0,1.0
13896,Zoo,231719,0,231719,2018.csv,2018,0.0,1.0
13897,Daawat-e-Ishq,231688,0,231688,2014.csv,2014,0.0,1.0
13898,Prey,231548,0,231548,2016.csv,2016,0.0,1.0
13899,Bishôjo senshi Sailor Moon Super S Special,231434,231434,0,2018.csv,2018,1.0,0.0
13900,A Place at the Table,231378,231378,0,2013.csv,2013,1.0,0.0
13901,Imaikkaa Nodigal,231368,0,231368,2018.csv,2018,0.0,1.0
13902,Toei Manga Matsuri 2020,231148,0,231148,2020.csv,2020,0.0,1.0
13903,The Quartette,231145,0,231145,2017.csv,2017,0.0,1.0
13904,Kto-nibud videl moyu devchonku?,231092,0,231092,2021.csv,2021,0.0,1.0
13905,Veeram,231046,0,231046,2014.csv,2014,0.0,1.0
13906,A Bump Along the Way,230963,0,230963,2019.csv,2019,0.0,1.0
13907,The Gospel of the Flesh,230797,0,230797,2013.csv,2013,0.0,1.0
13908,DAZN Boxing: Canelo Alvarez vs. Daniel Jacobs,230703,230703,0,2019.csv,2019,1.0,0.0
13909,All for One,230619,0,230619,2017.csv,2017,0.0,1.0
13910,"Life, Above All",230529,134461,96068,2011.csv,2011,0.5832715189845963,0.4167284810154037
13911,Star Wars: Episode VII - The Force Awakens 2020 Re-release,230509,0,230509,2020.csv,2020,0.0,1.0
13912,The Family Running Forward,230475,0,230475,2016.csv,2016,0.0,1.0
13913,Infini-T Force the Movie: Farewell Gatchaman My Friend,230383,0,230383,2018.csv,2018,0.0,1.0
13914,Morgue,230215,0,230215,2019.csv,2019,0.0,1.0
13915,Going Clear: Scientology & the Prison of Belief,230194,0,230194,2015.csv,2015,0.0,1.0
13916,Angel of Mine,230193,0,230193,2019.csv,2019,0.0,1.0
13917,The Red Spider,230141,0,230141,2015.csv,2015,0.0,1.0
13918,Chakravyuh,230136,151778,78358,2012.csv,2012,0.6595143741092224,0.34048562589077763
13919,El Pais Mas Feliz Del Mundo,230113,0,230113,2017.csv,2017,0.0,1.0
13920,Justice for All with Judge Cristina Perez: Credit Repair & No Broken Glass Permission,230030,0,230030,2016.csv,2016,0.0,1.0
13921,"Belle and Sebastian, Friends for Life 2018 Re-release",229983,105890,124093,2018.csv,2018,0.4604253357856885,0.5395746642143114
13922,Sundown,229963,0,229963,2016.csv,2016,0.0,1.0
13923,David Byrne's American Utopia,229731,0,229731,2020.csv,2020,0.0,1.0
13924,Titli,229691,0,229691,2015.csv,2015,0.0,1.0
13925,Wrecked,229532,8020,221512,2011.csv,2011,0.03494066186849764,0.9650593381315024
13926,Third Eye,229531,0,229531,2014.csv,2014,0.0,1.0
13927,Fourth Place,229510,0,229510,2016.csv,2016,0.0,1.0
13928,Bróder,229437,0,229437,2011.csv,2011,0.0,1.0
13929,The Teacher,229227,0,229227,2015.csv,2015,0.0,1.0
13930,Irumbu Thirai,229163,0,229163,2018.csv,2018,0.0,1.0
13931,Milenge Milenge,229104,0,229104,2010.csv,2010,0.0,1.0
13932,A Matter of Principles 2011 Re-release,229049,0,229049,2011.csv,2011,0.0,1.0
13933,Wolfwalkers,229041,0,229041,2020.csv,2020,0.0,1.0
13934,After the Revolution,228984,0,228984,2011.csv,2011,0.0,1.0
13935,Geuk-jang-pan Peu-ri-pa-ra Mo-du Mo-yeo-ra! Peu-ri-jeum Tu-eo-jeu,228903,0,228903,2016.csv,2016,0.0,1.0
13936,Pressure,228892,0,228892,2015.csv,2015,0.0,1.0
13937,Sunday Holiday,228878,0,228878,2017.csv,2017,0.0,1.0
13938,Kalushi: The Story of Solomon Mahlangu,228865,0,228865,2017.csv,2017,0.0,1.0
13939,Let the Child Be the Guide,228770,0,228770,2017.csv,2017,0.0,1.0
13940,The Taming of the Shrew - Bolshoi 2016,228755,0,228755,2016.csv,2016,0.0,1.0
13941,Primal,228679,0,228679,2019.csv,2019,0.0,1.0
13942,The Last Tree,228676,10128,218548,2019.csv,2019,0.04428973744511886,0.9557102625548811
13943,I Am Wrath,228631,0,228631,2016.csv,2016,0.0,1.0
13944,Doctor Who Live Q&A And Screening,228615,228615,0,2020.csv,2020,1.0,0.0
13945,Mein Lotta-Leben,228385,0,228385,2019.csv,2019,0.0,1.0
13946,City of Ghosts,228225,128015,100210,2017.csv,2017,0.560915762953226,0.439084237046774
13947,Jeremiah Tower: The Last Magnificent,228153,228153,0,2017.csv,2017,1.0,0.0
13948,The Greatest Miracle 2013 Re-release,228084,0,228084,2013.csv,2013,0.0,1.0
13949,Big Brother,228014,0,228014,2020.csv,2020,0.0,1.0
13950,InAPPropriate Comedy,228004,228004,0,2013.csv,2013,1.0,0.0
13951,The Great Escape 2019 Re-release,227940,0,227940,2019.csv,2019,0.0,1.0
13952,Glass Dolls,227857,0,227857,2014.csv,2014,0.0,1.0
13953,Mon maître d'école,227808,0,227808,2016.csv,2016,0.0,1.0
13954,Aire libre,227781,0,227781,2014.csv,2014,0.0,1.0
13955,Bhoothnath Returns,227756,0,227756,2014.csv,2014,0.0,1.0
13956,Katamarayudu,227747,0,227747,2017.csv,2017,0.0,1.0
13957,It Gets Better,227745,0,227745,2012.csv,2012,0.0,1.0
13958,Ruben Guthrie,227691,0,227691,2015.csv,2015,0.0,1.0
13959,Stockholm 2019 Re-release,227458,0,227458,2019.csv,2019,0.0,1.0
13960,Like Water,227332,0,227332,2012.csv,2012,0.0,1.0
13961,The Plan,227321,0,227321,2017.csv,2017,0.0,1.0
13962,Sket,227283,0,227283,2011.csv,2011,0.0,1.0
13963,The Nutcracker: The Untold Story 2013 Re-release,227146,0,227146,2013.csv,2013,0.0,1.0
13964,Studio 54,227062,199767,27295,2018.csv,2018,0.879790541790348,0.120209458209652
13965,Sahane Hayaller,226809,0,226809,2020.csv,2020,0.0,1.0
13966,Smuggling Hendrix,226749,0,226749,2019.csv,2019,0.0,1.0
13967,Le grand jeu,226708,0,226708,2015.csv,2015,0.0,1.0
13968,Jallikattu,226658,0,226658,2019.csv,2019,0.0,1.0
13969,"I, Olga Hepnarova",226645,0,226645,2016.csv,2016,0.0,1.0
13970,El sueño de todos,226535,0,226535,2014.csv,2014,0.0,1.0
13971,The Long Way Home,226440,0,226440,2013.csv,2013,0.0,1.0
13972,Mine 9,226421,226421,0,2019.csv,2019,1.0,0.0
13973,Extraterrestrial,226405,0,226405,2012.csv,2012,0.0,1.0
13974,Saranae Love You,226238,0,226238,2017.csv,2017,0.0,1.0
13975,Magikos kathreftis,226218,0,226218,2016.csv,2016,0.0,1.0
13976,Manda yuvasi,226112,0,226112,2015.csv,2015,0.0,1.0
13977,Rumble: The Indians Who Rocked The World,226006,226006,0,2017.csv,2017,1.0,0.0
13978,Schellebelle 1919,225937,0,225937,2011.csv,2011,0.0,1.0
13979,The Great Emperor,225876,0,225876,2016.csv,2016,0.0,1.0
13980,Galveston,225795,0,225795,2018.csv,2018,0.0,1.0
13981,Ülkücüler,225641,0,225641,2012.csv,2012,0.0,1.0
13982,October November,225596,0,225596,2013.csv,2013,0.0,1.0
13983,Nora's Will,225525,0,225525,2010.csv,2010,0.0,1.0
13984,Dr. Cabbie,225490,225490,0,2014.csv,2014,1.0,0.0
13985,Sevkat Yerimdar 2: Bizde Sakat Çok,225471,0,225471,2016.csv,2016,0.0,1.0
13986,Millennium Actress 2019 Re-release,225250,225250,0,2019.csv,2019,1.0,0.0
13987,My Own Love Song,225246,0,225246,2010.csv,2010,0.0,1.0
13988,A Night in Old Mexico,225222,0,225222,2014.csv,2014,0.0,1.0
13989,Double DI Trouble,225110,0,225110,2014.csv,2014,0.0,1.0
13990,Hebe: The Brazilian Star,224934,0,224934,2019.csv,2019,0.0,1.0
13991,Tootsies & the Fake,224766,0,224766,2020.csv,2020,0.0,1.0
13992,Reshala. Nulevye,224764,0,224764,2020.csv,2020,0.0,1.0
13993,Deadpool 2020 Re-release,224636,0,224636,2020.csv,2020,0.0,1.0
13994,Helen,224613,0,224613,2019.csv,2019,0.0,1.0
13995,Onna Ga Nemurutoki,224566,0,224566,2016.csv,2016,0.0,1.0
13996,Vientos de la Habana,224540,0,224540,2016.csv,2016,0.0,1.0
13997,Mozzarella Stories,224494,0,224494,2011.csv,2011,0.0,1.0
13998,The Field of Enchantment,224488,0,224488,2011.csv,2011,0.0,1.0
13999,Nostalgia for the Light 2012 Re-release,224445,0,224445,2012.csv,2012,0.0,1.0
14000,Fatima the Ultimate Mystery,224441,0,224441,2017.csv,2017,0.0,1.0
14001,The Black Waters of Echo's Pond,224409,224409,0,2010.csv,2010,1.0,0.0
14002,Wizard,224396,0,224396,2019.csv,2019,0.0,1.0
14003,Not on My Watch,224347,0,224347,2017.csv,2017,0.0,1.0
14004,The Vatican Museums,224278,0,224278,2014.csv,2014,0.0,1.0
14005,Freerunner,224236,0,224236,2012.csv,2012,0.0,1.0
14006,Boyaco Man,224232,0,224232,2019.csv,2019,0.0,1.0
14007,Experimenter,224145,155575,68570,2015.csv,2015,0.6940819558767762,0.3059180441232238
14008,Little Baby Jesus,224129,0,224129,2013.csv,2013,0.0,1.0
14009,Poka noch ne razluchit,224101,0,224101,2012.csv,2012,0.0,1.0
14010,Tampopo,224097,224097,0,2016.csv,2016,1.0,0.0
14011,The Flowers of Kirkuk,224084,0,224084,2010.csv,2010,0.0,1.0
14012,Kadaikutty Singam,224049,0,224049,2018.csv,2018,0.0,1.0
14013,Jatts in Golmaal,224018,0,224018,2013.csv,2013,0.0,1.0
14014,A Fantastic Ghost Wedding,223930,0,223930,2014.csv,2014,0.0,1.0
14015,Extra Ordinary,223898,164346,59552,2019.csv,2019,0.7340217420432519,0.2659782579567482
14016,Premier Boxing Champions: PBC on FOX PPV: Pacquiao vs. Thurman,223858,223858,0,2019.csv,2019,1.0,0.0
14017,Rust,223845,0,223845,2011.csv,2011,0.0,1.0
14018,Appena un minuto,223827,0,223827,2019.csv,2019,0.0,1.0
14019,Crystal Fairy & the Magical Cactus,223821,202370,21451,2013.csv,2013,0.9041600207308519,0.09583997926914811
14020,Their Distance,223795,0,223795,2017.csv,2017,0.0,1.0
14021,The Melody,223723,0,223723,2012.csv,2012,0.0,1.0
14022,BuyBust,223720,178471,45249,2018.csv,2018,0.7977427141069193,0.20225728589308065
14023,Tim and Eric's Billion Dollar Movie,223580,201436,22144,2012.csv,2012,0.9009571518024868,0.09904284819751319
14024,Love and Lies,223574,0,223574,2017.csv,2017,0.0,1.0
14025,Shoo bre,223497,0,223497,2012.csv,2012,0.0,1.0
14026,Take Every Wave: The Life of Laird Hamilton,223301,176076,47225,2017.csv,2017,0.7885141580198924,0.21148584198010756
14027,Forsaken,223287,0,223287,2018.csv,2018,0.0,1.0
14028,Venghai,223204,0,223204,2011.csv,2011,0.0,1.0
14029,The Road To Hippie,223188,0,223188,2019.csv,2019,0.0,1.0
14030,Lincz,223165,0,223165,2011.csv,2011,0.0,1.0
14031,Nothing But the Truth 2015 Re-release,223130,0,223130,2015.csv,2015,0.0,1.0
14032,Jonas Kaufmann: Under the Stars,223121,0,223121,2018.csv,2018,0.0,1.0
14033,After You're Gone,223014,0,223014,2017.csv,2017,0.0,1.0
14034,Never Surrender: A Galaxy Quest Documentary,222971,222971,0,2019.csv,2019,1.0,0.0
14035,Chouquette,222952,0,222952,2017.csv,2017,0.0,1.0
14036,Lucky Day,222945,0,222945,2019.csv,2019,0.0,1.0
14037,My Little Pony: Equestria Girls - Friendship Games,222840,0,222840,2015.csv,2015,0.0,1.0
14038,Shooting Stars,222755,0,222755,2015.csv,2015,0.0,1.0
14039,Leo the Lion,222735,0,222735,2012.csv,2012,0.0,1.0
14040,Günce,222616,0,222616,2013.csv,2013,0.0,1.0
14041,Todas las mujeres,222572,0,222572,2013.csv,2013,0.0,1.0
14042,Spirit of the Game,222565,222565,0,2016.csv,2016,1.0,0.0
14043,My Awkward Sexual Adventure,222560,0,222560,2013.csv,2013,0.0,1.0
14044,10.000 Km,222530,12423,210107,2014.csv,2014,0.055826180739675546,0.9441738192603244
14045,United States of Love,222482,0,222482,2016.csv,2016,0.0,1.0
14046,"Indio, La Pelicula",222429,0,222429,2015.csv,2015,0.0,1.0
14047,Oh! Father,222390,0,222390,2014.csv,2014,0.0,1.0
14048,Lien se Lankstaanskoene,222209,0,222209,2013.csv,2013,0.0,1.0
14049,Kung Fu Pho,222207,0,222207,2015.csv,2015,0.0,1.0
14050,Film socialisme,222079,42925,179154,2010.csv,2010,0.1932870735188829,0.806712926481117
14051,Feedback,221975,0,221975,2019.csv,2019,0.0,1.0
14052,The Life of Fish,221975,0,221975,2010.csv,2010,0.0,1.0
14053,7 Aum Arivu,221894,0,221894,2011.csv,2011,0.0,1.0
14054,Ángel o demonio: El demonio de los celos,221879,0,221879,2014.csv,2014,0.0,1.0
14055,La cueva,221858,0,221858,2014.csv,2014,0.0,1.0
14056,Untouchable,221801,0,221801,2019.csv,2019,0.0,1.0
14057,Neighbor,221774,0,221774,2019.csv,2019,0.0,1.0
14058,Tokyo Oasis,221620,0,221620,2011.csv,2011,0.0,1.0
14059,High School,221590,139034,82556,2012.csv,2012,0.627438061284354,0.372561938715646
14060,Junga,221554,0,221554,2018.csv,2018,0.0,1.0
14061,Aschenbrödel und der gestiefelte Kater,221501,0,221501,2013.csv,2013,0.0,1.0
14062,The Con is On,221359,0,221359,2018.csv,2018,0.0,1.0
14063,The Bang Bang Club,221292,0,221292,2011.csv,2011,0.0,1.0
14064,Rockin' on Heaven's Door,221232,0,221232,2013.csv,2013,0.0,1.0
14065,Simonal,221209,0,221209,2019.csv,2019,0.0,1.0
14066,Neil Young Journeys,221082,215026,6056,2012.csv,2012,0.9726074488198949,0.02739255118010512
14067,Phantom Boy,221016,34362,186654,2015.csv,2015,0.15547290693886415,0.8445270930611358
14068,Day of the Flowers,220991,0,220991,2013.csv,2013,0.0,1.0
14069,Little Pink House,220948,220948,0,2018.csv,2018,1.0,0.0
14070,The Devil's Tomb,220925,0,220925,2010.csv,2010,0.0,1.0
14071,The Flight of the Swan,220884,0,220884,2011.csv,2011,0.0,1.0
14072,8E88 Fan Lanla,220859,0,220859,2010.csv,2010,0.0,1.0
14073,Beyond Beyond,220784,0,220784,2014.csv,2014,0.0,1.0
14074,Chance Pe Dance,220619,168643,51976,2010.csv,2010,0.7644083238524334,0.23559167614756663
14075,Dirty Hearts,220593,0,220593,2012.csv,2012,0.0,1.0
14076,My Big Gay Italian Wedding 2019 Re-release,220563,0,220563,2019.csv,2019,0.0,1.0
14077,New Initial D the Movie: Legend 2 - Racer,220527,0,220527,2015.csv,2015,0.0,1.0
14078,Thomas & Friends: Day of the Diesels,220509,0,220509,2011.csv,2011,0.0,1.0
14079,Police Academy Alaturka,220483,0,220483,2015.csv,2015,0.0,1.0
14080,Blood Ransom,220388,0,220388,2014.csv,2014,0.0,1.0
14081,Survive the Night,220371,0,220371,2020.csv,2020,0.0,1.0
14082,Journeyman,220353,0,220353,2018.csv,2018,0.0,1.0
14083,Daegyeol,220234,0,220234,2016.csv,2016,0.0,1.0
14084,Supermensch,220065,213064,7001,2014.csv,2014,0.9681866721196011,0.03181332788039897
14085,Baby Mamas,220061,0,220061,2018.csv,2018,0.0,1.0
14086,Lost in Wrestling,220000,0,220000,2015.csv,2015,0.0,1.0
14087,Le grand bal,219982,0,219982,2018.csv,2018,0.0,1.0
14088,Geld her oder Autsch'n!,219897,0,219897,2013.csv,2013,0.0,1.0
14089,Women's Day,219893,0,219893,2013.csv,2013,0.0,1.0
14090,Bangla,219867,0,219867,2019.csv,2019,0.0,1.0
14091,Bobby Sands: 66 Days,219765,0,219765,2016.csv,2016,0.0,1.0
14092,Anna's War,219720,0,219720,2019.csv,2019,0.0,1.0
14093,A Quiet Outpost,219698,0,219698,2011.csv,2011,0.0,1.0
14094,The Fourth Revolution: Energy,219694,0,219694,2010.csv,2010,0.0,1.0
14095,Bendita calamidad,219640,0,219640,2015.csv,2015,0.0,1.0
14096,Lucky Chan-sil,219623,0,219623,2020.csv,2020,0.0,1.0
14097,The Metropolitan Opera HD Live: Puccini: Turandot,219619,172627,46992,2016.csv,2016,0.7860294418971037,0.2139705581028964
14098,Space Dogs: Adventure to the Moon 2016 Re-release,219459,0,219459,2016.csv,2016,0.0,1.0
14099,Brooklyn Castle,219407,219407,0,2012.csv,2012,1.0,0.0
14100,Fragments of Truth,219342,219342,0,2018.csv,2018,1.0,0.0
14101,Club Life,219229,4444,214785,2015.csv,2015,0.020271040783837905,0.9797289592161621
14102,Kiwi Christmas,219213,0,219213,2017.csv,2017,0.0,1.0
14103,The House I Live In,219159,210752,8407,2012.csv,2012,0.9616397227583626,0.03836027724163735
14104,Fascinated Love,219012,0,219012,2017.csv,2017,0.0,1.0
14105,The Second Coming,218889,0,218889,2014.csv,2014,0.0,1.0
14106,Thamaasha,218812,0,218812,2019.csv,2019,0.0,1.0
14107,Harry Potter and the Prisoner of Azkaban 2018 Re-release,218774,218774,0,2018.csv,2018,1.0,0.0
14108,Operation Goldenshell,218702,0,218702,2017.csv,2017,0.0,1.0
14109,Flora and Fauna's War,218568,0,218568,2016.csv,2016,0.0,1.0
14110,California Typewriter,218563,218563,0,2017.csv,2017,1.0,0.0
14111,The Most Beautiful Season,218412,0,218412,2018.csv,2018,0.0,1.0
14112,La montaña rusa,218262,0,218262,2012.csv,2012,0.0,1.0
14113,"Ruben Brandt, Collector",218184,0,218184,2018.csv,2018,0.0,1.0
14114,Kabir Azabi,218181,0,218181,2018.csv,2018,0.0,1.0
14115,La Sucursal,218139,0,218139,2019.csv,2019,0.0,1.0
14116,Oi gabroi tis Eftyhias,218077,0,218077,2015.csv,2015,0.0,1.0
14117,Babbo Natale non viene da Nord,218067,0,218067,2015.csv,2015,0.0,1.0
14118,Guardian Angel 2015 Re-release,217996,0,217996,2015.csv,2015,0.0,1.0
14119,Dark Money,217932,217932,0,2018.csv,2018,1.0,0.0
14120,Getting Grace,217812,217812,0,2018.csv,2018,1.0,0.0
14121,War Horse,217803,0,217803,2014.csv,2014,0.0,1.0
14122,"Pistolet, Kufar i 3 smurdyashti varela",217794,0,217794,2012.csv,2012,0.0,1.0
14123,Star Wars: Episode VI - Return of the Jedi 2020 Re-release,217664,0,217664,2020.csv,2020,0.0,1.0
14124,Thomas & Friends: Journey Beyond Sodor 2018 Re-release,217625,0,217625,2018.csv,2018,0.0,1.0
14125,Jane's Journey,217615,27253,190362,2010.csv,2010,0.12523493325368196,0.874765066746318
14126,Eléonore,217529,0,217529,2020.csv,2020,0.0,1.0
14127,Complete Unknown,217473,191761,25712,2016.csv,2016,0.881769231122944,0.118230768877056
14128,Everything Will Be Fine 2015 Re-release,217456,0,217456,2015.csv,2015,0.0,1.0
14129,Kuma,217438,0,217438,2012.csv,2012,0.0,1.0
14130,Vampire in Love,217374,0,217374,2015.csv,2015,0.0,1.0
14131,The Caller,217172,0,217172,2013.csv,2013,0.0,1.0
14132,Eccentricities of a Blonde-Haired Girl,217014,0,217014,2010.csv,2010,0.0,1.0
14133,Freedom,216965,0,216965,2014.csv,2014,0.0,1.0
14134,A Blood Pledge: Broken Promise 2010 Re-release,216917,0,216917,2010.csv,2010,0.0,1.0
14135,Fish N Chips: The Movie,216866,0,216866,2014.csv,2014,0.0,1.0
14136,O Vendedor de Passados,216706,0,216706,2015.csv,2015,0.0,1.0
14137,Dogtooth 2020 Re-release,216591,0,216591,2020.csv,2020,0.0,1.0
14138,Nozokime,216526,0,216526,2016.csv,2016,0.0,1.0
14139,Speed: In Search of Lost Time,216501,0,216501,2012.csv,2012,0.0,1.0
14140,Harbi define,216324,0,216324,2010.csv,2010,0.0,1.0
14141,Çocuklar Sana Emanet,216163,0,216163,2018.csv,2018,0.0,1.0
14142,Nankou in 1937,215872,0,215872,2016.csv,2016,0.0,1.0
14143,How to Steal 2 Million,215791,0,215791,2011.csv,2011,0.0,1.0
14144,The Merger 2018 Re-release,215643,0,215643,2018.csv,2018,0.0,1.0
14145,Beach Spike,215598,0,215598,2011.csv,2011,0.0,1.0
14146,Hero,215462,0,215462,2014.csv,2014,0.0,1.0
14147,The Karate Kid 2019 Re-release,215447,215447,0,2019.csv,2019,1.0,0.0
14148,Vadhayiyaan Ji Vadhayiyaan,215432,0,215432,2018.csv,2018,0.0,1.0
14149,The Treasure of the Sierra Madre 2018 Re-release,215295,215295,0,2018.csv,2018,1.0,0.0
14150,National Theatre Live: The Curious Incident of the Dog in the Night-Time,215203,0,215203,2012.csv,2012,0.0,1.0
14151,Haunted,215092,0,215092,2017.csv,2017,0.0,1.0
14152,The Tribe,215034,150564,64470,2015.csv,2015,0.7001869471804458,0.2998130528195541
14153,The Optimists,214956,0,214956,2013.csv,2013,0.0,1.0
14154,Welcome to New York,214939,0,214939,2018.csv,2018,0.0,1.0
14155,Who's Next,214936,0,214936,2019.csv,2019,0.0,1.0
14156,Bellicher: Cel,214908,0,214908,2012.csv,2012,0.0,1.0
14157,Risk,214669,200219,14450,2017.csv,2017,0.9326870670660412,0.06731293293395879
14158,Seven Sundays,214641,0,214641,2017.csv,2017,0.0,1.0
14159,Hamlet 2019 Re-release,214578,214578,0,2019.csv,2019,1.0,0.0
14160,Winter in my heart,214567,0,214567,2018.csv,2018,0.0,1.0
14161,Matching Jack 2012 Re-release,214486,0,214486,2012.csv,2012,0.0,1.0
14162,Noy,214391,0,214391,2010.csv,2010,0.0,1.0
14163,The Pervert's Guide to Ideology,214313,67966,146347,2013.csv,2013,0.31713428490105594,0.6828657150989441
14164,Working Woman,214283,64048,150235,2019.csv,2019,0.2988944526630671,0.701105547336933
14165,Fenomen,214209,0,214209,2010.csv,2010,0.0,1.0
14166,Sing Song,214193,0,214193,2017.csv,2017,0.0,1.0
14167,Redline,214180,0,214180,2010.csv,2010,0.0,1.0
14168,Aa Gaya Hero,214085,0,214085,2017.csv,2017,0.0,1.0
14169,Blazing Famiglia,214039,0,214039,2012.csv,2012,0.0,1.0
14170,Bony a klid II,214021,0,214021,2014.csv,2014,0.0,1.0
14171,Ingrid Bergman: In Her Own Words,214014,138148,75866,2015.csv,2015,0.6455091722971394,0.35449082770286056
14172,In Dubious Battle,213982,0,213982,2017.csv,2017,0.0,1.0
14173,Meung gu Puankanjonwantai,213879,0,213879,2012.csv,2012,0.0,1.0
14174,Marjorie Prime,213858,180608,33250,2017.csv,2017,0.844523001243816,0.155476998756184
14175,Fukri,213858,0,213858,2017.csv,2017,0.0,1.0
14176,Stop Me Here,213835,0,213835,2016.csv,2016,0.0,1.0
14177,Find My Way Home,213749,0,213749,2018.csv,2018,0.0,1.0
14178,htr2b: Dönüsüm,213747,0,213747,2012.csv,2012,0.0,1.0
14179,Bakgat! tot die mag 3,213670,0,213670,2013.csv,2013,0.0,1.0
14180,Trabantem Tam a Zase Zpatky (Trabant: There and Back Again),213636,0,213636,2019.csv,2019,0.0,1.0
14181,Spy Eyes,213635,0,213635,2017.csv,2017,0.0,1.0
14182,Gremlins 4k Restoration,213572,0,213572,2019.csv,2019,0.0,1.0
14183,Falchi: Falcons Special Squad,213555,0,213555,2017.csv,2017,0.0,1.0
14184,Warriors of the Rainbow: Seediq Bale II,213543,0,213543,2011.csv,2011,0.0,1.0
14185,Thaandavam,213476,213476,0,2012.csv,2012,1.0,0.0
14186,Brødrene Dal og Vikingsverdets Forbannelse,213460,0,213460,2010.csv,2010,0.0,1.0
14187,Dynasty,213449,0,213449,2010.csv,2010,0.0,1.0
14188,Lemonade,213444,0,213444,2018.csv,2018,0.0,1.0
14189,Fake Partner,213273,0,213273,2018.csv,2018,0.0,1.0
14190,The Dead Queen,213256,0,213256,2018.csv,2018,0.0,1.0
14191,Masss 2015 Re-release,213214,0,213214,2015.csv,2015,0.0,1.0
14192,Two Men in Town,213204,0,213204,2014.csv,2014,0.0,1.0
14193,For Love with You,213084,0,213084,2019.csv,2019,0.0,1.0
14194,Namo OK,213056,0,213056,2014.csv,2014,0.0,1.0
14195,The Wound,213043,30678,182365,2017.csv,2017,0.14399909877348704,0.856000901226513
14196,Ghost Killers vs. Bloody Mary,213040,0,213040,2018.csv,2018,0.0,1.0
14197,SubHysteria,213015,0,213015,2010.csv,2010,0.0,1.0
14198,The Afflicted,212940,212940,0,2011.csv,2011,1.0,0.0
14199,Brotherhood of Tears,212928,0,212928,2013.csv,2013,0.0,1.0
14200,¿Estás ahí?,212858,0,212858,2011.csv,2011,0.0,1.0
14201,Daphne,212837,0,212837,2017.csv,2017,0.0,1.0
14202,Chocolate City,212662,212662,0,2015.csv,2015,1.0,0.0
14203,Young & Wild,212624,5514,207110,2012.csv,2012,0.025933102566032058,0.9740668974339679
14204,The Lost Land,212590,0,212590,2018.csv,2018,0.0,1.0
14205,Sta kala kathoumena,212571,0,212571,2014.csv,2014,0.0,1.0
14206,The Treasure,212546,0,212546,2017.csv,2017,0.0,1.0
14207,Fiela se Kind,212504,0,212504,2019.csv,2019,0.0,1.0
14208,The More You Ignore Me,212498,0,212498,2018.csv,2018,0.0,1.0
14209,Big Sonia,212471,212471,0,2017.csv,2017,1.0,0.0
14210,A Bite of China: Celebrating the Chinese New Year,212418,0,212418,2016.csv,2016,0.0,1.0
14211,The Vanished Elephant,212410,0,212410,2014.csv,2014,0.0,1.0
14212,The Human Factor,212288,0,212288,2013.csv,2013,0.0,1.0
14213,Perfect Rivals,212245,0,212245,2011.csv,2011,0.0,1.0
14214,Waste Land,212245,0,212245,2014.csv,2014,0.0,1.0
14215,Fatima,212228,50105,162123,2016.csv,2016,0.23609043104585634,0.7639095689541436
14216,The Wolf of Snow Hollow,212161,185026,27135,2020.csv,2020,0.8721018471820928,0.12789815281790715
14217,Dil Juunglee,212100,0,212100,2018.csv,2018,0.0,1.0
14218,Donnie Darko 2016 Re-release,212034,207971,4063,2016.csv,2016,0.9808379788147183,0.019162021185281607
14219,A Gentle Creature,211875,0,211875,2017.csv,2017,0.0,1.0
14220,Mr Perfect,211853,0,211853,2014.csv,2014,0.0,1.0
14221,Waterboys,211834,0,211834,2016.csv,2016,0.0,1.0
14222,Tomb Story,211751,0,211751,2018.csv,2018,0.0,1.0
14223,Cardboard Gangsters,211728,0,211728,2017.csv,2017,0.0,1.0
14224,Sto xespasma tou feggariou,211696,0,211696,2010.csv,2010,0.0,1.0
14225,Hypnosis,211681,0,211681,2011.csv,2011,0.0,1.0
14226,Chasing Asylum,211664,0,211664,2016.csv,2016,0.0,1.0
14227,The Ground We Won,211629,0,211629,2015.csv,2015,0.0,1.0
14228,L'ami,211613,0,211613,2016.csv,2016,0.0,1.0
14229,Shit Happens,211534,0,211534,2019.csv,2019,0.0,1.0
14230,Goa,211332,0,211332,2010.csv,2010,0.0,1.0
14231,Neva,211049,0,211049,2013.csv,2013,0.0,1.0
14232,Ngok toi,211004,0,211004,2010.csv,2010,0.0,1.0
14233,The Possession Experiment,210979,0,210979,2016.csv,2016,0.0,1.0
14234,Somewhere Between,210975,210975,0,2012.csv,2012,1.0,0.0
14235,Damnation,210967,0,210967,2018.csv,2018,0.0,1.0
14236,Belluscone. Una storia siciliana,210967,0,210967,2014.csv,2014,0.0,1.0
14237,Sabaidee 2,210937,0,210937,2010.csv,2010,0.0,1.0
14238,Lake of Death,210887,0,210887,2019.csv,2019,0.0,1.0
14239,Reyder,210871,0,210871,2011.csv,2011,0.0,1.0
14240,Maikäfer flieg,210865,0,210865,2016.csv,2016,0.0,1.0
14241,Blue,210796,0,210796,2018.csv,2018,0.0,1.0
14242,11 ditey z Morshyna,210664,0,210664,2019.csv,2019,0.0,1.0
14243,La soga,210625,210625,0,2010.csv,2010,1.0,0.0
14244,A Glimpse Inside the Mind of Charles Swan III,210565,45350,165215,2013.csv,2013,0.2153729252249899,0.7846270747750101
14245,Sand Castles,210512,0,210512,2015.csv,2015,0.0,1.0
14246,Vergeet my nie,210386,0,210386,2020.csv,2020,0.0,1.0
14247,Seven Days of Sin,210217,0,210217,2012.csv,2012,0.0,1.0
14248,Tigers Are Not Afraid 2019 Re-release,210138,175559,34579,2019.csv,2019,0.8354462305722906,0.1645537694277094
14249,Beware of Mr. Baker,210123,116476,93647,2012.csv,2012,0.5543229441803135,0.4456770558196866
14250,"Faith, Hope & Love",210091,210091,0,2019.csv,2019,1.0,0.0
14251,Ilk Opucuk 2018 Re-release,210052,0,210052,2018.csv,2018,0.0,1.0
14252,Little Black Spiders,209875,0,209875,2012.csv,2012,0.0,1.0
14253,F2: Fun and Frustration,209812,0,209812,2019.csv,2019,0.0,1.0
14254,Amor Impossível,209805,0,209805,2015.csv,2015,0.0,1.0
14255,Offline,209778,0,209778,2012.csv,2012,0.0,1.0
14256,House,209765,209765,0,2010.csv,2010,1.0,0.0
14257,The Death of Louis XIV,209715,43635,166080,2016.csv,2016,0.2080680924111294,0.7919319075888707
14258,Love Only,209711,0,209711,2018.csv,2018,0.0,1.0
14259,Trick,209686,0,209686,2016.csv,2016,0.0,1.0
14260,100 metri dal paradiso,209640,0,209640,2012.csv,2012,0.0,1.0
14261,Rob the Mob,209613,208693,920,2014.csv,2014,0.99561095924394,0.004389040756059977
14262,SEED: The Untold Story,209580,207825,1755,2016.csv,2016,0.9916261093615804,0.008373890638419696
14263,31st October,209472,0,209472,2016.csv,2016,0.0,1.0
14264,Rolling Stars: The Movie,209467,0,209467,2011.csv,2011,0.0,1.0
14265,Mr. Local,209411,0,209411,2019.csv,2019,0.0,1.0
14266,Knight Rusty 2: Full Metal Racket,209309,0,209309,2018.csv,2018,0.0,1.0
14267,Abducted,209271,0,209271,2013.csv,2013,0.0,1.0
14268,A Clockwork Orange 2019 Re-release,209172,0,209172,2019.csv,2019,0.0,1.0
14269,Sum of Histories,208993,0,208993,2015.csv,2015,0.0,1.0
14270,Kathy Griffin: A Hell of a Story,208907,208907,0,2019.csv,2019,1.0,0.0
14271,Kill Me Please,208821,0,208821,2010.csv,2010,0.0,1.0
14272,Café Derby,208815,0,208815,2015.csv,2015,0.0,1.0
14273,Two of Us,208723,5495,203228,2020.csv,2020,0.0263267584310306,0.9736732415689694
14274,Azazil 2: Büyü 2017 Re-release,208632,0,208632,2017.csv,2017,0.0,1.0
14275,Miss Conception 2011 Re-release,208612,0,208612,2011.csv,2011,0.0,1.0
14276,Casablanca 2013 Re-release,208608,208608,0,2013.csv,2013,1.0,0.0
14277,Getroud met Rugby: Die Onvertelde Storie,208531,0,208531,2011.csv,2011,0.0,1.0
14278,Aida,208355,0,208355,2013.csv,2013,0.0,1.0
14279,Agent Mr. Chan,208351,208351,0,2018.csv,2018,1.0,0.0
14280,Lotte and the Moonstone Secret,208291,0,208291,2011.csv,2011,0.0,1.0
14281,DJ,208210,0,208210,2017.csv,2017,0.0,1.0
14282,Beyond Belief,208209,0,208209,2019.csv,2019,0.0,1.0
14283,The Right Kind of Wrong,208105,2098,206007,2014.csv,2014,0.010081449268398164,0.9899185507316018
14284,The Dating Project,208100,208100,0,2018.csv,2018,1.0,0.0
14285,Furious 7 2020 Re-release,207951,0,207951,2020.csv,2020,0.0,1.0
14286,Thys & Trix,207929,0,207929,2018.csv,2018,0.0,1.0
14287,First Love,207928,0,207928,2013.csv,2013,0.0,1.0
14288,Batman 2019 Re-release,207901,159419,48482,2019.csv,2019,0.766802468482595,0.2331975315174049
14289,Strangled,207856,0,207856,2016.csv,2016,0.0,1.0
14290,The Whaler Boy,207853,0,207853,2020.csv,2020,0.0,1.0
14291,The Clearstream Affair,207730,0,207730,2015.csv,2015,0.0,1.0
14292,Feel the Beat,207678,0,207678,2020.csv,2020,0.0,1.0
14293,The mystery of Padre Pio,207621,0,207621,2018.csv,2018,0.0,1.0
14294,Under the Electric Sky,207584,207584,0,2014.csv,2014,1.0,0.0
14295,Zwerbowana milosc,207569,0,207569,2010.csv,2010,0.0,1.0
14296,Heading Home: The Tale of Team Israel,207533,207533,0,2018.csv,2018,1.0,0.0
14297,Sweetgrass,207473,207473,0,2010.csv,2010,1.0,0.0
14298,Eski Sevgili,207468,0,207468,2017.csv,2017,0.0,1.0
14299,Promised,207431,0,207431,2019.csv,2019,0.0,1.0
14300,Vernacular plan,207276,0,207276,2020.csv,2020,0.0,1.0
14301,Big Mamma's Boy,207262,0,207262,2011.csv,2011,0.0,1.0
14302,Alguém Como Eu,207252,0,207252,2017.csv,2017,0.0,1.0
14303,Advanced Style,207231,87879,119352,2014.csv,2014,0.4240630021570132,0.5759369978429868
14304,Love Heaw Feaw Tott,207189,0,207189,2015.csv,2015,0.0,1.0
14305,Folk Songs Forever,207092,0,207092,2011.csv,2011,0.0,1.0
14306,It's Only Make Believe,207023,0,207023,2013.csv,2013,0.0,1.0
14307,Eleanor's Secret 2010 Re-release,206885,0,206885,2010.csv,2010,0.0,1.0
14308,Bungo Stray Dogs -Dead Aplle-,206854,0,206854,2018.csv,2018,0.0,1.0
14309,National Theatre Live: Hamlet 2013 Re-release,206786,0,206786,2013.csv,2013,0.0,1.0
14310,Love You You,206561,0,206561,2011.csv,2011,0.0,1.0
14311,The Blacksmith from Woodham,206525,0,206525,2013.csv,2013,0.0,1.0
14312,The Trace We Leave Behind,206454,0,206454,2017.csv,2017,0.0,1.0
14313,Ek Thi Daayan,206279,112135,94144,2013.csv,2013,0.5436084138472651,0.4563915861527349
14314,2021 Oscar Nominated Short Films: Live Action,206272,206272,0,2021.csv,2021,1.0,0.0
14315,The Sweeties,206246,0,206246,2019.csv,2019,0.0,1.0
14316,Jou Romeo,206112,0,206112,2016.csv,2016,0.0,1.0
14317,Aravindante Athidhikal,206091,0,206091,2018.csv,2018,0.0,1.0
14318,Mar Gaye Oye Loko,206036,0,206036,2018.csv,2018,0.0,1.0
14319,Don't Call Me Son,205987,11678,194309,2016.csv,2016,0.05669289809551088,0.9433071019044891
14320,The Price of Happiness,205867,0,205867,2019.csv,2019,0.0,1.0
14321,King of the Belgians,205785,0,205785,2016.csv,2016,0.0,1.0
14322,The Machine,205715,0,205715,2014.csv,2014,0.0,1.0
14323,Blue Planet II,205531,0,205531,2018.csv,2018,0.0,1.0
14324,Transit,205445,0,205445,2012.csv,2012,0.0,1.0
14325,The Desert Bride,205350,30110,175240,2017.csv,2017,0.14662770878987094,0.853372291210129
14326,Notizie degli scavi,205338,0,205338,2011.csv,2011,0.0,1.0
14327,A Diamond in the Rough,205213,0,205213,2019.csv,2019,0.0,1.0
14328,Ghost in the Shell Arise: Border 4 - Ghost Stands Alone,205108,0,205108,2014.csv,2014,0.0,1.0
14329,Huyen Su Thien Do,205044,0,205044,2011.csv,2011,0.0,1.0
14330,Mulk,205009,0,205009,2018.csv,2018,0.0,1.0
14331,König von Deutschland,204932,0,204932,2013.csv,2013,0.0,1.0
14332,About Love,204901,0,204901,2017.csv,2017,0.0,1.0
14333,Sicilian Ghost Story,204892,15285,189607,2017.csv,2017,0.07460027721921793,0.9253997227807821
14334,Poveda,204889,0,204889,2016.csv,2016,0.0,1.0
14335,The Iron Orchard,204881,204881,0,2019.csv,2019,1.0,0.0
14336,Sofra sirlari,204798,0,204798,2018.csv,2018,0.0,1.0
14337,Hesburgh,204709,204709,0,2019.csv,2019,1.0,0.0
14338,Jersey,204669,0,204669,2019.csv,2019,0.0,1.0
14339,Operacion Piroberta,204668,0,204668,2017.csv,2017,0.0,1.0
14340,Dirty God,204591,0,204591,2019.csv,2019,0.0,1.0
14341,Birds of Paradise,204538,0,204538,2010.csv,2010,0.0,1.0
14342,Musical Chairs,204466,0,204466,2015.csv,2015,0.0,1.0
14343,Pop Aye,204464,77976,126488,2017.csv,2017,0.3813678691603412,0.6186321308396588
14344,Vanish,204422,0,204422,2015.csv,2015,0.0,1.0
14345,Kormoranid ehk Nahkpükse ei pesta,204395,0,204395,2011.csv,2011,0.0,1.0
14346,The Terminator,204360,0,204360,2020.csv,2020,0.0,1.0
14347,Les anarchistes,204270,0,204270,2015.csv,2015,0.0,1.0
14348,Touchback,204232,204232,0,2012.csv,2012,1.0,0.0
14349,Fiore,204185,0,204185,2016.csv,2016,0.0,1.0
14350,Americano,204165,0,204165,2011.csv,2011,0.0,1.0
14351,Just the 3 of Us,204135,0,204135,2016.csv,2016,0.0,1.0
14352,My Days of Glory,204055,0,204055,2020.csv,2020,0.0,1.0
14353,A Frenchman,204032,0,204032,2019.csv,2019,0.0,1.0
14354,O Amor Dá Trabalho,203863,0,203863,2019.csv,2019,0.0,1.0
14355,The Landlords,203758,0,203758,2012.csv,2012,0.0,1.0
14356,It Was Fifty Years Ago Today! The Beatles: Sgt. Pepper & Beyond,203725,0,203725,2017.csv,2017,0.0,1.0
14357,All She Wrote,203705,0,203705,2018.csv,2018,0.0,1.0
14358,Miss Granny,203680,0,203680,2018.csv,2018,0.0,1.0
14359,I bambini sanno,203674,0,203674,2015.csv,2015,0.0,1.0
14360,CBeebies Christmas Show 2019: Hansel & Gretel,203623,0,203623,2019.csv,2019,0.0,1.0
14361,Shameless,203603,0,203603,2010.csv,2010,0.0,1.0
14362,Michael Buble: Tour Stop 148,203597,0,203597,2016.csv,2016,0.0,1.0
14363,The Parallel,203542,0,203542,2014.csv,2014,0.0,1.0
14364,Krásno,203485,0,203485,2014.csv,2014,0.0,1.0
14365,My Extraordinary Summer with Tess,203426,0,203426,2019.csv,2019,0.0,1.0
14366,Soul Pawnshop,203386,0,203386,2018.csv,2018,0.0,1.0
14367,Forrest Gump 2019 Re-release,203088,203088,0,2019.csv,2019,1.0,0.0
14368,Mr. Kaplan,203009,0,203009,2014.csv,2014,0.0,1.0
14369,Charlie's Country,202966,42937,160029,2014.csv,2014,0.2115477469132761,0.7884522530867238
14370,The Ballad of Shirley Collins,202887,0,202887,2017.csv,2017,0.0,1.0
14371,The Door 2010 Re-release,202834,0,202834,2010.csv,2010,0.0,1.0
14372,Keep the Change,202788,202788,0,2018.csv,2018,1.0,0.0
14373,Magical Girl,202756,0,202756,2014.csv,2014,0.0,1.0
14374,Heartless,202739,0,202739,2014.csv,2014,0.0,1.0
14375,Bad Tales,202560,0,202560,2020.csv,2020,0.0,1.0
14376,"Filth to Ashes, Flesh to Dust",202531,202531,0,2011.csv,2011,1.0,0.0
14377,Pensé que iba a haber fiesta,202528,0,202528,2013.csv,2013,0.0,1.0
14378,In the Name of Love,202474,0,202474,2020.csv,2020,0.0,1.0
14379,Pan T.,202432,0,202432,2019.csv,2019,0.0,1.0
14380,Fridge Horror,202398,0,202398,2018.csv,2018,0.0,1.0
14381,Love in 50 Metres,202339,0,202339,2019.csv,2019,0.0,1.0
14382,Mama daragaya!,202336,0,202336,2015.csv,2015,0.0,1.0
14383,The Bolshoi Ballet: Live From Moscow - Coppélia,202217,202217,0,2018.csv,2018,1.0,0.0
14384,The Warrior Queen of Jhansi,202142,177289,24853,2019.csv,2019,0.8770517754845604,0.12294822451543964
14385,Kung Fu Bunny Man,202104,0,202104,2017.csv,2017,0.0,1.0
14386,Láska na vlásku,202065,0,202065,2014.csv,2014,0.0,1.0
14387,Stranded: I've Come from a Plane That Crashed on the Mountains 2013 Re-release,202057,0,202057,2013.csv,2013,0.0,1.0
14388,Adventurers' Club,202045,0,202045,2015.csv,2015,0.0,1.0
14389,The Nightmare Before Christmas 2016 Re-release,201941,0,201941,2016.csv,2016,0.0,1.0
14390,"Hieronymus Bosch, Touched by the Devil",201907,172533,29374,2016.csv,2016,0.8545171787010851,0.14548282129891485
14391,The Bad Batch,201890,180851,21039,2017.csv,2017,0.8957897865174105,0.10421021348258953
14392,Blink of an Eye,201874,201874,0,2019.csv,2019,1.0,0.0
14393,The Witness,201826,0,201826,2012.csv,2012,0.0,1.0
14394,The Pool,201822,0,201822,2019.csv,2019,0.0,1.0
14395,Ready o/r Knot,201646,0,201646,2021.csv,2021,0.0,1.0
14396,Sakhavu,201562,0,201562,2017.csv,2017,0.0,1.0
14397,Little Joe,201551,23862,177689,2019.csv,2019,0.11839187104008415,0.8816081289599158
14398,Rabb Da Radio 2,201416,0,201416,2019.csv,2019,0.0,1.0
14399,Billie,201200,0,201200,2020.csv,2020,0.0,1.0
14400,"52Hz, I Love You",201172,0,201172,2017.csv,2017,0.0,1.0
14401,A Matador's Mistress 2011 Re-release,200992,0,200992,2011.csv,2011,0.0,1.0
14402,Zombi Child,200909,25878,175031,2019.csv,2019,0.12880458316949464,0.8711954168305054
14403,Suraj Pe Mangal Bhari,200802,0,200802,2020.csv,2020,0.0,1.0
14404,Los Flamencos,200627,0,200627,2013.csv,2013,0.0,1.0
14405,Metro Manila,200584,0,200584,2013.csv,2013,0.0,1.0
14406,Puss,200462,0,200462,2010.csv,2010,0.0,1.0
14407,Legendary,200393,200393,0,2010.csv,2010,1.0,0.0
14408,1974: La posesión de Altair,200362,0,200362,2017.csv,2017,0.0,1.0
14409,Gemini,200340,200340,0,2018.csv,2018,1.0,0.0
14410,En Mutlu Oldugum Yer,200316,0,200316,2010.csv,2010,0.0,1.0
14411,White Girl,200242,200242,0,2016.csv,2016,1.0,0.0
14412,No Place on Earth,200238,200238,0,2013.csv,2013,1.0,0.0
14413,9/11,200229,170000,30229,2017.csv,2017,0.8490278630967543,0.1509721369032458
14414,The Order of Things,200182,0,200182,2017.csv,2017,0.0,1.0
14415,Listen Up Philip,200126,200126,0,2014.csv,2014,1.0,0.0
14416,Alem-i Cin,200078,0,200078,2018.csv,2018,0.0,1.0
14417,Mercy Black,200046,0,200046,2019.csv,2019,0.0,1.0
14418,Cutie and the Boxer,200036,200036,0,2013.csv,2013,1.0,0.0
14419,Shameless,200004,0,200004,2012.csv,2012,0.0,1.0
14420,Chu lian wei man,200000,0,200000,2013.csv,2013,0.0,1.0
14421,Rebel Without a Cause 2018 Re-release,199963,199963,0,2018.csv,2018,1.0,0.0
14422,Ijé: The Journey,199954,0,199954,2010.csv,2010,0.0,1.0
14423,Martilarin Efendisi,199953,0,199953,2017.csv,2017,0.0,1.0
14424,Nikka Zaildar,199935,0,199935,2016.csv,2016,0.0,1.0
14425,Calling 3,199719,0,199719,2011.csv,2011,0.0,1.0
14426,The Water Witch,199648,0,199648,2019.csv,2019,0.0,1.0
14427,The Fallen Idol 2016 Re-release,199619,199619,0,2016.csv,2016,1.0,0.0
14428,Thong Dee Fun Khao,199555,0,199555,2017.csv,2017,0.0,1.0
14429,Spievankovo 5: O povolaniach,199525,0,199525,2015.csv,2015,0.0,1.0
14430,Perdidos,199509,0,199509,2017.csv,2017,0.0,1.0
14431,Laiye Je Yaarian,199477,0,199477,2019.csv,2019,0.0,1.0
14432,Uncle Vanya,199461,0,199461,2020.csv,2020,0.0,1.0
14433,October Baby,199442,199442,0,2011.csv,2011,1.0,0.0
14434,Beyond the River,199408,0,199408,2017.csv,2017,0.0,1.0
14435,Judy & Punch,199360,0,199360,2019.csv,2019,0.0,1.0
14436,"Have Fun, Vasya! Date in Bali",199291,0,199291,2021.csv,2021,0.0,1.0
14437,Muzh moey vdovy,199218,0,199218,2010.csv,2010,0.0,1.0
14438,My Year with Helen,199085,0,199085,2017.csv,2017,0.0,1.0
14439,Wo de shi pian,198986,0,198986,2015.csv,2015,0.0,1.0
14440,Hürkus,198979,0,198979,2018.csv,2018,0.0,1.0
14441,Sürgün Inek,198974,0,198974,2013.csv,2013,0.0,1.0
14442,El-Harami wa el-Abit,198897,0,198897,2013.csv,2013,0.0,1.0
14443,Friendsgiving Day #2,198869,198869,0,2019.csv,2019,1.0,0.0
14444,Still Tomorrow,198798,0,198798,2017.csv,2017,0.0,1.0
14445,Rak-Aow-You,198570,0,198570,2012.csv,2012,0.0,1.0
14446,Vasco Modena Park: Il Film,198349,0,198349,2017.csv,2017,0.0,1.0
14447,Krotoa,198311,0,198311,2017.csv,2017,0.0,1.0
14448,Doraemon the Movie: The New Records of Nobita's Spaceblazer 2011 Re-release,198281,0,198281,2011.csv,2011,0.0,1.0
14449,Erratum,198276,0,198276,2011.csv,2011,0.0,1.0
14450,Ni un hombre más,198261,0,198261,2012.csv,2012,0.0,1.0
14451,Ex Libris: New York Public Library,198239,158192,40047,2017.csv,2017,0.7979862690994204,0.2020137309005796
14452,Oeconomia,198158,0,198158,2020.csv,2020,0.0,1.0
14453,A Summer's Tale,198126,198126,0,2014.csv,2014,1.0,0.0
14454,Nachtwacht: De Poort der Zielen,198085,0,198085,2018.csv,2018,0.0,1.0
14455,Easy Life,198053,0,198053,2016.csv,2016,0.0,1.0
14456,Good Girl,197936,0,197936,2014.csv,2014,0.0,1.0
14457,Whores' Glory,197932,31420,166512,2011.csv,2011,0.1587413859305216,0.8412586140694784
14458,Pusher,197857,0,197857,2012.csv,2012,0.0,1.0
14459,Schastlivyy konets,197835,0,197835,2010.csv,2010,0.0,1.0
14460,All I Wish,197734,0,197734,2018.csv,2018,0.0,1.0
14461,Northern Wind,197676,0,197676,2018.csv,2018,0.0,1.0
14462,Oh Baby,197643,0,197643,2017.csv,2017,0.0,1.0
14463,Killing Gunther,197616,0,197616,2017.csv,2017,0.0,1.0
14464,Hidden 3D 2013 Re-release,197605,0,197605,2013.csv,2013,0.0,1.0
14465,In Fabric,197592,0,197592,2019.csv,2019,0.0,1.0
14466,Fu sing,197580,0,197580,2012.csv,2012,0.0,1.0
14467,Czysciec,197496,0,197496,2020.csv,2020,0.0,1.0
14468,Madeline's Madeline,197309,185576,11733,2018.csv,2018,0.9405348970396687,0.05946510296033126
14469,Wonders,197293,0,197293,2015.csv,2015,0.0,1.0
14470,Velaiyilla Pattathari,197197,0,197197,2014.csv,2014,0.0,1.0
14471,Rapid Reaction Corps,197180,0,197180,2012.csv,2012,0.0,1.0
14472,Have It All -The Movie,197142,197142,0,2018.csv,2018,1.0,0.0
14473,Hüddam 2,197014,0,197014,2019.csv,2019,0.0,1.0
14474,Geuk-jang-pan Kko-ma-beo-seu Ta-yo-ui E-i-seu Gu-chul-jak-jeon,196828,0,196828,2016.csv,2016,0.0,1.0
14475,Directions,196700,0,196700,2017.csv,2017,0.0,1.0
14476,Stoute Boudjies,196662,0,196662,2010.csv,2010,0.0,1.0
14477,Yolunda A.S.: Çinçin Baglari Hikayesi,196653,0,196653,2015.csv,2015,0.0,1.0
14478,The Unmarried Wife,196506,0,196506,2016.csv,2016,0.0,1.0
14479,Romy's Salon,196455,0,196455,2019.csv,2019,0.0,1.0
14480,Rip Tide,196452,0,196452,2017.csv,2017,0.0,1.0
14481,Grossstadtklein,196451,0,196451,2013.csv,2013,0.0,1.0
14482,"Lou Andreas-Salomé, The Audacity to be Free 2019 Re-release",196418,0,196418,2019.csv,2019,0.0,1.0
14483,Go with Your Gut,196403,0,196403,2017.csv,2017,0.0,1.0
14484,Mirza: The Untold Story,196398,0,196398,2012.csv,2012,0.0,1.0
14485,Break Loose,196379,0,196379,2014.csv,2014,0.0,1.0
14486,London Paris New York,196317,0,196317,2012.csv,2012,0.0,1.0
14487,Jai Lava Kusa,196046,0,196046,2017.csv,2017,0.0,1.0
14488,La pièce,195982,0,195982,2016.csv,2016,0.0,1.0
14489,The Magic Flute - Glyndebourne 2019 (Opera),195972,0,195972,2019.csv,2019,0.0,1.0
14490,Gawaza Mery,195950,0,195950,2014.csv,2014,0.0,1.0
14491,Come trovare nel modo giusto l'uomo sbagliato,195943,0,195943,2011.csv,2011,0.0,1.0
14492,Batman Begins 2020 Re-release,195729,0,195729,2020.csv,2020,0.0,1.0
14493,Mom,195701,0,195701,2017.csv,2017,0.0,1.0
14494,Thanh Nho,195683,0,195683,2015.csv,2015,0.0,1.0
14495,Boom for Real: The Late Teenage Years of Jean-Michel Basquiat,195517,166616,28901,2018.csv,2018,0.8521816517233796,0.14781834827662044
14496,If You Cherish Me,195419,0,195419,2017.csv,2017,0.0,1.0
14497,Ignatius of Loyola,195250,0,195250,2017.csv,2017,0.0,1.0
14498,Soldado Argentino solo conocido por Dios,195201,0,195201,2017.csv,2017,0.0,1.0
14499,The Divine Order,195081,76277,118804,2017.csv,2017,0.3910016864789498,0.6089983135210503
14500,Watashi no Hawaii no arukikata,195041,0,195041,2014.csv,2014,0.0,1.0
14501,Free Angela and All Political Prisoners,195005,194102,903,2013.csv,2013,0.9953693495038589,0.004630650496141125
14502,The Masters,194998,0,194998,2015.csv,2015,0.0,1.0
14503,Cannibal,194948,0,194948,2013.csv,2013,0.0,1.0
14504,Jack,194833,0,194833,2015.csv,2015,0.0,1.0
14505,The Woman Knight of Mirror Lake,194780,0,194780,2011.csv,2011,0.0,1.0
14506,Little Grey Fergie Saves the Farm,194632,0,194632,2017.csv,2017,0.0,1.0
14507,Success Story,194602,0,194602,2017.csv,2017,0.0,1.0
14508,Family,194601,194601,0,2019.csv,2019,1.0,0.0
14509,Influence,194591,0,194591,2015.csv,2015,0.0,1.0
14510,La Esmeralda 1879,194513,0,194513,2010.csv,2010,0.0,1.0
14511,Luther 2017 Re-release,194506,0,194506,2017.csv,2017,0.0,1.0
14512,A Class of One,194504,0,194504,2018.csv,2018,0.0,1.0
14513,Joan of Arc,194475,0,194475,2019.csv,2019,0.0,1.0
14514,Viral 2016 Re-release,194341,0,194341,2016.csv,2016,0.0,1.0
14515,The Woman with a Broken Nose,194282,0,194282,2010.csv,2010,0.0,1.0
14516,Ninja,194243,0,194243,2010.csv,2010,0.0,1.0
14517,Primates of the Caribbean 2014 Re-release,194106,0,194106,2014.csv,2014,0.0,1.0
14518,Wild Bill,194099,0,194099,2012.csv,2012,0.0,1.0
14519,A Screaming Man,193981,9862,184119,2010.csv,2010,0.0508400307246586,0.9491599692753414
14520,Bozo: The World's Most Famous Clown: Super Salesman Bozo,193904,0,193904,2015.csv,2015,0.0,1.0
14521,Trader Games,193897,0,193897,2010.csv,2010,0.0,1.0
14522,Blood Creek 2011 Re-release,193776,0,193776,2011.csv,2011,0.0,1.0
14523,Toni Kroos,193703,0,193703,2019.csv,2019,0.0,1.0
14524,Ema,193676,0,193676,2019.csv,2019,0.0,1.0
14525,Aadya Rathri,193627,0,193627,2019.csv,2019,0.0,1.0
14526,Agir Romantik,193612,0,193612,2020.csv,2020,0.0,1.0
14527,I Am Kalam,193593,0,193593,2011.csv,2011,0.0,1.0
14528,Starship Troopers: Invasion,193425,0,193425,2012.csv,2012,0.0,1.0
14529,Autumn Fairy Tale,193338,0,193338,2019.csv,2019,0.0,1.0
14530,Chalk N Duster,193292,0,193292,2016.csv,2016,0.0,1.0
14531,Bad Girl,193221,0,193221,2019.csv,2019,0.0,1.0
14532,Yalghaar,193040,0,193040,2017.csv,2017,0.0,1.0
14533,Mr. Klein,193028,193028,0,2019.csv,2019,1.0,0.0
14534,Karma,193005,0,193005,2018.csv,2018,0.0,1.0
14535,Love Lives Here,192989,0,192989,2019.csv,2019,0.0,1.0
14536,Client 9,192870,189416,3454,2010.csv,2010,0.982091564266086,0.017908435733914034
14537,Invictus 2010 Re-release,192821,0,192821,2010.csv,2010,0.0,1.0
14538,The Fatherless,192785,0,192785,2011.csv,2011,0.0,1.0
14539,So Far So Good,192732,0,192732,2015.csv,2015,0.0,1.0
14540,Runway Beat,192631,0,192631,2011.csv,2011,0.0,1.0
14541,The Metropolitan Opera HD Live: Wagner: Götterdämmerung,192550,0,192550,2012.csv,2012,0.0,1.0
14542,"Felix, Net i Nika oraz teoretycznie mozliwa katastrofa",192536,0,192536,2012.csv,2012,0.0,1.0
14543,Disneynature: Wings of Life,192467,0,192467,2011.csv,2011,0.0,1.0
14544,"Sexo fácil, películas tristes",192466,0,192466,2014.csv,2014,0.0,1.0
14545,Little Gobie,192460,0,192460,2010.csv,2010,0.0,1.0
14546,Meky,192381,0,192381,2020.csv,2020,0.0,1.0
14547,Frau Stern,192275,0,192275,2019.csv,2019,0.0,1.0
14548,Bir Hikayem Var,192239,0,192239,2013.csv,2013,0.0,1.0
14549,Memories of Anne Frank,192134,0,192134,2011.csv,2011,0.0,1.0
14550,Tempo Insatiable,192077,0,192077,2015.csv,2015,0.0,1.0
14551,Save Your Legs!,192041,0,192041,2013.csv,2013,0.0,1.0
14552,Claire's Camera,191980,83418,108562,2018.csv,2018,0.4345140118762371,0.5654859881237629
14553,Harry Potter and the Deathly Hallows: Part 2 2018 Re-release,191886,181938,9948,2018.csv,2018,0.9481567180513429,0.05184328194865701
14554,Role Models,191834,0,191834,2017.csv,2017,0.0,1.0
14555,The Violin Teacher 2018 Re-release,191727,0,191727,2018.csv,2018,0.0,1.0
14556,Past Life,191678,180099,11579,2017.csv,2017,0.9395913980738531,0.06040860192614698
14557,The Legend of Michael Mishra,191670,0,191670,2016.csv,2016,0.0,1.0
14558,Lian xia lian xia lian lian xia,191502,0,191502,2011.csv,2011,0.0,1.0
14559,Don't Tell,191471,0,191471,2017.csv,2017,0.0,1.0
14560,Remo,191459,0,191459,2016.csv,2016,0.0,1.0
14561,Geronimo,191365,0,191365,2014.csv,2014,0.0,1.0
14562,Chunkzz,191202,0,191202,2017.csv,2017,0.0,1.0
14563,Chalo Dilli,191185,94300,96885,2011.csv,2011,0.4932395323900934,0.5067604676099067
14564,Ottolenghi and the Cakes of Versailles,191092,4962,186130,2020.csv,2020,0.025966550143386433,0.9740334498566136
14565,The Romantics,191019,106524,84495,2010.csv,2010,0.5576618032761139,0.4423381967238861
14566,Paura 3D,190836,0,190836,2012.csv,2012,0.0,1.0
14567,Imaginaerum,190819,0,190819,2012.csv,2012,0.0,1.0
14568,Plan Bart,190801,0,190801,2014.csv,2014,0.0,1.0
14569,We Summon the Darkness,190760,60794,129966,2020.csv,2020,0.3186936464667645,0.6813063535332354
14570,Patchwork Family,190690,0,190690,2014.csv,2014,0.0,1.0
14571,The County,190655,0,190655,2019.csv,2019,0.0,1.0
14572,"Farewell, Berlin Wall",190640,0,190640,2015.csv,2015,0.0,1.0
14573,Ya tozhe khochu,190631,0,190631,2012.csv,2012,0.0,1.0
14574,Digimon Adventure tri. Part 1: Reunion Domestic Release,190581,190581,0,2016.csv,2016,1.0,0.0
14575,The Eight Immortals,190536,0,190536,2018.csv,2018,0.0,1.0
14576,Disturbed Souls on Campus,190532,0,190532,2018.csv,2018,0.0,1.0
14577,Le ultime 56 ore,190483,0,190483,2010.csv,2010,0.0,1.0
14578,The Hero Show,190471,0,190471,2010.csv,2010,0.0,1.0
14579,Yalan Dolan,190441,0,190441,2019.csv,2019,0.0,1.0
14580,Mamma Gógó,190422,0,190422,2010.csv,2010,0.0,1.0
14581,Posesiones del más allá,190414,0,190414,2013.csv,2013,0.0,1.0
14582,The Silent Forest,190404,0,190404,2020.csv,2020,0.0,1.0
14583,Captifs,190312,0,190312,2010.csv,2010,0.0,1.0
14584,Deadman Inferno,190299,0,190299,2015.csv,2015,0.0,1.0
14585,Code Black,190229,190229,0,2014.csv,2014,1.0,0.0
14586,The Doors: Break On Thru - A Celebration Of Ray Manzarek,190160,190160,0,2020.csv,2020,1.0,0.0
14587,The Hero Battle,190035,0,190035,2020.csv,2020,0.0,1.0
14588,The Divine Plan,190031,190031,0,2019.csv,2019,1.0,0.0
14589,Go Back,190002,0,190002,2021.csv,2021,0.0,1.0
14590,Vojtech,190000,0,190000,2015.csv,2015,0.0,1.0
14591,Area Q.,189995,0,189995,2012.csv,2012,0.0,1.0
14592,Cell 2018 Re-release,189981,0,189981,2018.csv,2018,0.0,1.0
14593,Louis Theroux: Heroin Town,189826,0,189826,2017.csv,2017,0.0,1.0
14594,Game of Death,189805,0,189805,2011.csv,2011,0.0,1.0
14595,Neulovimye,189787,0,189787,2015.csv,2015,0.0,1.0
14596,Force 2,189742,0,189742,2016.csv,2016,0.0,1.0
14597,Java Heat,189739,1061,188678,2013.csv,2013,0.0055918920200907565,0.9944081079799092
14598,Infoholik,189471,0,189471,2017.csv,2017,0.0,1.0
14599,La Rodata,189467,0,189467,2011.csv,2011,0.0,1.0
14600,Skinwalker Ranch,189380,0,189380,2014.csv,2014,0.0,1.0
14601,The Trip 2013 Re-release,189343,0,189343,2013.csv,2013,0.0,1.0
14602,Quiet Bliss,189318,0,189318,2014.csv,2014,0.0,1.0
14603,First Snow 2010 Re-release,189218,0,189218,2010.csv,2010,0.0,1.0
14604,Coriolanus,189212,0,189212,2013.csv,2013,0.0,1.0
14605,The Moment,189188,0,189188,2017.csv,2017,0.0,1.0
14606,Carnivores,189126,0,189126,2018.csv,2018,0.0,1.0
14607,Munna Michael,189105,99629,89476,2017.csv,2017,0.5268448745405991,0.47315512545940086
14608,Carrie TV Love Concert: The Movie,189079,0,189079,2019.csv,2019,0.0,1.0
14609,Nick Saban: Gamechanger,189000,189000,0,2010.csv,2010,1.0,0.0
14610,President's 7 Hours,188979,0,188979,2019.csv,2019,0.0,1.0
14611,"31 minutos, la película 2012 Re-release",188971,0,188971,2012.csv,2012,0.0,1.0
14612,Deadly Illusions,188864,0,188864,2020.csv,2020,0.0,1.0
14613,Hallo Bungalow,188794,0,188794,2015.csv,2015,0.0,1.0
14614,Harry Potter and the Goblet of Fire 2018 Re-release,188716,188716,0,2018.csv,2018,1.0,0.0
14615,Yona Yona Penguin,188660,0,188660,2010.csv,2010,0.0,1.0
14616,This Is Life,188556,0,188556,2016.csv,2016,0.0,1.0
14617,The Predators,188464,0,188464,2020.csv,2020,0.0,1.0
14618,Sin Sisters 2,188451,0,188451,2010.csv,2010,0.0,1.0
14619,French Dolls,188410,0,188410,2014.csv,2014,0.0,1.0
14620,Thomas & Friends: Tale of the Brave,188290,0,188290,2014.csv,2014,0.0,1.0
14621,Leap Year,188242,12979,175263,2010.csv,2010,0.06894848121035688,0.9310515187896431
14622,Diamond Dust,188228,0,188228,2018.csv,2018,0.0,1.0
14623,Captain Marvel 2020 Re-release,188178,0,188178,2020.csv,2020,0.0,1.0
14624,E.S.O. Entitat sobrenatural oculta,188066,0,188066,2010.csv,2010,0.0,1.0
14625,Qismat,188044,0,188044,2018.csv,2018,0.0,1.0
14626,Beating Heart,187953,0,187953,2020.csv,2020,0.0,1.0
14627,The Bolshoi Ballet: Live From Moscow - Don Quixote,187946,187946,0,2018.csv,2018,1.0,0.0
14628,When Santa Fell to Earth 2012 Re-release,187925,0,187925,2012.csv,2012,0.0,1.0
14629,Mr. Big,187922,0,187922,2018.csv,2018,0.0,1.0
14630,Music and Dream,187886,0,187886,2016.csv,2016,0.0,1.0
14631,La vie sauvage des animaux domestiques,187840,0,187840,2010.csv,2010,0.0,1.0
14632,Ruta,187603,0,187603,2018.csv,2018,0.0,1.0
14633,The Days to Come,187593,0,187593,2019.csv,2019,0.0,1.0
14634,The Child Who Would Not Come,187589,0,187589,2021.csv,2021,0.0,1.0
14635,Treurgrond,187566,0,187566,2015.csv,2015,0.0,1.0
14636,The Prom,187430,0,187430,2020.csv,2020,0.0,1.0
14637,Never-Ending Man: Hayao Miyazaki,187320,187320,0,2018.csv,2018,1.0,0.0
14638,The Last Days on Mars,187191,24084,163107,2013.csv,2013,0.12866003173229482,0.8713399682677052
14639,Happily Ever After,187089,0,187089,2010.csv,2010,0.0,1.0
14640,The Runway,187089,0,187089,2011.csv,2011,0.0,1.0
14641,Halston,187085,151991,35094,2019.csv,2019,0.8124168158858273,0.1875831841141727
14642,"Synecdoche, New York 2014 Re-release",187077,0,187077,2014.csv,2014,0.0,1.0
14643,In the Fog,186838,11894,174944,2013.csv,2013,0.06365942688318223,0.9363405731168177
14644,Gary of the Pacific,186729,0,186729,2017.csv,2017,0.0,1.0
14645,Here's the Deal,186618,0,186618,2013.csv,2013,0.0,1.0
14646,Paradise Beach,186410,0,186410,2019.csv,2019,0.0,1.0
14647,Breakaway 2011 Re-release,186410,0,186410,2011.csv,2011,0.0,1.0
14648,The Depraved,186276,0,186276,2011.csv,2011,0.0,1.0
14649,Chibi Maruko Chan Movie: Ono & Sugiyama,186235,0,186235,2019.csv,2019,0.0,1.0
14650,Hello My Dog,186226,0,186226,2018.csv,2018,0.0,1.0
14651,"Ana, My Love",186200,0,186200,2017.csv,2017,0.0,1.0
14652,Singam 3,186138,0,186138,2016.csv,2016,0.0,1.0
14653,The Donkey King,186134,0,186134,2019.csv,2019,0.0,1.0
14654,Thawed Carp,186126,0,186126,2018.csv,2018,0.0,1.0
14655,Good for Nothing,186119,0,186119,2012.csv,2012,0.0,1.0
14656,Twiceland,186078,52874,133204,2018.csv,2018,0.28414965767043926,0.7158503423295607
14657,The Invisible Eye,186057,0,186057,2010.csv,2010,0.0,1.0
14658,Salt of This Sea 2010 Re-release,186045,11662,174383,2010.csv,2010,0.06268375930554436,0.9373162406944556
14659,In the Basement,186036,3643,182393,2014.csv,2014,0.019582231396073877,0.9804177686039262
14660,Britt-Marie Was Here,185794,36549,149245,2019.csv,2019,0.19671787032950472,0.8032821296704953
14661,Secrets,185741,0,185741,2013.csv,2013,0.0,1.0
14662,Andy,185711,0,185711,2019.csv,2019,0.0,1.0
14663,God Only Knows,185683,0,185683,2019.csv,2019,0.0,1.0
14664,Buñuel in the Labyrinth of the Turtles,185675,36205,149470,2019.csv,2019,0.19499124814864682,0.8050087518513531
14665,The Crossing 2014 Re-release,185643,0,185643,2014.csv,2014,0.0,1.0
14666,Føniks,185598,0,185598,2015.csv,2015,0.0,1.0
14667,Jagged Blood Spirit Yang Jingyu,185465,0,185465,2019.csv,2019,0.0,1.0
14668,Sea Fever,185447,0,185447,2020.csv,2020,0.0,1.0
14669,Who Is Crying at Midnight,185379,0,185379,2016.csv,2016,0.0,1.0
14670,The Diabolical 2016 Re-release,185199,0,185199,2016.csv,2016,0.0,1.0
14671,Go Fish,185184,0,185184,2019.csv,2019,0.0,1.0
14672,The Duke of Burgundy,185147,64521,120626,2015.csv,2015,0.3484852576601295,0.6515147423398705
14673,Tell Me Sweet Something,185131,0,185131,2015.csv,2015,0.0,1.0
14674,Cobra Kai Premiere Event feat. The Karate Kid,185082,185082,0,2018.csv,2018,1.0,0.0
14675,Blokbaster,184935,0,184935,2017.csv,2017,0.0,1.0
14676,Je l'aimais 2011 Re-release,184888,0,184888,2011.csv,2011,0.0,1.0
14677,The Immature 2012 Re-release,184750,0,184750,2012.csv,2012,0.0,1.0
14678,Total Chaos,184730,0,184730,2014.csv,2014,0.0,1.0
14679,A Bride for Rip Van Winkle,184727,0,184727,2016.csv,2016,0.0,1.0
14680,Amigo,184705,184705,0,2011.csv,2011,1.0,0.0
14681,Manhattan Night,184656,0,184656,2016.csv,2016,0.0,1.0
14682,To Dust,184495,184495,0,2019.csv,2019,1.0,0.0
14683,Dog Eat Dog,184404,0,184404,2016.csv,2016,0.0,1.0
14684,Selfie,184395,0,184395,2017.csv,2017,0.0,1.0
14685,It Begins with the End,184363,0,184363,2010.csv,2010,0.0,1.0
14686,Alien 2020 Re-release,184354,135000,49354,2020.csv,2020,0.7322867960554151,0.26771320394458487
14687,Susanna van Biljon,184270,0,184270,2010.csv,2010,0.0,1.0
14688,Blade Runner 2020 Re-release,184264,0,184264,2020.csv,2020,0.0,1.0
14689,New Age Vampire Warriors,184206,0,184206,2010.csv,2010,0.0,1.0
14690,Score: A Film Music Documentary,184025,101382,82643,2017.csv,2017,0.5509142779513653,0.4490857220486347
14691,Avenged,183927,0,183927,2014.csv,2014,0.0,1.0
14692,Voyez comme ils dansent,183842,0,183842,2011.csv,2011,0.0,1.0
14693,Palladio,183825,0,183825,2019.csv,2019,0.0,1.0
14694,Kill It and Leave This Town,183771,0,183771,2021.csv,2021,0.0,1.0
14695,The Stoker,183640,0,183640,2010.csv,2010,0.0,1.0
14696,The River and the Wall,183602,183602,0,2019.csv,2019,1.0,0.0
14697,Barn,183594,0,183594,2019.csv,2019,0.0,1.0
14698,Lucky Grandma,183561,102000,81561,2020.csv,2020,0.5556735907954304,0.4443264092045696
14699,Assassination Classroom: 365 Days,183551,0,183551,2017.csv,2017,0.0,1.0
14700,X.,183473,0,183473,2018.csv,2018,0.0,1.0
14701,Rakrak Kratakgin,183462,0,183462,2012.csv,2012,0.0,1.0
14702,Return to Sender 2015 Re-release,183369,0,183369,2015.csv,2015,0.0,1.0
14703,"The Man Nobody Knew: In Search of My Father, CIA Spymaster William Colby",183342,183342,0,2011.csv,2011,1.0,0.0
14704,Lambert & Stamp,183320,183320,0,2015.csv,2015,1.0,0.0
14705,Asier ETA biok,183216,0,183216,2014.csv,2014,0.0,1.0
14706,Mardaani,183205,0,183205,2014.csv,2014,0.0,1.0
14707,Dance to Death,182957,0,182957,2017.csv,2017,0.0,1.0
14708,Whose Streets?,182799,182799,0,2017.csv,2017,1.0,0.0
14709,Virtual Recall,182788,0,182788,2010.csv,2010,0.0,1.0
14710,Agnathavasi - Prince in Exile,182751,0,182751,2018.csv,2018,0.0,1.0
14711,Hördur - Zwischen den Welten,182737,0,182737,2015.csv,2015,0.0,1.0
14712,The Masked Saint,182695,182695,0,2016.csv,2016,1.0,0.0
14713,Bana Bir Soygun Yaz 2,182692,0,182692,2018.csv,2018,0.0,1.0
14714,"Pettson and Findus: A Little Nuisance, a Great Friendship 2015 Re-release",182676,0,182676,2015.csv,2015,0.0,1.0
14715,Bastardi 3,182503,0,182503,2012.csv,2012,0.0,1.0
14716,Sneakers,182485,0,182485,2011.csv,2011,0.0,1.0
14717,The Axe Murders of Villisca,182467,0,182467,2017.csv,2017,0.0,1.0
14718,I Am Not a Witch,182462,50868,131594,2017.csv,2017,0.2787868158849514,0.7212131841150486
14719,She Devil,182442,0,182442,2014.csv,2014,0.0,1.0
14720,3 Little Pigs and the Magic Lamp 2017 Re-release,182435,0,182435,2017.csv,2017,0.0,1.0
14721,Shock and Awe,182415,77980,104435,2018.csv,2018,0.42748677466217144,0.5725132253378286
14722,Deli dumrul kurtlar kuslar aleminde,182249,0,182249,2010.csv,2010,0.0,1.0
14723,Dead Snow 2010 Re-release,182135,0,182135,2010.csv,2010,0.0,1.0
14724,Lucky Luke 2011 Re-release,182081,0,182081,2011.csv,2011,0.0,1.0
14725,The Italian 2012 Re-release,182037,0,182037,2012.csv,2012,0.0,1.0
14726,Method,182019,0,182019,2017.csv,2017,0.0,1.0
14727,Lesser Fullness,181959,0,181959,2019.csv,2019,0.0,1.0
14728,Mama's Boy,181876,0,181876,2018.csv,2018,0.0,1.0
14729,Fin Sugoi,181739,0,181739,2014.csv,2014,0.0,1.0
14730,An Umbrella Conspiracy,181698,0,181698,2017.csv,2017,0.0,1.0
14731,Flowers of Evil,181686,0,181686,2016.csv,2016,0.0,1.0
14732,Inzuma Eleven Go Vs. Danbourusenki,181648,0,181648,2013.csv,2013,0.0,1.0
14733,Il padre d'Italia,181606,0,181606,2017.csv,2017,0.0,1.0
14734,For Some Inexplicable Reason,181554,0,181554,2014.csv,2014,0.0,1.0
14735,Varnyathil Aashanka,181510,0,181510,2017.csv,2017,0.0,1.0
14736,Giant Little Ones,181507,181507,0,2019.csv,2019,1.0,0.0
14737,Subedar Joginder Singh,181450,0,181450,2018.csv,2018,0.0,1.0
14738,Raag Desh,181430,0,181430,2017.csv,2017,0.0,1.0
14739,The Postcard Killings,181415,0,181415,2020.csv,2020,0.0,1.0
14740,Bolshoi Ballet: Raymonda domestic,181361,181361,0,2019.csv,2019,1.0,0.0
14741,Raymonda: Bolshoi Ballet,181361,181361,0,2019.csv,2019,1.0,0.0
14742,Love Is Not Perfect,181328,0,181328,2012.csv,2012,0.0,1.0
14743,Rafiki,181316,137968,43348,2019.csv,2019,0.7609256767190982,0.23907432328090186
14744,Recreo,181172,0,181172,2018.csv,2018,0.0,1.0
14745,The End?,181145,0,181145,2018.csv,2018,0.0,1.0
14746,Kill Switch 2017 Re-release,181136,0,181136,2017.csv,2017,0.0,1.0
14747,A Belfast Story,181108,0,181108,2013.csv,2013,0.0,1.0
14748,Diving,181078,0,181078,2017.csv,2017,0.0,1.0
14749,4 Roses,181069,0,181069,2019.csv,2019,0.0,1.0
14750,The Grandad,181052,0,181052,2014.csv,2014,0.0,1.0
14751,Winnebago Man,181039,181039,0,2010.csv,2010,1.0,0.0
14752,1001 Grams,181030,10983,170047,2014.csv,2014,0.06066950229243772,0.9393304977075623
14753,A Hard Day's Night 2015 Re-release,180939,0,180939,2015.csv,2015,0.0,1.0
14754,The Idolmaster Movie: Beyond the Brilliant Future! 2015 Re-release,180904,0,180904,2015.csv,2015,0.0,1.0
14755,The Howling: Reborn,180871,0,180871,2011.csv,2011,0.0,1.0
14756,Voyna polov,180837,0,180837,2015.csv,2015,0.0,1.0
14757,Um Tio Quase Perfeito 2,180607,0,180607,2021.csv,2021,0.0,1.0
14758,An Honest Liar,180590,180590,0,2015.csv,2015,1.0,0.0
14759,The Network of Freedom,180584,0,180584,2017.csv,2017,0.0,1.0
14760,The Coffin 2011 Re-release,180416,0,180416,2011.csv,2011,0.0,1.0
14761,Fukrey,180331,125279,55052,2013.csv,2013,0.694716937187727,0.30528306281227297
14762,Carbon,180315,0,180315,2018.csv,2018,0.0,1.0
14763,Evidence,180249,0,180249,2013.csv,2013,0.0,1.0
14764,Go for It!,180237,180237,0,2011.csv,2011,1.0,0.0
14765,Bangalore Days,180217,0,180217,2014.csv,2014,0.0,1.0
14766,Contracted: Phase II,180213,0,180213,2015.csv,2015,0.0,1.0
14767,Pink,180180,0,180180,2016.csv,2016,0.0,1.0
14768,Bonhomme,180175,0,180175,2018.csv,2018,0.0,1.0
14769,Smart Christmas,180120,0,180120,2018.csv,2018,0.0,1.0
14770,Lost Woods,180117,180117,0,2012.csv,2012,1.0,0.0
14771,Best of Luck,179946,0,179946,2013.csv,2013,0.0,1.0
14772,Soulmate 2017 Re-release,179936,0,179936,2017.csv,2017,0.0,1.0
14773,Pocholo y su Marida - amor a lo gorrión,179924,0,179924,2010.csv,2010,0.0,1.0
14774,Sunkist Family,179868,0,179868,2019.csv,2019,0.0,1.0
14775,Balgar: The Movie,179850,0,179850,2014.csv,2014,0.0,1.0
14776,Seytan Tüyü,179842,0,179842,2016.csv,2016,0.0,1.0
14777,Lila & Eve,179807,38263,141544,2015.csv,2015,0.21280039153091926,0.7871996084690808
14778,Esruhumun eszamani,179681,0,179681,2012.csv,2012,0.0,1.0
14779,The Chase,179646,0,179646,2013.csv,2013,0.0,1.0
14780,Lazy Hazy Crazy,179637,0,179637,2015.csv,2015,0.0,1.0
14781,Therapy for a Vampire,179607,0,179607,2014.csv,2014,0.0,1.0
14782,The Latin Dream,179519,0,179519,2017.csv,2017,0.0,1.0
14783,#Selfieparty,179458,0,179458,2016.csv,2016,0.0,1.0
14784,The Purple Mist,179444,0,179444,2019.csv,2019,0.0,1.0
14785,Olimpiyskaya derevnya,179424,0,179424,2012.csv,2012,0.0,1.0
14786,The Mouth of the Wolf,179376,0,179376,2010.csv,2010,0.0,1.0
14787,What War May Bring,179352,0,179352,2010.csv,2010,0.0,1.0
14788,The Jungle Bunch 2: The Great Treasure Quest,179272,0,179272,2015.csv,2015,0.0,1.0
14789,Throne of Elves 2018 Re-release,179249,0,179249,2018.csv,2018,0.0,1.0
14790,Lovemakers,179154,0,179154,2011.csv,2011,0.0,1.0
14791,Holiday 2014 Re-release,179131,0,179131,2014.csv,2014,0.0,1.0
14792,The Sonata,178887,0,178887,2018.csv,2018,0.0,1.0
14793,Mothers,178748,0,178748,2018.csv,2018,0.0,1.0
14794,Rossini: William Tell,178663,0,178663,2015.csv,2015,0.0,1.0
14795,Beyond Beauty: Taiwan from Above,178608,0,178608,2014.csv,2014,0.0,1.0
14796,Saint Judy,178594,78935,99659,2019.csv,2019,0.4419801337110989,0.5580198662889011
14797,Hayfever,178420,0,178420,2011.csv,2011,0.0,1.0
14798,The Dog Who Saved Easter,178360,0,178360,2015.csv,2015,0.0,1.0
14799,Dizlayk,178210,0,178210,2016.csv,2016,0.0,1.0
14800,Offender,178158,0,178158,2012.csv,2012,0.0,1.0
14801,Orpheus' Lyre,178145,0,178145,2013.csv,2013,0.0,1.0
14802,You Are So Yummy: Happy to Be with You,178126,0,178126,2015.csv,2015,0.0,1.0
14803,Walking on Water,178119,102140,75979,2019.csv,2019,0.5734368596275524,0.42656314037244764
14804,Modest Heroes,178027,178027,0,2019.csv,2019,1.0,0.0
14805,Bypass,178027,0,178027,2012.csv,2012,0.0,1.0
14806,Raew Talu Raew,177924,0,177924,2014.csv,2014,0.0,1.0
14807,Zaytoun,177753,42330,135423,2013.csv,2013,0.2381394406845454,0.7618605593154546
14808,Monumental: In Search of America's National Treasure,177729,177729,0,2012.csv,2012,1.0,0.0
14809,The Distances,177641,0,177641,2018.csv,2018,0.0,1.0
14810,Nostalgia for the Light,177634,163962,13672,2010.csv,2010,0.9230327527387775,0.07696724726122252
14811,Gaming Instinct,177469,0,177469,2013.csv,2013,0.0,1.0
14812,Sonali Cable,177396,0,177396,2014.csv,2014,0.0,1.0
14813,Letters from War,177388,0,177388,2016.csv,2016,0.0,1.0
14814,Blessers,177387,0,177387,2019.csv,2019,0.0,1.0
14815,People Places Things,177338,67046,110292,2015.csv,2015,0.3780689981842583,0.6219310018157417
14816,White Riot,177308,0,177308,2020.csv,2020,0.0,1.0
14817,The Booksellers,177306,25694,151612,2020.csv,2020,0.14491331370624796,0.8550866862937521
14818,Görünmeyenler,177254,0,177254,2012.csv,2012,0.0,1.0
14819,And Soon the Darkness,177182,0,177182,2011.csv,2011,0.0,1.0
14820,Madam President,177129,0,177129,2012.csv,2012,0.0,1.0
14821,The Corrupted,177100,0,177100,2019.csv,2019,0.0,1.0
14822,Anita: Speaking Truth to Power,176979,176979,0,2014.csv,2014,1.0,0.0
14823,Trois Coeurs,176935,0,176935,2015.csv,2015,0.0,1.0
14824,Bye Bye Germany,176933,73730,103203,2017.csv,2017,0.4167114105339309,0.5832885894660691
14825,Hut in the Woods,176916,0,176916,2012.csv,2012,0.0,1.0
14826,Casino Jack and the United States of Money,176865,176865,0,2010.csv,2010,1.0,0.0
14827,Sorry Saranghaeyo,176810,0,176810,2010.csv,2010,0.0,1.0
14828,Grand Father,176791,0,176791,2016.csv,2016,0.0,1.0
14829,Anchor Baby,176784,15790,160994,2010.csv,2010,0.08931803783147796,0.910681962168522
14830,Vigilante Diaries,176777,1991,174786,2016.csv,2016,0.01126277739751212,0.9887372226024879
14831,Happy Hour 2018 Re-release,176734,0,176734,2018.csv,2018,0.0,1.0
14832,The Sun Above Me Never Sets,176693,0,176693,2019.csv,2019,0.0,1.0
14833,Vozhd raznokozhikh,176529,0,176529,2012.csv,2012,0.0,1.0
14834,"Iyengar: The Man, Yoga, and the Student's Journey",176387,176387,0,2019.csv,2019,1.0,0.0
14835,Escape from Raqqa,176372,0,176372,2019.csv,2019,0.0,1.0
14836,4 Kings 2015 Re-release,176309,0,176309,2015.csv,2015,0.0,1.0
14837,Better Watch Out,176288,20369,155919,2017.csv,2017,0.1155438827373389,0.884456117262661
14838,Jungle Emperor: The Brave Can Change the Future,176277,0,176277,2012.csv,2012,0.0,1.0
14839,Girl on a Bicycle,176272,91401,84871,2013.csv,2013,0.5185225106653354,0.4814774893346646
14840,When a Wolf Falls in Love with a Sheep,176260,0,176260,2012.csv,2012,0.0,1.0
14841,Die verrückte Welt der Ute Bock,176089,0,176089,2010.csv,2010,0.0,1.0
14842,Diary of the Dead 2010 Re-release,176083,0,176083,2010.csv,2010,0.0,1.0
14843,Ev,176054,0,176054,2010.csv,2010,0.0,1.0
14844,The Bolshoi Ballet: Live From Moscow - The Flames of Paris,175922,175922,0,2018.csv,2018,1.0,0.0
14845,Elixir,175910,0,175910,2014.csv,2014,0.0,1.0
14846,Thomas & Friends: Misty Island Rescue,175885,0,175885,2011.csv,2011,0.0,1.0
14847,The Price of Fame,175844,0,175844,2015.csv,2015,0.0,1.0
14848,Quién te cantará,175791,0,175791,2018.csv,2018,0.0,1.0
14849,Afternoon Delight,175755,174496,1259,2013.csv,2013,0.9928366191573497,0.00716338084265028
14850,Thambi,175746,0,175746,2019.csv,2019,0.0,1.0
14851,Butter,175706,105018,70688,2012.csv,2012,0.5976915984656187,0.4023084015343813
14852,A.C.O.D.,175705,175705,0,2013.csv,2013,1.0,0.0
14853,The Girl from Future,175696,0,175696,2018.csv,2018,0.0,1.0
14854,Black Rock,175682,0,175682,2013.csv,2013,0.0,1.0
14855,The Hole 2010 Re-release,175490,0,175490,2010.csv,2010,0.0,1.0
14856,Refugiado,175410,0,175410,2014.csv,2014,0.0,1.0
14857,Be Natural: The Untold Story of Alice Guy-Blaché,175328,115804,59524,2019.csv,2019,0.6604991786822413,0.3395008213177587
14858,Sat Shri Akaal England,175241,0,175241,2017.csv,2017,0.0,1.0
14859,Champion,175232,175232,0,2017.csv,2017,1.0,0.0
14860,With or Without You 2016 Re-release,175041,0,175041,2016.csv,2016,0.0,1.0
14861,Apparition,175038,0,175038,2019.csv,2019,0.0,1.0
14862,Classic Again,175027,0,175027,2020.csv,2020,0.0,1.0
14863,Studentfesten,175026,0,175026,2013.csv,2013,0.0,1.0
14864,Full of Hunger,174936,0,174936,2012.csv,2012,0.0,1.0
14865,Recipes of Diet Diaries,174872,0,174872,2013.csv,2013,0.0,1.0
14866,Bravehearts,174867,0,174867,2012.csv,2012,0.0,1.0
14867,A Wolf at the Door,174619,0,174619,2014.csv,2014,0.0,1.0
14868,Rassegna Cinematografica,174464,0,174464,2020.csv,2020,0.0,1.0
14869,"Happy New Year, Grandma!",174458,0,174458,2011.csv,2011,0.0,1.0
14870,Cottage Country,174306,0,174306,2013.csv,2013,0.0,1.0
14871,ToyKhtoProyshovKrizVohon,174289,0,174289,2012.csv,2012,0.0,1.0
14872,Frogs and Toads 2010 Re-release,174257,0,174257,2010.csv,2010,0.0,1.0
14873,Always at The Carlyle,174251,174251,0,2018.csv,2018,1.0,0.0
14874,Hola pravda,174204,0,174204,2020.csv,2020,0.0,1.0
14875,SOMM,174197,174197,0,2013.csv,2013,1.0,0.0
14876,Second Chance,174095,0,174095,2011.csv,2011,0.0,1.0
14877,Grand Illusion,174065,174065,0,2012.csv,2012,1.0,0.0
14878,My Dog Dou Dou,173873,0,173873,2012.csv,2012,0.0,1.0
14879,Cleo,173872,0,173872,2019.csv,2019,0.0,1.0
14880,The Father and the Foreigner,173810,0,173810,2011.csv,2011,0.0,1.0
14881,Night Ride,173798,0,173798,2020.csv,2020,0.0,1.0
14882,Ranchi Diaries,173784,0,173784,2017.csv,2017,0.0,1.0
14883,7:19,173756,0,173756,2016.csv,2016,0.0,1.0
14884,Get Out 2020 Re-release,173743,0,173743,2020.csv,2020,0.0,1.0
14885,Heil,173647,0,173647,2015.csv,2015,0.0,1.0
14886,Sound of Metal,173622,0,173622,2021.csv,2021,0.0,1.0
14887,Life is a Belief,173603,0,173603,2018.csv,2018,0.0,1.0
14888,Paparazzi,173470,0,173470,2015.csv,2015,0.0,1.0
14889,Miracle in Cell No. 7,173454,0,173454,2019.csv,2019,0.0,1.0
14890,Ganagandharvan,173330,0,173330,2019.csv,2019,0.0,1.0
14891,L'accabadora,173312,0,173312,2017.csv,2017,0.0,1.0
14892,Arvydas Sabonis 11,173307,0,173307,2014.csv,2014,0.0,1.0
14893,The First on the List,173276,0,173276,2011.csv,2011,0.0,1.0
14894,The Warden,173274,0,173274,2020.csv,2020,0.0,1.0
14895,Neon Bull,173219,26734,146485,2016.csv,2016,0.15433641806037443,0.8456635819396255
14896,Kaiken se kestää,173164,0,173164,2017.csv,2017,0.0,1.0
14897,Cirkus Columbia,173083,3457,169626,2011.csv,2011,0.019973076500869526,0.9800269234991305
14898,Them That Follow,172952,159218,13734,2019.csv,2019,0.9205906841204496,0.0794093158795504
14899,Bellflower,172935,168226,4709,2011.csv,2011,0.9727701159395149,0.027229884060485154
14900,Blackie and Canuto 3D,172929,0,172929,2014.csv,2014,0.0,1.0
14901,Petaling Street Warriors,172868,0,172868,2012.csv,2012,0.0,1.0
14902,Jamais contente,172835,0,172835,2017.csv,2017,0.0,1.0
14903,The Metropolitan Opera HD Live: Puccini: La Bohème,172729,0,172729,2014.csv,2014,0.0,1.0
14904,Enai Noki Paayum Thota,172647,0,172647,2019.csv,2019,0.0,1.0
14905,Whiteley,172607,0,172607,2017.csv,2017,0.0,1.0
14906,Foo Fighters: Back and Forth,172558,0,172558,2011.csv,2011,0.0,1.0
14907,Bang Ern Rakmaisinsud,172543,0,172543,2010.csv,2010,0.0,1.0
14908,L'intrusa,172508,0,172508,2017.csv,2017,0.0,1.0
14909,Afternoon of a Faun: Tanaquil Le Clercq,172450,172450,0,2014.csv,2014,1.0,0.0
14910,All Things Must Pass,172394,172394,0,2015.csv,2015,1.0,0.0
14911,Blood,172325,0,172325,2013.csv,2013,0.0,1.0
14912,Xiaoming and His Friends,172299,0,172299,2016.csv,2016,0.0,1.0
14913,Vodka Diaries,172266,0,172266,2018.csv,2018,0.0,1.0
14914,Morto Não Fala,172220,0,172220,2019.csv,2019,0.0,1.0
14915,Tattoo,172157,0,172157,2013.csv,2013,0.0,1.0
14916,Donbass. Okraina,172100,0,172100,2019.csv,2019,0.0,1.0
14917,Sy klink soos lente,172029,0,172029,2016.csv,2016,0.0,1.0
14918,Landraub,172002,0,172002,2015.csv,2015,0.0,1.0
14919,Escape from Tomorrow,171962,171962,0,2013.csv,2013,1.0,0.0
14920,Mumu,171939,0,171939,2010.csv,2010,0.0,1.0
14921,Little Woods,171912,150010,21902,2019.csv,2019,0.8725976080785518,0.12740239192144817
14922,Minuscule: Valley of the Lost Ants 2016 Re-release,171900,0,171900,2016.csv,2016,0.0,1.0
14923,Haunted Dormitory - Marionette Teacher,171807,0,171807,2017.csv,2017,0.0,1.0
14924,The Cinderella,171774,0,171774,2011.csv,2011,0.0,1.0
14925,Copperhead,171740,171740,0,2013.csv,2013,1.0,0.0
14926,Abuse of Weakness,171660,31611,140049,2014.csv,2014,0.1841488989863684,0.8158511010136316
14927,Summer of Changsha,171605,0,171605,2019.csv,2019,0.0,1.0
14928,Caídos del mapa,171574,0,171574,2013.csv,2013,0.0,1.0
14929,De guerre lasse,171522,0,171522,2014.csv,2014,0.0,1.0
14930,The Men's Room,171520,0,171520,2018.csv,2018,0.0,1.0
14931,United Passions,171511,607,170904,2014.csv,2014,0.003539131600888573,0.9964608683991114
14932,Elephant Song,171505,0,171505,2015.csv,2015,0.0,1.0
14933,Criminal Activities,171494,0,171494,2016.csv,2016,0.0,1.0
14934,Fasel W Na'oud,171373,0,171373,2011.csv,2011,0.0,1.0
14935,Faith,171231,0,171231,2010.csv,2010,0.0,1.0
14936,Sang Krasue,171229,0,171229,2019.csv,2019,0.0,1.0
14937,A Score to Settle,171216,0,171216,2019.csv,2019,0.0,1.0
14938,Kaum De Heere,171193,0,171193,2014.csv,2014,0.0,1.0
14939,The Bolshoi Ballet: Live From Moscow - La Sylphide,171177,171177,0,2018.csv,2018,1.0,0.0
14940,Palau the Movie,171155,134696,36459,2019.csv,2019,0.786982559668137,0.21301744033186293
14941,The Winner,171143,0,171143,2011.csv,2011,0.0,1.0
14942,Ein Geschenk der Götter,171095,0,171095,2014.csv,2014,0.0,1.0
14943,Cheerful Weather for the Wedding,170922,2651,168271,2012.csv,2012,0.015509998712863177,0.9844900012871368
14944,Chashme Baddoor,170764,0,170764,2013.csv,2013,0.0,1.0
14945,The Silencing,170653,100746,69907,2020.csv,2020,0.5903558683410195,0.4096441316589805
14946,Amnèsia 2015 Re-release,170565,0,170565,2015.csv,2015,0.0,1.0
14947,Apparition Hill,170457,170457,0,2016.csv,2016,1.0,0.0
14948,Ek Joke Net,170432,0,170432,2011.csv,2011,0.0,1.0
14949,Deseo 2013 Re-release,170339,0,170339,2013.csv,2013,0.0,1.0
14950,The Human Centipede II (Full Sequence),170323,141877,28446,2011.csv,2011,0.8329879112040065,0.1670120887959935
14951,Reus,170271,0,170271,2011.csv,2011,0.0,1.0
14952,Rak Luang Lhon,170158,0,170158,2014.csv,2014,0.0,1.0
14953,Tornado Alley,170155,0,170155,2011.csv,2011,0.0,1.0
14954,The House That Jack Built,170113,170113,0,2018.csv,2018,1.0,0.0
14955,La bella società,170072,0,170072,2010.csv,2010,0.0,1.0
14956,Legenda o Lietajúcom Cypriánovi,169797,0,169797,2010.csv,2010,0.0,1.0
14957,Büsra,169693,0,169693,2010.csv,2010,0.0,1.0
14958,Haikyuu!!: The Battle of Concepts,169519,0,169519,2018.csv,2018,0.0,1.0
14959,The Fits,169236,166425,2811,2016.csv,2016,0.9833900588527263,0.01660994114727363
14960,Anina,169159,0,169159,2013.csv,2013,0.0,1.0
14961,Wonder 2020 Re-release,169130,0,169130,2020.csv,2020,0.0,1.0
14962,Wrinkles,169058,0,169058,2012.csv,2012,0.0,1.0
14963,Brown Sugar 2,169031,0,169031,2010.csv,2010,0.0,1.0
14964,Öz Hakiki Karakol: Asayis Berkemal Aga...,169025,0,169025,2012.csv,2012,0.0,1.0
14965,Viva Riva!,168982,61759,107223,2011.csv,2011,0.3654767963451729,0.6345232036548272
14966,Free the Mind,168916,157201,11715,2013.csv,2013,0.930646001562907,0.06935399843709299
14967,Idiot Prayer,168842,0,168842,2020.csv,2020,0.0,1.0
14968,La parrucchiera,168790,0,168790,2017.csv,2017,0.0,1.0
14969,Girls of the Sun,168771,19712,149059,2018.csv,2018,0.1167973170746159,0.8832026829253841
14970,Valley of Bones,168738,168738,0,2017.csv,2017,1.0,0.0
14971,Pup,168713,0,168713,2013.csv,2013,0.0,1.0
14972,The Song Keepers,168615,0,168615,2018.csv,2018,0.0,1.0
14973,Hoodies vs. Hooligans,168588,0,168588,2014.csv,2014,0.0,1.0
14974,Verna,168552,0,168552,2017.csv,2017,0.0,1.0
14975,Black Raven,168543,0,168543,2019.csv,2019,0.0,1.0
14976,Our Sister Mambo,168478,0,168478,2015.csv,2015,0.0,1.0
14977,Treasure Hunters,168454,0,168454,2011.csv,2011,0.0,1.0
14978,The Legend of Godstow,168359,0,168359,2017.csv,2017,0.0,1.0
14979,The Godfather: Part III 2020 Re-release,168246,95330,72916,2020.csv,2020,0.5666107960961925,0.43338920390380753
14980,Beltracchi: The Art of Forgery,168238,0,168238,2014.csv,2014,0.0,1.0
14981,A Warrior's Tail 2019 Re-release,168190,0,168190,2019.csv,2019,0.0,1.0
14982,Teen Angels: el Adios 3D,168161,0,168161,2013.csv,2013,0.0,1.0
14983,De Palma,168045,165237,2808,2016.csv,2016,0.9832901901276444,0.016709809872355617
14984,The Clovehitch Killer,167994,8208,159786,2018.csv,2018,0.04885888781742205,0.9511411121825779
14985,The Bolshoi Ballet: Live From Moscow - The Lady of the Camellias,167991,167991,0,2018.csv,2018,1.0,0.0
14986,Perrier's Bounty,167938,828,167110,2010.csv,2010,0.004930390977622694,0.9950696090223773
14987,The Last Right,167798,0,167798,2019.csv,2019,0.0,1.0
14988,Hurvínek na scénì,167738,0,167738,2010.csv,2010,0.0,1.0
14989,No Stone Unturned,167730,0,167730,2017.csv,2017,0.0,1.0
14990,Beauty and the Dogs,167723,8915,158808,2017.csv,2017,0.05315311555362115,0.9468468844463789
14991,Strangers in the City,167531,0,167531,2010.csv,2010,0.0,1.0
14992,Genius Within: The Inner Life of Glenn Gould,167508,167508,0,2010.csv,2010,1.0,0.0
14993,Raaiselkind,167482,0,167482,2018.csv,2018,0.0,1.0
14994,Pericle,167439,0,167439,2016.csv,2016,0.0,1.0
14995,Rina,167405,0,167405,2010.csv,2010,0.0,1.0
14996,Fair Love,167350,0,167350,2010.csv,2010,0.0,1.0
14997,Bokutachi no afutâ sukûru,167327,0,167327,2011.csv,2011,0.0,1.0
14998,Marcello Marcello 2010 Re-release,167287,0,167287,2010.csv,2010,0.0,1.0
14999,Tokyo Fiancée,167230,0,167230,2014.csv,2014,0.0,1.0
15000,The Happiness of a Mother,167217,0,167217,2019.csv,2019,0.0,1.0
15001,Türkan,167173,0,167173,2011.csv,2011,0.0,1.0
15002,Juvenile Advisor of Dayu Treasure,167170,0,167170,2016.csv,2016,0.0,1.0
15003,Man Down,167085,0,167085,2016.csv,2016,0.0,1.0
15004,Bang Jia Bing Ji Ling,166894,0,166894,2010.csv,2010,0.0,1.0
15005,Che: A New Man,166884,0,166884,2010.csv,2010,0.0,1.0
15006,A Dangerous Man,166865,0,166865,2011.csv,2011,0.0,1.0
15007,Love Without Rules,166858,0,166858,2016.csv,2016,0.0,1.0
15008,Captain,166792,0,166792,2018.csv,2018,0.0,1.0
15009,Is Genesis History? 2018 Re-release,166763,166763,0,2018.csv,2018,1.0,0.0
15010,The Lost Brother,166741,0,166741,2017.csv,2017,0.0,1.0
15011,Pyewacket,166610,0,166610,2018.csv,2018,0.0,1.0
15012,Unalterable,166596,0,166596,2019.csv,2019,0.0,1.0
15013,Le Tour: My Last 49 Days,166564,0,166564,2017.csv,2017,0.0,1.0
15014,Pushkin Hills,166535,0,166535,2018.csv,2018,0.0,1.0
15015,Groundhog Day 2021 Re-release,166447,166447,0,2021.csv,2021,1.0,0.0
15016,The Common Story,166389,0,166389,2019.csv,2019,0.0,1.0
15017,Blue Hour,166334,0,166334,2020.csv,2020,0.0,1.0
15018,The Lost Boys 2020 Re-release,166331,0,166331,2020.csv,2020,0.0,1.0
15019,Lajkó - Cigány az ürben,166179,0,166179,2018.csv,2018,0.0,1.0
15020,The Day After,166022,24746,141276,2017.csv,2017,0.1490525352061775,0.8509474647938225
15021,Far From the Tree,166018,166018,0,2018.csv,2018,1.0,0.0
15022,The Punk Syndrome,166006,0,166006,2012.csv,2012,0.0,1.0
15023,Fool for Love,165987,165987,0,2010.csv,2010,1.0,0.0
15024,Bing at the Cinema,165980,0,165980,2018.csv,2018,0.0,1.0
15025,Mom and Dad,165962,0,165962,2018.csv,2018,0.0,1.0
15026,The Film Critic,165891,7358,158533,2014.csv,2014,0.04435442549625959,0.9556455745037404
15027,Lügen,165884,0,165884,2014.csv,2014,0.0,1.0
15028,O Amor É Lindo... Porque Sim!,165854,0,165854,2016.csv,2016,0.0,1.0
15029,My Internship in Canada,165801,0,165801,2016.csv,2016,0.0,1.0
15030,The Chambermaid,165711,86422,79289,2019.csv,2019,0.5215224094960503,0.47847759050394967
15031,Zombie Fight Club,165653,0,165653,2014.csv,2014,0.0,1.0
15032,Bright Ones,165627,165627,0,2019.csv,2019,1.0,0.0
15033,Office Uprising,165623,0,165623,2018.csv,2018,0.0,1.0
15034,Fit Lover 2012 Re-release,165589,0,165589,2012.csv,2012,0.0,1.0
15035,Sparring,165548,0,165548,2018.csv,2018,0.0,1.0
15036,App Love,165522,0,165522,2014.csv,2014,0.0,1.0
15037,Wayang Boy,165346,0,165346,2014.csv,2014,0.0,1.0
15038,Cowboys,165280,0,165280,2013.csv,2013,0.0,1.0
15039,The Dealer,165157,0,165157,2010.csv,2010,0.0,1.0
15040,Amapola,165074,0,165074,2014.csv,2014,0.0,1.0
15041,Bhaagamathie,164967,0,164967,2018.csv,2018,0.0,1.0
15042,Land and Shade,164916,0,164916,2015.csv,2015,0.0,1.0
15043,Christmas Eve,164839,91302,73537,2015.csv,2015,0.5538859129210927,0.4461140870789073
15044,The House,164772,0,164772,2016.csv,2016,0.0,1.0
15045,Ways to Live Forever,164720,0,164720,2010.csv,2010,0.0,1.0
15046,Charade 2010 Re-release,164715,0,164715,2010.csv,2010,0.0,1.0
15047,Dear Comrade,164714,0,164714,2019.csv,2019,0.0,1.0
15048,The Incredibles 2015 Re-release,164621,0,164621,2015.csv,2015,0.0,1.0
15049,Small Town Killers,164604,0,164604,2017.csv,2017,0.0,1.0
15050,Tafash We Arb3een Harami,164584,0,164584,2017.csv,2017,0.0,1.0
15051,Beta'a Kulu,164544,0,164544,2019.csv,2019,0.0,1.0
15052,Nas: Time Is Illmatic,164540,164540,0,2014.csv,2014,1.0,0.0
15053,Si muore tutti democristiani,164524,0,164524,2018.csv,2018,0.0,1.0
15054,Star Ant: Global Adventure,164460,0,164460,2016.csv,2016,0.0,1.0
15055,The Neighbor,164348,0,164348,2016.csv,2016,0.0,1.0
15056,Eastern Boys,164290,16831,147459,2014.csv,2014,0.10244689268975592,0.8975531073102441
15057,Luk Thung Signature,164238,0,164238,2016.csv,2016,0.0,1.0
15058,Combat Wombat,164199,0,164199,2020.csv,2020,0.0,1.0
15059,Lost & Found,164026,125173,38853,2018.csv,2018,0.7631290161315889,0.2368709838684111
15060,Dümdüzz Adam,164024,0,164024,2018.csv,2018,0.0,1.0
15061,Ask aglatir,163990,0,163990,2013.csv,2013,0.0,1.0
15062,Ghost 30th Anniversary,163987,0,163987,2020.csv,2020,0.0,1.0
15063,The 100 Candles Game,163948,0,163948,2020.csv,2020,0.0,1.0
15064,Cruel Peter,163925,0,163925,2020.csv,2020,0.0,1.0
15065,"Berlin, I Love You",163908,0,163908,2019.csv,2019,0.0,1.0
15066,Slam,163771,0,163771,2017.csv,2017,0.0,1.0
15067,Keep on Keepin' On,163745,163745,0,2014.csv,2014,1.0,0.0
15068,Jack Goes Boating 2014 Re-release,163727,0,163727,2014.csv,2014,0.0,1.0
15069,Narco Cultura,163690,145088,18602,2013.csv,2013,0.88635836031523,0.11364163968477
15070,Seni Seven Ölsün,163629,0,163629,2016.csv,2016,0.0,1.0
15071,Klovn the Final,163603,0,163603,2020.csv,2020,0.0,1.0
15072,The Reckoning,163594,143532,20062,2021.csv,2021,0.8773671406041786,0.12263285939582136
15073,Sijjin 2,163542,0,163542,2015.csv,2015,0.0,1.0
15074,Bhuddah Hoga Tera Baap,163533,0,163533,2011.csv,2011,0.0,1.0
15075,Rapid Reaction Corps 2,163368,0,163368,2014.csv,2014,0.0,1.0
15076,Future World,163313,0,163313,2018.csv,2018,0.0,1.0
15077,An Act of Defiance,163150,0,163150,2017.csv,2017,0.0,1.0
15078,1 Day 2015 Re-release,163116,0,163116,2015.csv,2015,0.0,1.0
15079,Pound of Flesh,163080,0,163080,2015.csv,2015,0.0,1.0
15080,Ebn El Onsol,163006,0,163006,2011.csv,2011,0.0,1.0
15081,Bad Girls,162965,0,162965,2012.csv,2012,0.0,1.0
15082,Cinema Kabuki: Kisen/Bo Shibari,162922,0,162922,2016.csv,2016,0.0,1.0
15083,Cinderella 2012 Re-release,162911,0,162911,2012.csv,2012,0.0,1.0
15084,Tanu Weds Manu,162756,0,162756,2011.csv,2011,0.0,1.0
15085,Güzel Günler Görecegiz,162693,0,162693,2012.csv,2012,0.0,1.0
15086,No Boyfriend Since Birth,162656,0,162656,2015.csv,2015,0.0,1.0
15087,Beshoot,162640,0,162640,2019.csv,2019,0.0,1.0
15088,Kings of Mulberry Street,162569,0,162569,2019.csv,2019,0.0,1.0
15089,City State,162562,0,162562,2011.csv,2011,0.0,1.0
15090,The Ugly Duckling,162484,0,162484,2010.csv,2010,0.0,1.0
15091,Walking Out,162445,101947,60498,2017.csv,2017,0.6275785650527871,0.3724214349472129
15092,Barry Lyndon 2016 Re-release,162407,0,162407,2016.csv,2016,0.0,1.0
15093,Sindrom Petrushki,162402,0,162402,2015.csv,2015,0.0,1.0
15094,We All Want What's Best for Her,162391,0,162391,2013.csv,2013,0.0,1.0
15095,On the Roof,162340,0,162340,2019.csv,2019,0.0,1.0
15096,Karate-Robo Zaborgar,162288,0,162288,2011.csv,2011,0.0,1.0
15097,Seduction,162262,0,162262,2012.csv,2012,0.0,1.0
15098,Lila's Book,162192,0,162192,2017.csv,2017,0.0,1.0
15099,Tepe'nin Usaklari,162131,0,162131,2013.csv,2013,0.0,1.0
15100,The Turin Horse,162088,56391,105697,2011.csv,2011,0.34790360791668723,0.6520963920833127
15101,Drishyam,162072,0,162072,2014.csv,2014,0.0,1.0
15102,Jane,161991,0,161991,2017.csv,2017,0.0,1.0
15103,Seve,161874,0,161874,2014.csv,2014,0.0,1.0
15104,The Calling,161842,0,161842,2010.csv,2010,0.0,1.0
15105,Vestuves/The Wedding,161805,0,161805,2019.csv,2019,0.0,1.0
15106,Satellite Boy,161780,0,161780,2013.csv,2013,0.0,1.0
15107,O Paciente: O Caso Tancredo Neves,161725,0,161725,2018.csv,2018,0.0,1.0
15108,Ghostbusters 2011 Re-release,161688,0,161688,2011.csv,2011,0.0,1.0
15109,Road to Nowhere,161619,40294,121325,2011.csv,2011,0.24931474640976617,0.7506852535902339
15110,Sventa Karve,161607,0,161607,2014.csv,2014,0.0,1.0
15111,The Samuel Project,161565,161565,0,2018.csv,2018,1.0,0.0
15112,Let's Go,161474,0,161474,2018.csv,2018,0.0,1.0
15113,Kampterrein,161424,0,161424,2017.csv,2017,0.0,1.0
15114,Hotel Swooni,161338,0,161338,2011.csv,2011,0.0,1.0
15115,Zkáza krásou,161334,0,161334,2016.csv,2016,0.0,1.0
15116,Marsella,161333,0,161333,2014.csv,2014,0.0,1.0
15117,Gang Leader,161321,0,161321,2019.csv,2019,0.0,1.0
15118,Little Mix: LM5 - The Tour Film,161260,0,161260,2020.csv,2020,0.0,1.0
15119,Lu Over the Wall,161253,109857,51396,2018.csv,2018,0.6812710461200722,0.31872895387992783
15120,Tharlo,161229,17091,144138,2016.csv,2016,0.10600450291200715,0.8939954970879929
15121,Be Afraid,161172,0,161172,2017.csv,2017,0.0,1.0
15122,Spring Fever,161110,10824,150286,2010.csv,2010,0.06718391161318354,0.9328160883868165
15123,Pepa,161086,0,161086,2018.csv,2018,0.0,1.0
15124,"Diana Ross: Her Life, Love and Legacy",160968,160968,0,2019.csv,2019,1.0,0.0
15125,Hesapta Ask,160958,0,160958,2016.csv,2016,0.0,1.0
15126,The Fantastic Family Hotel,160926,0,160926,2017.csv,2017,0.0,1.0
15127,Hunt to Kill,160867,0,160867,2013.csv,2013,0.0,1.0
15128,No te enamores de mí,160860,0,160860,2012.csv,2012,0.0,1.0
15129,Love in Late Autumn,160854,0,160854,2016.csv,2016,0.0,1.0
15130,Twelve Nights,160796,0,160796,2014.csv,2014,0.0,1.0
15131,French Toast,160742,0,160742,2015.csv,2015,0.0,1.0
15132,Her Love Boils Bathwater,160697,0,160697,2017.csv,2017,0.0,1.0
15133,Black Gospel,160687,0,160687,2013.csv,2013,0.0,1.0
15134,A Decent Man,160683,0,160683,2016.csv,2016,0.0,1.0
15135,To the Four Winds,160655,0,160655,2018.csv,2018,0.0,1.0
15136,Captain Alatriste: The Spanish Musketeer 2010 Re-release,160653,0,160653,2010.csv,2010,0.0,1.0
15137,Irupathiyonnaam Noottaandu,160627,0,160627,2019.csv,2019,0.0,1.0
15138,O Renascimento do Parto,160582,0,160582,2013.csv,2013,0.0,1.0
15139,Tiempo sin aire,160477,0,160477,2015.csv,2015,0.0,1.0
15140,Induced Labor,160460,0,160460,2018.csv,2018,0.0,1.0
15141,Death of a Man in the Balkans,160382,0,160382,2012.csv,2012,0.0,1.0
15142,National Theatre Live: The Curious Incident of the Dog in the Night-Time 2018 Re-release,160381,160381,0,2018.csv,2018,1.0,0.0
15143,Bound to Vengeance,160358,0,160358,2015.csv,2015,0.0,1.0
15144,Pleasant Goat 6,160357,0,160357,2014.csv,2014,0.0,1.0
15145,Super 8 Stories 2011 Re-release,160356,0,160356,2011.csv,2011,0.0,1.0
15146,Thomas & Friends: Tale of the Brave 2016 Re-release,160354,0,160354,2016.csv,2016,0.0,1.0
15147,Gek van Oranje,160236,0,160236,2018.csv,2018,0.0,1.0
15148,Beauty and the Beast 2016 Re-release,160215,160215,0,2016.csv,2016,1.0,0.0
15149,Petra,160148,0,160148,2018.csv,2018,0.0,1.0
15150,Suzi Q,160132,0,160132,2019.csv,2019,0.0,1.0
15151,Levski,160101,0,160101,2015.csv,2015,0.0,1.0
15152,Halloween 2020 Re-release,160000,160000,0,2020.csv,2020,1.0,0.0
15153,Voltage Extraordinaire,160000,0,160000,2013.csv,2013,0.0,1.0
15154,El último cuerpo,159940,0,159940,2011.csv,2011,0.0,1.0
15155,Agnes Joy,159915,0,159915,2019.csv,2019,0.0,1.0
15156,Mil cretins,159885,0,159885,2011.csv,2011,0.0,1.0
15157,Sinbad: The Fifth Voyage,159862,159862,0,2014.csv,2014,1.0,0.0
15158,The Eclipse,159852,133411,26441,2010.csv,2010,0.8345907464404574,0.16540925355954259
15159,The Last Man on Earth,159846,0,159846,2011.csv,2011,0.0,1.0
15160,Lost Place,159828,0,159828,2013.csv,2013,0.0,1.0
15161,Dawn of the Dead,159822,0,159822,2020.csv,2020,0.0,1.0
15162,Murder 3,159798,0,159798,2013.csv,2013,0.0,1.0
15163,The Model,159743,0,159743,2016.csv,2016,0.0,1.0
15164,DEATH Siam Masseur,159720,0,159720,2015.csv,2015,0.0,1.0
15165,Eames: The Architect & The Painter,159715,153088,6627,2011.csv,2011,0.9585073412015152,0.0414926587984848
15166,Red Land (Rosso Istria),159693,0,159693,2018.csv,2018,0.0,1.0
15167,From Time to Time,159640,0,159640,2011.csv,2011,0.0,1.0
15168,70 Big Ones,159630,0,159630,2019.csv,2019,0.0,1.0
15169,Wounded,159561,0,159561,2013.csv,2013,0.0,1.0
15170,Tall Tales,159554,0,159554,2019.csv,2019,0.0,1.0
15171,Warriors of the Nation,159503,0,159503,2019.csv,2019,0.0,1.0
15172,Into Paradiso,159465,0,159465,2011.csv,2011,0.0,1.0
15173,The Body,159317,68196,91121,2019.csv,2019,0.42805224803379427,0.5719477519662057
15174,The Witness,159305,159305,0,2016.csv,2016,1.0,0.0
15175,Happy Together,159277,0,159277,2018.csv,2018,0.0,1.0
15176,Rüzgar,159222,0,159222,2018.csv,2018,0.0,1.0
15177,Victoria 2015 Re-release,159156,0,159156,2015.csv,2015,0.0,1.0
15178,Bolshoi Ballet: The Lady of the Camellias,159155,0,159155,2015.csv,2015,0.0,1.0
15179,Milosc,159106,0,159106,2013.csv,2013,0.0,1.0
15180,We Are What We Are,159047,81381,77666,2013.csv,2013,0.5116789376725119,0.4883210623274881
15181,The Next Skin,159020,0,159020,2016.csv,2016,0.0,1.0
15182,Ip Man: Kung Fu Master,158953,3439,155514,2020.csv,2020,0.02163532616559612,0.9783646738344038
15183,Pulp Fiction 2019 Re-release,158952,0,158952,2019.csv,2019,0.0,1.0
15184,Shiver 2010 Re-release,158949,0,158949,2010.csv,2010,0.0,1.0
15185,Star Wars: Episode VIII - The Last Jedi 2020 Re-release,158941,0,158941,2020.csv,2020,0.0,1.0
15186,Until Forever,158872,35839,123033,2016.csv,2016,0.2255841180321265,0.7744158819678735
15187,Driving for You All Night,158737,0,158737,2019.csv,2019,0.0,1.0
15188,Breaking Surface,158659,0,158659,2020.csv,2020,0.0,1.0
15189,Chicas,158653,0,158653,2010.csv,2010,0.0,1.0
15190,I Am Grandmother,158650,0,158650,2010.csv,2010,0.0,1.0
15191,The Last Resort,158646,158646,0,2018.csv,2018,1.0,0.0
15192,The 4th Company,158560,0,158560,2018.csv,2018,0.0,1.0
15193,If You Are Happy,158527,0,158527,2019.csv,2019,0.0,1.0
15194,Logan 2020 Re-release,158514,0,158514,2020.csv,2020,0.0,1.0
15195,El Kwaissen,158493,0,158493,2018.csv,2018,0.0,1.0
15196,Pitch,158481,0,158481,2016.csv,2016,0.0,1.0
15197,B. Tech,158444,0,158444,2018.csv,2018,0.0,1.0
15198,Phase 7,158421,0,158421,2011.csv,2011,0.0,1.0
15199,The Big Picture 2012 Re-release,158411,158411,0,2012.csv,2012,1.0,0.0
15200,Maurice 2018 Re-release,158337,0,158337,2018.csv,2018,0.0,1.0
15201,E io non pago,158312,0,158312,2012.csv,2012,0.0,1.0
15202,Nene Hatun,158168,0,158168,2010.csv,2010,0.0,1.0
15203,The Peach Tree,158156,0,158156,2012.csv,2012,0.0,1.0
15204,Mother of George,157937,157937,0,2013.csv,2013,1.0,0.0
15205,Polar Adventure 2018 Re-release,157877,0,157877,2018.csv,2018,0.0,1.0
15206,Blue Goldfish,157874,0,157874,2018.csv,2018,0.0,1.0
15207,The Look of Silence,157857,109089,48768,2015.csv,2015,0.6910621638571619,0.30893783614283815
15208,Autumn Sunshine,157828,0,157828,2017.csv,2017,0.0,1.0
15209,Adana isi,157822,0,157822,2015.csv,2015,0.0,1.0
15210,Majili,157784,0,157784,2019.csv,2019,0.0,1.0
15211,Crazy Horse,157782,157782,0,2012.csv,2012,1.0,0.0
15212,Hell and Back,157768,157768,0,2015.csv,2015,1.0,0.0
15213,Attack on Titan: Crimson Bow and Arrow,157747,0,157747,2015.csv,2015,0.0,1.0
15214,Sigo siendo,157684,0,157684,2013.csv,2013,0.0,1.0
15215,Caffè,157683,0,157683,2017.csv,2017,0.0,1.0
15216,Final Balance,157646,0,157646,2011.csv,2011,0.0,1.0
15217,Chasing Madoff,157612,157612,0,2011.csv,2011,1.0,0.0
15218,Cykelmyggen og minibillen,157515,0,157515,2014.csv,2014,0.0,1.0
15219,Eva Hesse,157481,157481,0,2016.csv,2016,1.0,0.0
15220,Wunderkinder,157362,0,157362,2011.csv,2011,0.0,1.0
15221,When Africa Meets You,157273,0,157273,2018.csv,2018,0.0,1.0
15222,Suntan,157267,6643,150624,2016.csv,2016,0.042240266553059444,0.9577597334469405
15223,Code 8,157209,0,157209,2019.csv,2019,0.0,1.0
15224,The Snow Queen 2018 Re-release,157158,0,157158,2018.csv,2018,0.0,1.0
15225,"Sexo, amor y otras perversiones 2",157155,0,157155,2011.csv,2011,0.0,1.0
15226,Two Buddies and a Badger 2017 Re-release,157091,0,157091,2017.csv,2017,0.0,1.0
15227,The Metropolitan Opera HD Live: Verdi: Rigoletto,157058,0,157058,2013.csv,2013,0.0,1.0
15228,Fate Express,157047,0,157047,2018.csv,2018,0.0,1.0
15229,Spike Island,157036,0,157036,2013.csv,2013,0.0,1.0
15230,My Own Good,157032,0,157032,2018.csv,2018,0.0,1.0
15231,LUV,156996,156996,0,2013.csv,2013,1.0,0.0
15232,Summer Survivors,156984,0,156984,2019.csv,2019,0.0,1.0
15233,Young-ju,156949,0,156949,2018.csv,2018,0.0,1.0
15234,Boogeyman 3,156941,0,156941,2010.csv,2010,0.0,1.0
15235,One Day or Another,156867,0,156867,2012.csv,2012,0.0,1.0
15236,Yes or No 2.5,156856,0,156856,2015.csv,2015,0.0,1.0
15237,Tainted Souls,156819,0,156819,2017.csv,2017,0.0,1.0
15238,To the Woods,156814,0,156814,2012.csv,2012,0.0,1.0
15239,Dear Comrades,156771,0,156771,2020.csv,2020,0.0,1.0
15240,Sous X,156706,0,156706,2015.csv,2015,0.0,1.0
15241,Marina Abramovic: The Artist Is Present,156695,86637,70058,2012.csv,2012,0.5529021347203166,0.4470978652796835
15242,Was machen Frauen morgens um halb vier?,156693,0,156693,2012.csv,2012,0.0,1.0
15243,Beyond Sleep,156655,0,156655,2016.csv,2016,0.0,1.0
15244,La scomparsa di Patò,156631,0,156631,2012.csv,2012,0.0,1.0
15245,Sketch,156566,0,156566,2018.csv,2018,0.0,1.0
15246,Lies & Illusions,156510,0,156510,2010.csv,2010,0.0,1.0
15247,Lilly the Little Fish,156494,0,156494,2018.csv,2018,0.0,1.0
15248,Kai,156431,0,156431,2016.csv,2016,0.0,1.0
15249,Si può fare l'amore vestiti?,156395,0,156395,2012.csv,2012,0.0,1.0
15250,Helmut Newton: The Bad and the Beautiful,156392,0,156392,2020.csv,2020,0.0,1.0
15251,Pure Hearts,156302,0,156302,2017.csv,2017,0.0,1.0
15252,Take Me Home 2019 Re-release,156248,0,156248,2019.csv,2019,0.0,1.0
15253,Hatchet II,156190,52604,103586,2010.csv,2010,0.3367949292528331,0.663205070747167
15254,Elveda Katya,156189,0,156189,2012.csv,2012,0.0,1.0
15255,Hasta que la boda nos separe,156159,0,156159,2018.csv,2018,0.0,1.0
15256,Hailongtun Tusi Fortress,156145,0,156145,2018.csv,2018,0.0,1.0
15257,George Harrison: Living in the Material World,156113,0,156113,2011.csv,2011,0.0,1.0
15258,Deadtime,156072,156072,0,2012.csv,2012,1.0,0.0
15259,Boonie Bears: Homeward Journey,156002,0,156002,2017.csv,2017,0.0,1.0
15260,"Die Frau, die sich traut",155994,0,155994,2013.csv,2013,0.0,1.0
15261,"Das Märchen von der Prinzessin, die unbedingt in einem Märchen vorkommen wollte",155990,0,155990,2013.csv,2013,0.0,1.0
15262,Urban Family,155929,0,155929,2015.csv,2015,0.0,1.0
15263,"Spring, Again",155918,0,155918,2019.csv,2019,0.0,1.0
15264,Derby Dogs,155896,0,155896,2012.csv,2012,0.0,1.0
15265,Queen & Country,155881,41297,114584,2015.csv,2015,0.26492645030504036,0.7350735496949596
15266,Money,155732,155732,0,2019.csv,2019,1.0,0.0
15267,Mamá al volante,155625,0,155625,2019.csv,2019,0.0,1.0
15268,The Forgiveness of Blood,155383,126700,28683,2012.csv,2012,0.8154045165816081,0.18459548341839196
15269,Kyaa Super Kool Hain Hum,155357,0,155357,2012.csv,2012,0.0,1.0
15270,Skylight,155339,0,155339,2014.csv,2014,0.0,1.0
15271,The Barrens,155339,0,155339,2013.csv,2013,0.0,1.0
15272,The Invisible,155314,0,155314,2020.csv,2020,0.0,1.0
15273,The Boy and the World 2015 Re-release,155215,129480,25735,2015.csv,2015,0.8341977257352704,0.16580227426472957
15274,Western,155215,41072,114143,2018.csv,2018,0.2646136004896434,0.7353863995103566
15275,After School Midnighters,155202,0,155202,2014.csv,2014,0.0,1.0
15276,En prest og en plage,155123,0,155123,2014.csv,2014,0.0,1.0
15277,Los inadaptados,155097,0,155097,2011.csv,2011,0.0,1.0
15278,Anegan,155084,0,155084,2015.csv,2015,0.0,1.0
15279,Dulha Mil Gaya,155058,0,155058,2010.csv,2010,0.0,1.0
15280,Matthew Bourne's the Red Shoes,155023,0,155023,2020.csv,2020,0.0,1.0
15281,Magic Trip: Ken Kesey's Search for a Kool Place,155005,154521,484,2011.csv,2011,0.9968775200799974,0.0031224799200025807
15282,The Rocky Horror Picture Show 2020 Re-release,154918,0,154918,2020.csv,2020,0.0,1.0
15283,Risto,154855,0,154855,2011.csv,2011,0.0,1.0
15284,The Secret of Immortal Code,154845,0,154845,2018.csv,2018,0.0,1.0
15285,The Human Contract,154527,0,154527,2010.csv,2010,0.0,1.0
15286,The Metropolitan Opera HD Live: Berg: Wozzeck,154471,0,154471,2020.csv,2020,0.0,1.0
15287,A Date for Mad Mary,154431,0,154431,2016.csv,2016,0.0,1.0
15288,The Game,154330,0,154330,2016.csv,2016,0.0,1.0
15289,The Crypt,154291,0,154291,2015.csv,2015,0.0,1.0
15290,Antarctica: Ice and Sky,154243,0,154243,2015.csv,2015,0.0,1.0
15291,Bad Reputation,154190,148568,5622,2018.csv,2018,0.963538491471561,0.03646150852843894
15292,Joris en Boris en het geheim van de tempel,154038,0,154038,2012.csv,2012,0.0,1.0
15293,Okdat Al Kawja,154018,0,154018,2018.csv,2018,0.0,1.0
15294,El show de cejas pobladas,154015,0,154015,2017.csv,2017,0.0,1.0
15295,Haikyuu!! Ova 4 And Haikyu!! Ova 5,153999,0,153999,2020.csv,2020,0.0,1.0
15296,Eating Animals,153993,149614,4379,2018.csv,2018,0.9715636425032307,0.028436357496769333
15297,Most Wanted,153983,138000,15983,2020.csv,2020,0.8962028275848632,0.10379717241513674
15298,Toast,153922,0,153922,2011.csv,2011,0.0,1.0
15299,Citizen Koch,153908,153908,0,2014.csv,2014,1.0,0.0
15300,The Tag Along: Devil Fish,153895,20726,133169,2018.csv,2018,0.13467624029370676,0.8653237597062933
15301,Chut sui fu yung,153880,0,153880,2010.csv,2010,0.0,1.0
15302,"How Much Does Your Building Weigh, Mr Foster?",153869,0,153869,2010.csv,2010,0.0,1.0
15303,Krakel Spektakel,153776,0,153776,2014.csv,2014,0.0,1.0
15304,Maternal,153697,0,153697,2020.csv,2020,0.0,1.0
15305,Agur Etxebeste!,153657,0,153657,2019.csv,2019,0.0,1.0
15306,Cruelty,153598,0,153598,2016.csv,2016,0.0,1.0
15307,Jeepers Creepers 2018 Re-release,153514,0,153514,2018.csv,2018,0.0,1.0
15308,Vive por mí,153505,0,153505,2017.csv,2017,0.0,1.0
15309,Love Story 50th Anniversary,153504,153504,0,2020.csv,2020,1.0,0.0
15310,Distortion,153485,0,153485,2012.csv,2012,0.0,1.0
15311,Harmonium,153283,17191,136092,2017.csv,2017,0.11215203251502123,0.8878479674849787
15312,Translator,153165,0,153165,2015.csv,2015,0.0,1.0
15313,Tonnerre,153161,0,153161,2014.csv,2014,0.0,1.0
15314,Quick,153129,0,153129,2019.csv,2019,0.0,1.0
15315,Backstreet Boys: Show 'Em What You're Made Of,153068,153068,0,2015.csv,2015,1.0,0.0
15316,Haunted Holiday,152999,0,152999,2010.csv,2010,0.0,1.0
15317,Nane ile Limon: Kayip Zaman Yolcusu,152887,0,152887,2017.csv,2017,0.0,1.0
15318,In the Shadow of Women,152802,50291,102511,2015.csv,2015,0.329125273229408,0.670874726770592
15319,Deceptive Practice: The Mysteries and Mentors of Ricky Jay,152791,152791,0,2013.csv,2013,1.0,0.0
15320,Changes,152786,0,152786,2014.csv,2014,0.0,1.0
15321,A Date with Miss Fortune,152653,0,152653,2015.csv,2015,0.0,1.0
15322,Bad Family,152357,0,152357,2010.csv,2010,0.0,1.0
15323,Finding Fela,152346,120980,31366,2014.csv,2014,0.7941133997610702,0.2058866002389298
15324,The Call Up,152294,0,152294,2016.csv,2016,0.0,1.0
15325,Snake & Mongoose,152200,152200,0,2013.csv,2013,1.0,0.0
15326,Sputnik,152194,0,152194,2013.csv,2013,0.0,1.0
15327,One Week and a Day,152178,41614,110564,2016.csv,2016,0.2734560843223068,0.7265439156776933
15328,Holy Expectations,152012,0,152012,2019.csv,2019,0.0,1.0
15329,72 Hours,151992,0,151992,2016.csv,2016,0.0,1.0
15330,"Buttons, A New Musical Film",151983,151983,0,2018.csv,2018,1.0,0.0
15331,Mayaanadhi,151973,0,151973,2018.csv,2018,0.0,1.0
15332,My Punch-Drunk Boxer,151971,0,151971,2019.csv,2019,0.0,1.0
15333,Born to Be Blue,151926,151926,0,2016.csv,2016,1.0,0.0
15334,Octonauts & the Great Barrier Reef,151898,0,151898,2020.csv,2020,0.0,1.0
15335,Tampopo 2018 Re-release,151874,0,151874,2018.csv,2018,0.0,1.0
15336,Lupin the 3rd: Castle of Cagliostro 2017 Re-release,151802,142425,9377,2017.csv,2017,0.9382287453393235,0.06177125466067641
15337,Generation Found,151751,151751,0,2016.csv,2016,1.0,0.0
15338,Red Riding: The Year of Our Lord 1974,151644,151644,0,2010.csv,2010,1.0,0.0
15339,The Eighth Commissioner,151599,0,151599,2018.csv,2018,0.0,1.0
15340,Stalin's Couch,151589,0,151589,2017.csv,2017,0.0,1.0
15341,Güelcom,151568,0,151568,2011.csv,2011,0.0,1.0
15342,Before You Know It,151507,151507,0,2019.csv,2019,1.0,0.0
15343,Dead Trigger,151493,0,151493,2018.csv,2018,0.0,1.0
15344,Bumperkleef,151484,0,151484,2019.csv,2019,0.0,1.0
15345,Only You 2019 Re-release,151459,0,151459,2019.csv,2019,0.0,1.0
15346,Lost Kisses,151454,0,151454,2011.csv,2011,0.0,1.0
15347,Camille,151450,0,151450,2019.csv,2019,0.0,1.0
15348,Real Playing Game,151448,0,151448,2013.csv,2013,0.0,1.0
15349,Play or Die,151381,0,151381,2019.csv,2019,0.0,1.0
15350,Jay Myself,151331,151331,0,2019.csv,2019,1.0,0.0
15351,Revenge of the Electric Car,151272,150886,386,2011.csv,2011,0.9974483050399281,0.0025516949600719236
15352,The Cremaster Cycle 2010 Re-release,151239,151239,0,2010.csv,2010,1.0,0.0
15353,Guest iin London,151237,0,151237,2017.csv,2017,0.0,1.0
15354,Ankhon Dekhi,151226,0,151226,2014.csv,2014,0.0,1.0
15355,Unexpectedly Yours,151225,0,151225,2017.csv,2017,0.0,1.0
15356,Var inte rädd Långa farbrorn 2012 Re-release,151210,0,151210,2012.csv,2012,0.0,1.0
15357,The House,151191,0,151191,2011.csv,2011,0.0,1.0
15358,Tell It to the Bees,151107,0,151107,2019.csv,2019,0.0,1.0
15359,Handle with Care,151104,0,151104,2017.csv,2017,0.0,1.0
15360,Aquaslash,151067,0,151067,2020.csv,2020,0.0,1.0
15361,After My Death,151024,0,151024,2018.csv,2018,0.0,1.0
15362,La Gran Promesa,150866,0,150866,2018.csv,2018,0.0,1.0
15363,Glory 2019 Re-release,150801,150801,0,2019.csv,2019,1.0,0.0
15364,Crawlspace 2016 Re-release,150785,0,150785,2016.csv,2016,0.0,1.0
15365,Tasting Menu,150718,18686,132032,2013.csv,2013,0.12397988296023037,0.8760201170397697
15366,MCA Middle Class Abbayi,150599,0,150599,2017.csv,2017,0.0,1.0
15367,i-Mania,150406,0,150406,2019.csv,2019,0.0,1.0
15368,Kidon,150390,0,150390,2014.csv,2014,0.0,1.0
15369,The Practice of Beauty,150333,0,150333,2011.csv,2011,0.0,1.0
15370,My Last Love,150306,0,150306,2017.csv,2017,0.0,1.0
15371,Birds of America,150278,0,150278,2011.csv,2011,0.0,1.0
15372,Taita Boves,150247,0,150247,2010.csv,2010,0.0,1.0
15373,Yourself and Yours,150229,0,150229,2016.csv,2016,0.0,1.0
15374,Kicks,150191,150191,0,2016.csv,2016,1.0,0.0
15375,Godzilla 2014 Re-release,150191,150191,0,2014.csv,2014,1.0,0.0
15376,Nobody Else But You,150173,43040,107133,2011.csv,2011,0.28660278478821094,0.7133972152117891
15377,Canova,150158,0,150158,2019.csv,2019,0.0,1.0
15378,Son of Babylon,150100,0,150100,2010.csv,2010,0.0,1.0
15379,The Metropolitan Opera HD Live: Wagner: Siegfried 2012 Re-release,150028,0,150028,2012.csv,2012,0.0,1.0
15380,The Sea of Itami Jun,150008,0,150008,2019.csv,2019,0.0,1.0
15381,Only the Brave,150000,150000,0,2010.csv,2010,1.0,0.0
15382,The Plan,149937,0,149937,2020.csv,2020,0.0,1.0
15383,The Age of Blood,149935,0,149935,2017.csv,2017,0.0,1.0
15384,40,149870,0,149870,2011.csv,2011,0.0,1.0
15385,The Thaw,149857,0,149857,2011.csv,2011,0.0,1.0
15386,Florence Foster Jenkins 2018 Re-release,149834,0,149834,2018.csv,2018,0.0,1.0
15387,In Your Hands,149814,0,149814,2011.csv,2011,0.0,1.0
15388,Legends of the Three Kingdoms,149755,0,149755,2018.csv,2018,0.0,1.0
15389,The Regulars,149725,0,149725,2017.csv,2017,0.0,1.0
15390,The Microchip,149409,0,149409,2011.csv,2011,0.0,1.0
15391,"Relaks, It's Just Pag-ibig",149331,0,149331,2014.csv,2014,0.0,1.0
15392,The Snow Queen 2 2018 Re-release,149310,0,149310,2018.csv,2018,0.0,1.0
15393,"Zaytsev, zhgi! Istoriya shoumena",149255,0,149255,2010.csv,2010,0.0,1.0
15394,The Confidant,149239,0,149239,2012.csv,2012,0.0,1.0
15395,Ninnu Kori,149229,0,149229,2017.csv,2017,0.0,1.0
15396,The Fifth Commandment 2012 Re-release,149220,0,149220,2012.csv,2012,0.0,1.0
15397,Piercing,149211,15856,133355,2019.csv,2019,0.10626562384810771,0.8937343761518923
15398,Fox Hunting,149173,0,149173,2020.csv,2020,0.0,1.0
15399,Tygyn Darkhan,149151,0,149151,2020.csv,2020,0.0,1.0
15400,On Wings of Eagles,149136,0,149136,2016.csv,2016,0.0,1.0
15401,Hong Kong Confidential,149118,0,149118,2010.csv,2010,0.0,1.0
15402,Michael Moore in TrumpLand,149090,149090,0,2016.csv,2016,1.0,0.0
15403,Astragal,149076,0,149076,2015.csv,2015,0.0,1.0
15404,H is for Happiness,149031,0,149031,2020.csv,2020,0.0,1.0
15405,Tutta colpa della musica,148994,0,148994,2011.csv,2011,0.0,1.0
15406,Gun Hill Road,148994,148994,0,2011.csv,2011,1.0,0.0
15407,Love Godfathers: Three Bad Guys,148986,0,148986,2016.csv,2016,0.0,1.0
15408,Consequences,148960,0,148960,2014.csv,2014,0.0,1.0
15409,Heritages,148880,0,148880,2014.csv,2014,0.0,1.0
15410,Tactical Force,148850,0,148850,2012.csv,2012,0.0,1.0
15411,Quizás Mañana,148840,0,148840,2013.csv,2013,0.0,1.0
15412,The King of Havana,148797,0,148797,2015.csv,2015,0.0,1.0
15413,Hitting the Apex,148792,0,148792,2015.csv,2015,0.0,1.0
15414,Wonrayipeu,148783,0,148783,2011.csv,2011,0.0,1.0
15415,Hiya,148681,0,148681,2016.csv,2016,0.0,1.0
15416,Deepsea Rangers: Super Crystals,148667,0,148667,2019.csv,2019,0.0,1.0
15417,From Afar,148630,30169,118461,2016.csv,2016,0.2029805557424477,0.7970194442575523
15418,"Guns, Girls and Gambling",148570,0,148570,2013.csv,2013,0.0,1.0
15419,Future Lasts Forever,148545,0,148545,2011.csv,2011,0.0,1.0
15420,Trial by Fire,148504,148504,0,2019.csv,2019,1.0,0.0
15421,War and Peace,148503,148503,0,2019.csv,2019,1.0,0.0
15422,Hard Times,148498,0,148498,2011.csv,2011,0.0,1.0
15423,Ma-li-an-neu-wa Ma-ga-let,148466,0,148466,2017.csv,2017,0.0,1.0
15424,Love Cuts,148428,0,148428,2010.csv,2010,0.0,1.0
15425,Hard to Get,148383,0,148383,2014.csv,2014,0.0,1.0
15426,Big Fish & Begonia 2018 Re-release,148348,0,148348,2018.csv,2018,0.0,1.0
15427,Pet Pals in Windland 2015 Re-release,148342,0,148342,2015.csv,2015,0.0,1.0
15428,The Bystander,148272,0,148272,2018.csv,2018,0.0,1.0
15429,Harry Potter and the Deathly Hallows: Part 1 2018 Re-release,148263,148263,0,2010.csv,2010,1.0,0.0
15430,La Espara,148214,0,148214,2015.csv,2015,0.0,1.0
15431,Absolution,148205,0,148205,2015.csv,2015,0.0,1.0
15432,The Needle Remix,148190,0,148190,2010.csv,2010,0.0,1.0
15433,Love for Life,148174,0,148174,2011.csv,2011,0.0,1.0
15434,Super Singh,148071,0,148071,2017.csv,2017,0.0,1.0
15435,The Rocky Horror Picture Show 2015 Re-release,148061,0,148061,2015.csv,2015,0.0,1.0
15436,Go Grandriders,147979,0,147979,2013.csv,2013,0.0,1.0
15437,Saving Flora,147941,0,147941,2019.csv,2019,0.0,1.0
15438,You Will Meet a Tall Dark Stranger 2013 Re-release,147938,0,147938,2013.csv,2013,0.0,1.0
15439,Poker Face,147927,0,147927,2012.csv,2012,0.0,1.0
15440,Nasa,147834,0,147834,2011.csv,2011,0.0,1.0
15441,Griff the Invisible,147831,0,147831,2011.csv,2011,0.0,1.0
15442,Ideal Home,147784,0,147784,2018.csv,2018,0.0,1.0
15443,Restless Creature: Wendy Whelan,147780,147780,0,2017.csv,2017,1.0,0.0
15444,The Lord of the Rings: The Two Towers 2020 Re-release,147768,0,147768,2020.csv,2020,0.0,1.0
15445,Conducta,147731,0,147731,2015.csv,2015,0.0,1.0
15446,The Gateless Gate,147650,0,147650,2018.csv,2018,0.0,1.0
15447,Ierey-san. Ispoved samuraya,147631,0,147631,2015.csv,2015,0.0,1.0
15448,Azhar,147521,0,147521,2016.csv,2016,0.0,1.0
15449,I Miss You Mom,147448,0,147448,2019.csv,2019,0.0,1.0
15450,Night of the Living Dead 2018 Re-release,147423,147423,0,2018.csv,2018,1.0,0.0
15451,Watchers,147308,0,147308,2020.csv,2020,0.0,1.0
15452,The Stopover,147307,0,147307,2016.csv,2016,0.0,1.0
15453,Masha and the Bear,147174,0,147174,2019.csv,2019,0.0,1.0
15454,The Strange Case of Angelica,147173,50135,97038,2010.csv,2010,0.3406535166097042,0.6593464833902958
15455,Driven,147172,0,147172,2019.csv,2019,0.0,1.0
15456,Looking for Grace,147164,0,147164,2016.csv,2016,0.0,1.0
15457,Burning Man,147153,0,147153,2011.csv,2011,0.0,1.0
15458,Blind,147131,0,147131,2021.csv,2021,0.0,1.0
15459,Songs My Brothers Taught Me,146937,34793,112144,2015.csv,2015,0.23678855563949175,0.7632114443605083
15460,American Promise,146702,146702,0,2013.csv,2013,1.0,0.0
15461,Wedding in New York,146620,0,146620,2015.csv,2015,0.0,1.0
15462,Watermark,146572,84464,62108,2014.csv,2014,0.576262860573643,0.423737139426357
15463,Touched with Fire,146487,146487,0,2016.csv,2016,1.0,0.0
15464,5 Broken Cameras,146475,109983,36492,2012.csv,2012,0.7508653353814644,0.2491346646185356
15465,Between Worlds,146339,0,146339,2018.csv,2018,0.0,1.0
15466,Hannah,146325,11700,134625,2018.csv,2018,0.07995899538698104,0.920041004613019
15467,Macbeth,146259,0,146259,2013.csv,2013,0.0,1.0
15468,3 Millones,146248,0,146248,2011.csv,2011,0.0,1.0
15469,Starlet,146222,88212,58010,2012.csv,2012,0.6032744730615092,0.3967255269384908
15470,Fifty Years on Stage,146202,0,146202,2013.csv,2013,0.0,1.0
15471,Aisha,146161,0,146161,2010.csv,2010,0.0,1.0
15472,Deadly Renovations,146146,146146,0,2012.csv,2012,1.0,0.0
15473,Dumapárbaj,146137,0,146137,2015.csv,2015,0.0,1.0
15474,El cantante 2011 Re-release,146104,0,146104,2011.csv,2011,0.0,1.0
15475,Confession of a Child of the Century,146081,0,146081,2012.csv,2012,0.0,1.0
15476,The Last Stickman of Chongqing,146050,0,146050,2018.csv,2018,0.0,1.0
15477,The Punk Singer,146000,122742,23258,2013.csv,2013,0.8406986301369863,0.1593013698630137
15478,While We're Young 2015 Re-release,145942,0,145942,2015.csv,2015,0.0,1.0
15479,Citizen K,145941,120411,25530,2019.csv,2019,0.8250662939132938,0.17493370608670628
15480,Our Love Story,145907,0,145907,2016.csv,2016,0.0,1.0
15481,Pretham 2,145897,0,145897,2018.csv,2018,0.0,1.0
15482,Girl on the Third Floor,145856,0,145856,2020.csv,2020,0.0,1.0
15483,Born to Race: Fast Track,145828,0,145828,2014.csv,2014,0.0,1.0
15484,Yamla Pagla Deewana Phir Se,145756,0,145756,2018.csv,2018,0.0,1.0
15485,Once Upon a Time in America 2012 Re-release,145755,0,145755,2012.csv,2012,0.0,1.0
15486,"Footprints, the Path of Your Life",145730,0,145730,2016.csv,2016,0.0,1.0
15487,Miss Violence,145665,0,145665,2013.csv,2013,0.0,1.0
15488,The Woman Who Ran,145650,0,145650,2020.csv,2020,0.0,1.0
15489,Framing John DeLorean,145625,145625,0,2019.csv,2019,1.0,0.0
15490,Rio 2096: A Story of Love and Fury,145613,0,145613,2013.csv,2013,0.0,1.0
15491,Father,145540,0,145540,2020.csv,2020,0.0,1.0
15492,The Last Dalai Lama?,145524,145524,0,2017.csv,2017,1.0,0.0
15493,Arjun Reddy,145522,0,145522,2017.csv,2017,0.0,1.0
15494,Uda Aida,145514,0,145514,2019.csv,2019,0.0,1.0
15495,Efsunlu - Kabirden Gelen,145500,0,145500,2019.csv,2019,0.0,1.0
15496,Westwind,145470,0,145470,2011.csv,2011,0.0,1.0
15497,Red Sky 2014 Re-release,145346,0,145346,2014.csv,2014,0.0,1.0
15498,Decide 2,145337,0,145337,2015.csv,2015,0.0,1.0
15499,Talihina Sky: The Story of Kings of Leon,145319,0,145319,2011.csv,2011,0.0,1.0
15500,Puzzle,145279,0,145279,2010.csv,2010,0.0,1.0
15501,Tai Xian,145250,0,145250,2018.csv,2018,0.0,1.0
15502,Three Days until Spring,145214,0,145214,2017.csv,2017,0.0,1.0
15503,Just One Summer,145115,0,145115,2012.csv,2012,0.0,1.0
15504,The Last Serb in Croatia,145071,0,145071,2019.csv,2019,0.0,1.0
15505,Krisha,144822,144822,0,2016.csv,2016,1.0,0.0
15506,Am Hang,144815,0,144815,2013.csv,2013,0.0,1.0
15507,I'll Wait for You,144796,0,144796,2019.csv,2019,0.0,1.0
15508,All You Need Is Love,144774,0,144774,2015.csv,2015,0.0,1.0
15509,Mr. Smith Goes to Washington 2018 Re-release,144738,144738,0,2018.csv,2018,1.0,0.0
15510,Unleashed,144718,0,144718,2018.csv,2018,0.0,1.0
15511,Nahid,144703,0,144703,2016.csv,2016,0.0,1.0
15512,Majority,144698,0,144698,2010.csv,2010,0.0,1.0
15513,A Choo,144669,0,144669,2020.csv,2020,0.0,1.0
15514,I Spit on Your Grave: Vengeance is Mine,144661,0,144661,2015.csv,2015,0.0,1.0
15515,Actor in Law,144654,0,144654,2016.csv,2016,0.0,1.0
15516,The Prodigy,144652,0,144652,2011.csv,2011,0.0,1.0
15517,Nazaryyet Ammity,144602,0,144602,2013.csv,2013,0.0,1.0
15518,Wendy,144564,143518,1046,2020.csv,2020,0.992764450347251,0.0072355496527489556
15519,Irving Berlin's Holiday Inn The Broadway Musical,144550,144550,0,2017.csv,2017,1.0,0.0
15520,The Price of Everything,144446,87400,57046,2018.csv,2018,0.6050704069340792,0.39492959306592085
15521,L.O.L. Surprise! On the Big Screen,144400,0,144400,2019.csv,2019,0.0,1.0
15522,The Big Bang,144298,0,144298,2011.csv,2011,0.0,1.0
15523,Good Boy and Kung Fu,144214,0,144214,2019.csv,2019,0.0,1.0
15524,Yellow Day 2015 Re-release,144163,144163,0,2015.csv,2015,1.0,0.0
15525,Diving Into the Unknown,144130,0,144130,2016.csv,2016,0.0,1.0
15526,From Beneath,144123,144123,0,2012.csv,2012,1.0,0.0
15527,Cold Weather,144056,141358,2698,2011.csv,2011,0.9812711723218748,0.018728827678125174
15528,Thunder Soul,143986,143986,0,2011.csv,2011,1.0,0.0
15529,Thrissivaperoor Kliptham,143972,0,143972,2017.csv,2017,0.0,1.0
15530,The North of Peking,143865,0,143865,2017.csv,2017,0.0,1.0
15531,Norm of the North: Family Vacation,143858,0,143858,2020.csv,2020,0.0,1.0
15532,We Die Young,143837,0,143837,2019.csv,2019,0.0,1.0
15533,Til Death Do Us Part 2019 Re-release,143801,0,143801,2019.csv,2019,0.0,1.0
15534,"Kamen Rider OOO, Den-O, & All Riders: Let's Go Kamen Riders 2013 Re-release",143733,0,143733,2013.csv,2013,0.0,1.0
15535,Cop Car,143658,134552,9106,2015.csv,2015,0.9366133455846525,0.06338665441534756
15536,Ladrões de Tuta e Meia,143657,0,143657,2019.csv,2019,0.0,1.0
15537,June,143617,0,143617,2019.csv,2019,0.0,1.0
15538,Carmen,143543,0,143543,2010.csv,2010,0.0,1.0
15539,Kammara Sambhavam,143538,0,143538,2018.csv,2018,0.0,1.0
15540,Dirty Girl,143485,55125,88360,2011.csv,2011,0.38418650033104507,0.6158134996689549
15541,The Insatiable Moon,143475,0,143475,2010.csv,2010,0.0,1.0
15542,Deep Well,143451,0,143451,2017.csv,2017,0.0,1.0
15543,Bleak Night,143437,0,143437,2011.csv,2011,0.0,1.0
15544,Knerten 2010 Re-release,143432,0,143432,2010.csv,2010,0.0,1.0
15545,Que Pena Tu Boda,143365,0,143365,2012.csv,2012,0.0,1.0
15546,The Mission 2020 Re-release,143364,0,143364,2020.csv,2020,0.0,1.0
15547,Doctor Who: Logopolis,143248,143248,0,2019.csv,2019,1.0,0.0
15548,Alps,143234,16057,127177,2012.csv,2012,0.1121032715695994,0.8878967284304006
15549,Survival of the Dead,143191,101740,41451,2010.csv,2010,0.7105195158913619,0.28948048410863814
15550,Blitzpatrollie,143190,0,143190,2013.csv,2013,0.0,1.0
15551,Roh Moo-hyun and the Fools,143187,0,143187,2019.csv,2019,0.0,1.0
15552,Kids for Cash,143178,143178,0,2014.csv,2014,1.0,0.0
15553,Clash,143121,18215,124906,2016.csv,2016,0.12726993243479293,0.8727300675652071
15554,Aiyaary,143108,0,143108,2018.csv,2018,0.0,1.0
15555,Hunter's Bride,142936,0,142936,2010.csv,2010,0.0,1.0
15556,So Hard to Forget,142894,0,142894,2010.csv,2010,0.0,1.0
15557,Game of Werewolves,142864,0,142864,2012.csv,2012,0.0,1.0
15558,Kavan,142784,0,142784,2017.csv,2017,0.0,1.0
15559,Na Parizh!,142748,0,142748,2019.csv,2019,0.0,1.0
15560,Alì Blue Eyes,142747,0,142747,2012.csv,2012,0.0,1.0
15561,Midnight Oil: 1984,142727,0,142727,2018.csv,2018,0.0,1.0
15562,The Soul Collector,142725,0,142725,2020.csv,2020,0.0,1.0
15563,Sister Dulce: The Angel from Brazil,142713,0,142713,2014.csv,2014,0.0,1.0
15564,Gold Coast,142641,0,142641,2016.csv,2016,0.0,1.0
15565,Bad Seeds,142509,0,142509,2012.csv,2012,0.0,1.0
15566,Crimean,142344,0,142344,2014.csv,2014,0.0,1.0
15567,Brillebjørn feirer jul,142317,0,142317,2020.csv,2020,0.0,1.0
15568,Bilocation,142286,0,142286,2014.csv,2014,0.0,1.0
15569,Ranam,142281,0,142281,2018.csv,2018,0.0,1.0
15570,Sole cuore amore,142270,0,142270,2017.csv,2017,0.0,1.0
15571,Save My Dogs,142235,0,142235,2018.csv,2018,0.0,1.0
15572,Liao Junbo,142148,0,142148,2019.csv,2019,0.0,1.0
15573,Padayottam,142058,0,142058,2018.csv,2018,0.0,1.0
15574,Dragon 2012 Re-release,142029,11137,130892,2012.csv,2012,0.0784135634271874,0.9215864365728126
15575,John Dies at the End,141951,141951,0,2013.csv,2013,1.0,0.0
15576,Vloga za Emo,141950,0,141950,2014.csv,2014,0.0,1.0
15577,Love Aaj Kal 2,141918,0,141918,2020.csv,2020,0.0,1.0
15578,Swalef Tafash,141906,0,141906,2016.csv,2016,0.0,1.0
15579,Citadel,141886,13377,128509,2012.csv,2012,0.09427991486122662,0.9057200851387733
15580,Solitaire,141862,0,141862,2017.csv,2017,0.0,1.0
15581,The Chameleon,141816,0,141816,2010.csv,2010,0.0,1.0
15582,Lou Lap,141779,0,141779,2016.csv,2016,0.0,1.0
15583,One Hundred and One Dalmatians 2012 Re-release,141773,0,141773,2012.csv,2012,0.0,1.0
15584,Gallowwalkers,141696,0,141696,2013.csv,2013,0.0,1.0
15585,May in the Summer,141605,22004,119601,2014.csv,2014,0.15538999329119735,0.8446100067088027
15586,On the Pitch,141578,0,141578,2017.csv,2017,0.0,1.0
15587,Adventure Time with Finn & Jake: Islands Part 6: Min and Marty/Adventure Time with Finn & Jake: Islands Part 1: The Invitation/Adventure Time with Finn & Jake: Islands Part 7: Helpers/Adventure Time with Finn & Jake: Islands Part 4: Imaginary Resources/Adventure Time with Finn & Jake: Islands Part 5: Hide and Seek/Adventure Time with Finn & Jake: Islands Part 8: The Light Cloud/Adventure Time with Finn & Jake: Islands Part 3: Mysterious Island/Adventure Time with Finn & Jake: Islands Part 2: Whipple the Happy Dragon,141529,0,141529,2017.csv,2017,0.0,1.0
15588,Best F(r)iends Volume Two,141524,141524,0,2018.csv,2018,1.0,0.0
15589,Presentimientos,141516,0,141516,2014.csv,2014,0.0,1.0
15590,"Pura Vida, Bajo Los Cielos De Asia",141506,0,141506,2012.csv,2012,0.0,1.0
15591,Milion dolarów,141399,0,141399,2011.csv,2011,0.0,1.0
15592,Aka Like Love,141373,0,141373,2012.csv,2012,0.0,1.0
15593,Mid Mile Racing Love,141348,0,141348,2011.csv,2011,0.0,1.0
15594,The Call,141327,0,141327,2012.csv,2012,0.0,1.0
15595,School Tales,141271,0,141271,2016.csv,2016,0.0,1.0
15596,Hellaro,141243,0,141243,2019.csv,2019,0.0,1.0
15597,Branagh Theatre Live: The Winter's Tale,141143,141143,0,2019.csv,2019,1.0,0.0
15598,Golden Sting,141132,0,141132,2018.csv,2018,0.0,1.0
15599,s.CRY.ed,141055,0,141055,2011.csv,2011,0.0,1.0
15600,Good as New,140991,0,140991,2020.csv,2020,0.0,1.0
15601,The Brawler,140981,75929,65052,2018.csv,2018,0.5385761201864081,0.4614238798135919
15602,National Theatre Live: Hamlet 2016 Re-release,140951,0,140951,2016.csv,2016,0.0,1.0
15603,We Are Champions,140937,0,140937,2020.csv,2020,0.0,1.0
15604,My Kitchen Lover,140923,0,140923,2018.csv,2018,0.0,1.0
15605,Metropolis Giorgio Moroder Presents,140907,27362,113545,2011.csv,2011,0.19418481693599324,0.8058151830640068
15606,Harry Og Heimir,140883,0,140883,2014.csv,2014,0.0,1.0
15607,Not Guilty,140869,0,140869,2019.csv,2019,0.0,1.0
15608,Canelo vs. Kovalev,140820,140820,0,2019.csv,2019,1.0,0.0
15609,Afterimages,140730,0,140730,2014.csv,2014,0.0,1.0
15610,Blood and Glory,140722,0,140722,2016.csv,2016,0.0,1.0
15611,The Dawn,140710,0,140710,2020.csv,2020,0.0,1.0
15612,May We Chat,140676,0,140676,2014.csv,2014,0.0,1.0
15613,Nahas XLarge,140555,0,140555,2020.csv,2020,0.0,1.0
15614,Catacombe,140530,0,140530,2018.csv,2018,0.0,1.0
15615,Pa-wo-bae-teul Wa-chi-ka: Wa-chi-ga-myeon-ui Yeok-seup,140484,0,140484,2017.csv,2017,0.0,1.0
15616,The Cordillera of Dreams,140465,20943,119522,2019.csv,2019,0.14909763998149006,0.8509023600185099
15617,Son Istasyon,140404,0,140404,2010.csv,2010,0.0,1.0
15618,Quand on crie au loup,140369,0,140369,2019.csv,2019,0.0,1.0
15619,Things We Do for Love,140349,0,140349,2013.csv,2013,0.0,1.0
15620,The Disintegration,140330,0,140330,2012.csv,2012,0.0,1.0
15621,Incitement,140306,140306,0,2020.csv,2020,1.0,0.0
15622,Hutsulka Ksenya,140195,0,140195,2019.csv,2019,0.0,1.0
15623,Gore Vidal: The United States of Amnesia,140164,140164,0,2014.csv,2014,1.0,0.0
15624,Au revoir Taipei,140155,0,140155,2010.csv,2010,0.0,1.0
15625,Beautiful Boy,140123,77247,62876,2011.csv,2011,0.5512799469037917,0.4487200530962083
15626,Deo Te-neo Ri-ri-ko Seu-pin-to,140098,0,140098,2015.csv,2015,0.0,1.0
15627,The Weathered Underground,140091,140091,0,2010.csv,2010,1.0,0.0
15628,My Wife Is a Superstar,140088,0,140088,2016.csv,2016,0.0,1.0
15629,Liv & Ingmar,140041,10347,129694,2012.csv,2012,0.07388550495926192,0.9261144950407381
15630,Maacher Jhol,139961,0,139961,2017.csv,2017,0.0,1.0
15631,Blindly in Love,139924,0,139924,2013.csv,2013,0.0,1.0
15632,Love and Fury,139896,0,139896,2016.csv,2016,0.0,1.0
15633,Boo!,139875,0,139875,2019.csv,2019,0.0,1.0
15634,Coherence,139745,102617,37128,2014.csv,2014,0.7343160757093277,0.2656839242906723
15635,Children of Men 2016 Re-release,139694,0,139694,2016.csv,2016,0.0,1.0
15636,Hunky Dory,139653,20296,119357,2012.csv,2012,0.14533164343050275,0.8546683565694972
15637,De force,139650,0,139650,2011.csv,2011,0.0,1.0
15638,The Envelope,139595,0,139595,2017.csv,2017,0.0,1.0
15639,Loveling,139559,0,139559,2018.csv,2018,0.0,1.0
15640,Support the Girls,139550,129124,10426,2018.csv,2018,0.9252884270870656,0.07471157291293443
15641,Atashin'chi the Movie 2011 Re-release,139545,0,139545,2011.csv,2011,0.0,1.0
15642,My God! Father,139511,0,139511,2020.csv,2020,0.0,1.0
15643,Super Monkey Returns,139500,0,139500,2011.csv,2011,0.0,1.0
15644,Final Report,139456,0,139456,2020.csv,2020,0.0,1.0
15645,Flowers,139421,61568,77853,2014.csv,2014,0.44159775069752766,0.5584022493024724
15646,Dansen op de vulkaan,139410,0,139410,2014.csv,2014,0.0,1.0
15647,Freej Al Taibeen,139391,0,139391,2018.csv,2018,0.0,1.0
15648,Hero on the Front,139271,0,139271,2018.csv,2018,0.0,1.0
15649,No Man's Land,139221,139221,0,2021.csv,2021,1.0,0.0
15650,Wilder vs. Ortiz,139207,139207,0,2019.csv,2019,1.0,0.0
15651,Rosie,139192,6839,132353,2019.csv,2019,0.04913357089487901,0.950866429105121
15652,Xenia,139186,3181,136005,2014.csv,2014,0.02285431005991982,0.9771456899400802
15653,A Grande Vitória,139124,0,139124,2014.csv,2014,0.0,1.0
15654,The Polar Express 2014 IMAX Release,139055,139055,0,2014.csv,2014,1.0,0.0
15655,Missing,138983,0,138983,2018.csv,2018,0.0,1.0
15656,The Washing Machine,138968,0,138968,2020.csv,2020,0.0,1.0
15657,Who Will Write Our History,138868,138039,829,2019.csv,2019,0.9940303021574445,0.0059696978425555205
15658,Head Full of Honey,138844,12350,126494,2018.csv,2018,0.0889487482354297,0.9110512517645704
15659,Good Ol' Freda,138811,138811,0,2013.csv,2013,1.0,0.0
15660,"Iron Gate, the Exile of Peron",138794,0,138794,2013.csv,2013,0.0,1.0
15661,Unbreakable,138777,0,138777,2019.csv,2019,0.0,1.0
15662,Umrika,138706,0,138706,2015.csv,2015,0.0,1.0
15663,Zero Motivation,138609,116044,22565,2014.csv,2014,0.8372039333665202,0.16279606663347979
15664,Boys Cry,138535,0,138535,2018.csv,2018,0.0,1.0
15665,Intruders 2017 Re-release,138510,0,138510,2017.csv,2017,0.0,1.0
15666,Doctor Zhivago 2013 Re-release,138448,0,138448,2013.csv,2013,0.0,1.0
15667,Nikita Kozhemyaka,138441,0,138441,2017.csv,2017,0.0,1.0
15668,Faust,138405,0,138405,2012.csv,2012,0.0,1.0
15669,Two Eyes Staring,138381,0,138381,2010.csv,2010,0.0,1.0
15670,Psycho-Pass: The Movie,138366,138366,0,2016.csv,2016,1.0,0.0
15671,Cinema Paradiso 2014 Re-release,138355,0,138355,2014.csv,2014,0.0,1.0
15672,Until Now,138208,0,138208,2014.csv,2014,0.0,1.0
15673,Bruno Aleixo's Film,138200,0,138200,2020.csv,2020,0.0,1.0
15674,Ana e Vitória,138171,0,138171,2018.csv,2018,0.0,1.0
15675,Sinyalciler: Son Aksam Yemegi,138147,0,138147,2017.csv,2017,0.0,1.0
15676,Antoine and Sebastian 2018 Re-release,138129,0,138129,2018.csv,2018,0.0,1.0
15677,Dream Driven,138086,0,138086,2014.csv,2014,0.0,1.0
15678,Innocent Saturday,138043,0,138043,2011.csv,2011,0.0,1.0
15679,The Heart of Man,138028,0,138028,2018.csv,2018,0.0,1.0
15680,The Puppet,138023,0,138023,2013.csv,2013,0.0,1.0
15681,Lynryd Skynyrd: Last of the Street Survivors Farewell Tour,137888,137888,0,2019.csv,2019,1.0,0.0
15682,Love Ranch,137885,137885,0,2010.csv,2010,1.0,0.0
15683,Floating Skyscrapers,137832,0,137832,2013.csv,2013,0.0,1.0
15684,Schemers,137800,0,137800,2020.csv,2020,0.0,1.0
15685,Rettet Raffi!,137775,0,137775,2015.csv,2015,0.0,1.0
15686,Nise: The Heart of Madness 2018 Re-release,137765,0,137765,2018.csv,2018,0.0,1.0
15687,Trippel Trappel Dierensinterklaas 2015 Re-release,137762,0,137762,2015.csv,2015,0.0,1.0
15688,Thomas & Friends: Hero of the Rails,137630,0,137630,2010.csv,2010,0.0,1.0
15689,Leonardo: The Works,137520,0,137520,2019.csv,2019,0.0,1.0
15690,Celebrity Ltd.,137463,0,137463,2015.csv,2015,0.0,1.0
15691,Thomas & Friends: Sodor's Legend of the Lost Treasure 2017 Re-release,137455,0,137455,2017.csv,2017,0.0,1.0
15692,Simon's Got a Gift,137358,0,137358,2020.csv,2020,0.0,1.0
15693,Beneath Us,137260,137260,0,2020.csv,2020,1.0,0.0
15694,The Metropolitan Opera HD Live: Offenbach: Les contes d'Hoffmann,137213,0,137213,2010.csv,2010,0.0,1.0
15695,A Fishboy's Story: Tortoise From the Sea,137155,0,137155,2019.csv,2019,0.0,1.0
15696,Heat 2013 Re-release,137155,0,137155,2013.csv,2013,0.0,1.0
15697,Ajvar,137139,0,137139,2019.csv,2019,0.0,1.0
15698,Electrick Children,137126,0,137126,2012.csv,2012,0.0,1.0
15699,El mural,137066,0,137066,2010.csv,2010,0.0,1.0
15700,Is the Man Who Is Tall Happy?,137042,137042,0,2013.csv,2013,1.0,0.0
15701,It's Not the Time of My Life,137035,0,137035,2016.csv,2016,0.0,1.0
15702,Nae Pasaran,136918,0,136918,2018.csv,2018,0.0,1.0
15703,Bang Gang (A Modern Love Story),136891,0,136891,2016.csv,2016,0.0,1.0
15704,Slaughter Creek,136815,136815,0,2012.csv,2012,1.0,0.0
15705,The Lord's Ride,136786,0,136786,2010.csv,2010,0.0,1.0
15706,Harry Potter and the Chamber of Secrets 2020 Re-release,136772,0,136772,2020.csv,2020,0.0,1.0
15707,The Trial,136695,0,136695,2018.csv,2018,0.0,1.0
15708,The Market,136675,0,136675,2014.csv,2014,0.0,1.0
15709,Iru Mugan,136623,0,136623,2016.csv,2016,0.0,1.0
15710,The Metropolitan Opera HD Live: Bizet: Carmen,136620,0,136620,2014.csv,2014,0.0,1.0
15711,High Strung Free Dance,136585,0,136585,2018.csv,2018,0.0,1.0
15712,Redemption Street,136541,0,136541,2012.csv,2012,0.0,1.0
15713,The First,136515,0,136515,2018.csv,2018,0.0,1.0
15714,Selfie from Hell,136452,0,136452,2018.csv,2018,0.0,1.0
15715,Cold Prey 2 2012 Re-release,136451,0,136451,2012.csv,2012,0.0,1.0
15716,Legenda ostrova Dvid,136405,0,136405,2010.csv,2010,0.0,1.0
15717,Five Fingers for Marseilles,136374,0,136374,2018.csv,2018,0.0,1.0
15718,The Dead Room,136319,0,136319,2015.csv,2015,0.0,1.0
15719,Hassa Wa Baqloz,136307,0,136307,2016.csv,2016,0.0,1.0
15720,The Cursed Lesson,136302,0,136302,2020.csv,2020,0.0,1.0
15721,Archenemy,136240,121642,14598,2020.csv,2020,0.8928508514386377,0.1071491485613623
15722,The Benefit of the Doubt,136070,0,136070,2019.csv,2019,0.0,1.0
15723,Morgana 2013 Re-release,136053,0,136053,2013.csv,2013,0.0,1.0
15724,Pulimurugan,136052,0,136052,2016.csv,2016,0.0,1.0
15725,Kasal,136012,0,136012,2018.csv,2018,0.0,1.0
15726,Mothers' Instinct,135950,0,135950,2019.csv,2019,0.0,1.0
15727,Welcome to Acapulco,135908,0,135908,2019.csv,2019,0.0,1.0
15728,Die Spook van Uniondale,135889,0,135889,2014.csv,2014,0.0,1.0
15729,Made in Abyss: Journey's Dawn,135821,134047,1774,2019.csv,2019,0.9869386913658418,0.013061308634158194
15730,I Will Follow,135809,135809,0,2011.csv,2011,1.0,0.0
15731,Food Club,135750,0,135750,2021.csv,2021,0.0,1.0
15732,Mantra: Sounds Into Silence,135684,115013,20671,2018.csv,2018,0.8476533710680699,0.15234662893193007
15733,"River, El Más Grande Siempre",135655,0,135655,2019.csv,2019,0.0,1.0
15734,Hitman,135636,0,135636,2012.csv,2012,0.0,1.0
15735,Revenir,135628,0,135628,2020.csv,2020,0.0,1.0
15736,The Third Half,135571,0,135571,2013.csv,2013,0.0,1.0
15737,Tady hlídám já,135569,0,135569,2012.csv,2012,0.0,1.0
15738,Skin,135562,0,135562,2019.csv,2019,0.0,1.0
15739,The Osiris Child,135532,0,135532,2017.csv,2017,0.0,1.0
15740,Pixies,135437,0,135437,2015.csv,2015,0.0,1.0
15741,Sonchiriya,135413,86765,48648,2019.csv,2019,0.6407435032087022,0.35925649679129773
15742,Tortoise in Love,135406,0,135406,2012.csv,2012,0.0,1.0
15743,Satan Said Dance,135405,0,135405,2017.csv,2017,0.0,1.0
15744,La Sapienza,135392,135392,0,2015.csv,2015,1.0,0.0
15745,The Kind Words,135382,135382,0,2016.csv,2016,1.0,0.0
15746,Hunting Emma,135328,0,135328,2017.csv,2017,0.0,1.0
15747,Mujer alabastrina,135251,0,135251,2010.csv,2010,0.0,1.0
15748,The Other Dream Team,135228,135228,0,2012.csv,2012,1.0,0.0
15749,The Interval,135219,0,135219,2012.csv,2012,0.0,1.0
15750,The Other Story,135191,135191,0,2019.csv,2019,1.0,0.0
15751,The Bolshoi Ballet: Live From Moscow - A Hero of Our Time,135168,104837,30331,2017.csv,2017,0.7756051728219697,0.2243948271780303
15752,Vellaikaara Durai,135155,0,135155,2014.csv,2014,0.0,1.0
15753,Manyas La Pelicula,134960,0,134960,2011.csv,2011,0.0,1.0
15754,Distant Sky: Nick Cave & The Bad Seeds Live in Copenhagen,134912,0,134912,2018.csv,2018,0.0,1.0
15755,My Neighbor Totoro 2015 Re-release,134877,0,134877,2015.csv,2015,0.0,1.0
15756,Tilva Rosh,134808,0,134808,2011.csv,2011,0.0,1.0
15757,Stars to Wish Upon,134802,0,134802,2010.csv,2010,0.0,1.0
15758,Another Day of Life,134801,3190,131611,2018.csv,2018,0.023664512874533573,0.9763354871254665
15759,Die Laaste Tango,134786,0,134786,2013.csv,2013,0.0,1.0
15760,The Clairvoyant's Prayer,134781,0,134781,2012.csv,2012,0.0,1.0
15761,Warren Miller: Ticket to Ride,134754,0,134754,2014.csv,2014,0.0,1.0
15762,Led Zeppelin: Celebration Day,134753,0,134753,2012.csv,2012,0.0,1.0
15763,Isabelle,134730,0,134730,2011.csv,2011,0.0,1.0
15764,Kamen Rider Ex-Aid: True Ending 2018 Re-release,134725,0,134725,2018.csv,2018,0.0,1.0
15765,Pilgrimage,134686,0,134686,2017.csv,2017,0.0,1.0
15766,Igelak,134672,0,134672,2016.csv,2016,0.0,1.0
15767,Warren Miller's Line of Descent,134661,0,134661,2018.csv,2018,0.0,1.0
15768,Shelter,134632,0,134632,2018.csv,2018,0.0,1.0
15769,Memorias de un Soldado,134611,0,134611,2012.csv,2012,0.0,1.0
15770,Dragon Blade,134540,0,134540,2018.csv,2018,0.0,1.0
15771,Attenberg,134503,24036,110467,2010.csv,2010,0.17870233377694178,0.8212976662230582
15772,Those Who Kill - Shadow of the Past,134502,0,134502,2012.csv,2012,0.0,1.0
15773,Feride,134497,0,134497,2020.csv,2020,0.0,1.0
15774,Battle of the Damned,134452,0,134452,2014.csv,2014,0.0,1.0
15775,Tristesse Club,134440,0,134440,2014.csv,2014,0.0,1.0
15776,Hawaii,134438,0,134438,2017.csv,2017,0.0,1.0
15777,Myeoneuri: My Son's Crazy Wife,134424,0,134424,2018.csv,2018,0.0,1.0
15778,La hermandad,134364,0,134364,2014.csv,2014,0.0,1.0
15779,Painless,134299,0,134299,2013.csv,2013,0.0,1.0
15780,The Times of Bill Cunningham,134288,134288,0,2020.csv,2020,1.0,0.0
15781,Nguoi La Oi,134222,0,134222,2019.csv,2019,0.0,1.0
15782,"Winds of Sand, Women of Rock",134186,0,134186,2010.csv,2010,0.0,1.0
15783,Ism,134165,134165,0,2016.csv,2016,1.0,0.0
15784,Love or Death,134162,0,134162,2014.csv,2014,0.0,1.0
15785,Stop! Thieves,134144,0,134144,2020.csv,2020,0.0,1.0
15786,El ángel en el reloj,134126,0,134126,2018.csv,2018,0.0,1.0
15787,Hoggeren,134067,0,134067,2017.csv,2017,0.0,1.0
15788,Redwood Highway,134049,134049,0,2014.csv,2014,1.0,0.0
15789,Man Up!,133983,0,133983,2020.csv,2020,0.0,1.0
15790,La suerte en tus manos 2013 Re-release,133959,0,133959,2013.csv,2013,0.0,1.0
15791,Without Men,133933,0,133933,2011.csv,2011,0.0,1.0
15792,La passion d'Augustine,133929,0,133929,2016.csv,2016,0.0,1.0
15793,Miss Stevens 2019 Re-release,133924,0,133924,2019.csv,2019,0.0,1.0
15794,The Great Museum,133905,18020,115885,2014.csv,2014,0.13457301818453382,0.8654269818154662
15795,Kangar Hoppiena,133836,0,133836,2016.csv,2016,0.0,1.0
15796,Pure Country 2: The Gift,133771,133771,0,2010.csv,2010,1.0,0.0
15797,One Thousand Ropes,133761,0,133761,2017.csv,2017,0.0,1.0
15798,The Days of Noah 2: Apocalypse,133758,0,133758,2011.csv,2011,0.0,1.0
15799,Ezan,133752,0,133752,2015.csv,2015,0.0,1.0
15800,Paris Follies 2016 Re-release,133694,0,133694,2016.csv,2016,0.0,1.0
15801,One Night in Istanbul,133588,0,133588,2014.csv,2014,0.0,1.0
15802,27: The Cursed Club,133546,0,133546,2018.csv,2018,0.0,1.0
15803,Plans for Tomorrow,133543,0,133543,2010.csv,2010,0.0,1.0
15804,Don't Think I've Forgotten: Cambodia's Lost Rock and Roll,133443,133443,0,2015.csv,2015,1.0,0.0
15805,Under the Shadow,133324,31900,101424,2016.csv,2016,0.23926674867240708,0.760733251327593
15806,Kukuriku Kadin Kralligi,133315,0,133315,2010.csv,2010,0.0,1.0
15807,The Jewish Cardinal,133232,133232,0,2014.csv,2014,1.0,0.0
15808,Sus scrofa,133094,0,133094,2020.csv,2020,0.0,1.0
15809,Antep Fistigi,133093,0,133093,2018.csv,2018,0.0,1.0
15810,Les enfants de la chance,133083,0,133083,2016.csv,2016,0.0,1.0
15811,"Hare Krishna! The Mantra, the Movement and the Swami Who Started It",133006,133006,0,2017.csv,2017,1.0,0.0
15812,Young Bao the Movie,132935,0,132935,2013.csv,2013,0.0,1.0
15813,Tonight You're Mine,132787,6255,126532,2011.csv,2011,0.04710551484708594,0.9528944851529141
15814,Lost in the Cave Dwelling,132584,0,132584,2019.csv,2019,0.0,1.0
15815,Bye Bye Blondie,132506,0,132506,2012.csv,2012,0.0,1.0
15816,Private Peaceful,132505,0,132505,2012.csv,2012,0.0,1.0
15817,Kagit,132461,0,132461,2011.csv,2011,0.0,1.0
15818,Candelaria,132427,0,132427,2018.csv,2018,0.0,1.0
15819,Hey Duggee at the Cinema,132420,0,132420,2019.csv,2019,0.0,1.0
15820,The Weather Station,132405,0,132405,2010.csv,2010,0.0,1.0
15821,Dawson City: Frozen Time,132369,132369,0,2016.csv,2016,1.0,0.0
15822,33 Days,132277,0,132277,2012.csv,2012,0.0,1.0
15823,The Silence,132204,0,132204,2010.csv,2010,0.0,1.0
15824,Kumaré,132160,132160,0,2012.csv,2012,1.0,0.0
15825,Saa'a wi Nos,132159,0,132159,2012.csv,2012,0.0,1.0
15826,The First People's City Fond by the Chinese Communist Party,132118,0,132118,2019.csv,2019,0.0,1.0
15827,The Plagues of Breslau,132114,0,132114,2018.csv,2018,0.0,1.0
15828,My Brother the Devil,132056,44906,87150,2012.csv,2012,0.34005270491306716,0.6599472950869328
15829,How to Survive a Plague,132055,132055,0,2012.csv,2012,1.0,0.0
15830,The Image Book,132015,94153,37862,2018.csv,2018,0.7131992576601144,0.2868007423398856
15831,A Ballerina's Tale,131995,131995,0,2015.csv,2015,1.0,0.0
15832,Piata pora roku,131982,0,131982,2012.csv,2012,0.0,1.0
15833,Ada: Zombilerin Dügünü,131966,0,131966,2010.csv,2010,0.0,1.0
15834,Mugamoodi,131965,101000,30965,2012.csv,2012,0.7653544500435722,0.23464554995642783
15835,The Girl by the Lake 2011 Re-release,131962,0,131962,2011.csv,2011,0.0,1.0
15836,The Metropolitan Opera Presents: Così fan tutte,131920,0,131920,2014.csv,2014,0.0,1.0
15837,Oi chum mai,131835,0,131835,2014.csv,2014,0.0,1.0
15838,Bolshoi Babylon,131832,0,131832,2016.csv,2016,0.0,1.0
15839,Moon Man,131705,0,131705,2013.csv,2013,0.0,1.0
15840,Women He's Undressed,131701,0,131701,2015.csv,2015,0.0,1.0
15841,Miss Conception 2010 Re-release,131666,0,131666,2010.csv,2010,0.0,1.0
15842,De l'huile sur le feu,131577,0,131577,2011.csv,2011,0.0,1.0
15843,The Banishing,131564,0,131564,2020.csv,2020,0.0,1.0
15844,Sasha Was Here,131500,0,131500,2019.csv,2019,0.0,1.0
15845,Predator 2017 Re-release,131498,0,131498,2017.csv,2017,0.0,1.0
15846,Creators: The Past,131473,0,131473,2020.csv,2020,0.0,1.0
15847,Vanamagan,131461,0,131461,2017.csv,2017,0.0,1.0
15848,Trigun: Badlands Rumble,131431,0,131431,2010.csv,2010,0.0,1.0
15849,Summers Downstairs,131397,0,131397,2015.csv,2015,0.0,1.0
15850,The Elfkins 2021 Re-release,131371,0,131371,2020.csv,2020,0.0,1.0
15851,Segurança Nacional,131300,0,131300,2010.csv,2010,0.0,1.0
15852,The Tie,131242,0,131242,2020.csv,2020,0.0,1.0
15853,28 Hotel Rooms,131208,18869,112339,2012.csv,2012,0.1438098286689836,0.8561901713310164
15854,Rudy 2018 Re-release,131200,131200,0,2018.csv,2018,1.0,0.0
15855,L'Elisir D'Amore,131193,0,131193,2012.csv,2012,0.0,1.0
15856,Above Us Only Sky,131189,0,131189,2011.csv,2011,0.0,1.0
15857,L'insoumis,131175,0,131175,2018.csv,2018,0.0,1.0
15858,Anatomia zla,131081,0,131081,2015.csv,2015,0.0,1.0
15859,The Wind,130974,28252,102722,2019.csv,2019,0.21570693420068104,0.7842930657993189
15860,My Love,130959,0,130959,2016.csv,2016,0.0,1.0
15861,Paranoia,130915,0,130915,2016.csv,2016,0.0,1.0
15862,Une vie ailleurs,130910,0,130910,2017.csv,2017,0.0,1.0
15863,Mister America,130897,130897,0,2019.csv,2019,1.0,0.0
15864,Maborosi,130864,0,130864,2016.csv,2016,0.0,1.0
15865,Lola auf der Erbse,130843,0,130843,2014.csv,2014,0.0,1.0
15866,The Divide,130839,0,130839,2012.csv,2012,0.0,1.0
15867,The Interpreter,130817,0,130817,2018.csv,2018,0.0,1.0
15868,Maya,130765,0,130765,2019.csv,2019,0.0,1.0
15869,Alone for Christmas,130743,0,130743,2014.csv,2014,0.0,1.0
15870,Zappa,130731,15502,115229,2020.csv,2020,0.11857937291078627,0.8814206270892138
15871,In Hiding,130680,0,130680,2013.csv,2013,0.0,1.0
15872,Like Life,130554,0,130554,2016.csv,2016,0.0,1.0
15873,Double Trouble,130520,0,130520,2016.csv,2016,0.0,1.0
15874,Territory of Love,130446,0,130446,2019.csv,2019,0.0,1.0
15875,Panika,130391,0,130391,2014.csv,2014,0.0,1.0
15876,October,130335,32127,98208,2010.csv,2010,0.24649556911036943,0.7535044308896306
15877,Five Seasons: The Gardens of Piet Oudolf,130319,119223,11096,2018.csv,2018,0.9148550863649967,0.08514491363500334
15878,Saab Bahadar,130265,0,130265,2017.csv,2017,0.0,1.0
15879,Requiem for the American Dream,130152,130152,0,2016.csv,2016,1.0,0.0
15880,Harry Potter and the Half-Blood Prince 2018 Re-release,130081,130081,0,2018.csv,2018,1.0,0.0
15881,Carmen,130073,0,130073,2013.csv,2013,0.0,1.0
15882,Al Ragol Al Ghamed,130062,0,130062,2011.csv,2011,0.0,1.0
15883,Late Autumn 2012 Re-release,130053,0,130053,2012.csv,2012,0.0,1.0
15884,My Love Story!! 2018 Re-release,130031,0,130031,2018.csv,2018,0.0,1.0
15885,Love Them All,130027,0,130027,2019.csv,2019,0.0,1.0
15886,Bal Kaymak,130004,0,130004,2018.csv,2018,0.0,1.0
15887,PM Narendra Modi,129955,0,129955,2019.csv,2019,0.0,1.0
15888,Section 375,129916,0,129916,2019.csv,2019,0.0,1.0
15889,Nothingwood,129888,0,129888,2017.csv,2017,0.0,1.0
15890,Let It Snow,129887,0,129887,2020.csv,2020,0.0,1.0
15891,Reclaim,129822,0,129822,2014.csv,2014,0.0,1.0
15892,The Fairy,129818,38399,91419,2011.csv,2011,0.2957910305196506,0.7042089694803494
15893,Halloween 2020 Re-release,129763,0,129763,2020.csv,2020,0.0,1.0
15894,Dantza,129753,0,129753,2018.csv,2018,0.0,1.0
15895,The Metropolitan Opera HD Live: Puccini: Madama Butterfly,129730,129730,0,2018.csv,2018,1.0,0.0
15896,Bunraku,129706,0,129706,2012.csv,2012,0.0,1.0
15897,More,129683,0,129683,2018.csv,2018,0.0,1.0
15898,Rise of the Zombies,129545,0,129545,2013.csv,2013,0.0,1.0
15899,The Metropolitan Opera HD Live: Tchaikovsky: Eugene Onegin 2018 Re-release,129498,129498,0,2018.csv,2018,1.0,0.0
15900,The Boat Race,129466,0,129466,2010.csv,2010,0.0,1.0
15901,Bareilly Ki Barfi,129454,0,129454,2017.csv,2017,0.0,1.0
15902,Scarface 2012 Re-release,129450,0,129450,2012.csv,2012,0.0,1.0
15903,The Metropolitan Opera HD Live: Puccini: Manon Lescaut,129438,0,129438,2012.csv,2012,0.0,1.0
15904,The Etruscan Smile,129418,0,129418,2019.csv,2019,0.0,1.0
15905,The Metropolitan Opera HD Live: Verdi: Il Trovatore,129393,129393,0,2018.csv,2018,1.0,0.0
15906,Handsome Devil,129391,0,129391,2017.csv,2017,0.0,1.0
15907,Sesinde Ask Var,129378,0,129378,2019.csv,2019,0.0,1.0
15908,McCullin,129365,0,129365,2013.csv,2013,0.0,1.0
15909,Guadalquivir,129136,0,129136,2013.csv,2013,0.0,1.0
15910,My Daughter's First Time,129134,0,129134,2015.csv,2015,0.0,1.0
15911,The Return 2010 Re-release,129063,0,129063,2010.csv,2010,0.0,1.0
15912,Hometown on the Cloud,129045,0,129045,2017.csv,2017,0.0,1.0
15913,Solo Brathuke So Better,129044,45000,84044,2020.csv,2020,0.348718266637736,0.651281733362264
15914,I Called Him Morgan,128986,128986,0,2017.csv,2017,1.0,0.0
15915,Just the Wind,128962,0,128962,2013.csv,2013,0.0,1.0
15916,The Circle 2017 Re-release,128930,0,128930,2017.csv,2017,0.0,1.0
15917,The Metropolitan Opera Presents: Otello,128915,0,128915,2012.csv,2012,0.0,1.0
15918,Intruder,128788,0,128788,2016.csv,2016,0.0,1.0
15919,The Black Box,128774,0,128774,2020.csv,2020,0.0,1.0
15920,Arkansas,128761,0,128761,2020.csv,2020,0.0,1.0
15921,Christmas Trees. Final,128760,0,128760,2018.csv,2018,0.0,1.0
15922,Paris of the North,128716,0,128716,2014.csv,2014,0.0,1.0
15923,Yossi,128668,117047,11621,2012.csv,2012,0.9096822830851494,0.09031771691485062
15924,Scarecrow,128665,0,128665,2021.csv,2021,0.0,1.0
15925,Love After Love,128602,121098,7504,2018.csv,2018,0.9416494300244164,0.058350569975583584
15926,My Little Princess,128537,0,128537,2011.csv,2011,0.0,1.0
15927,Stilte,128497,0,128497,2012.csv,2012,0.0,1.0
15928,The Metropolitan Opera HD Live: Handel: Rodelinda,128472,0,128472,2012.csv,2012,0.0,1.0
15929,The Adventurer: The Curse of the Midas Box,128471,6399,122072,2014.csv,2014,0.04980890629013552,0.9501910937098644
15930,I'm Not There 2010 Re-release,128426,0,128426,2010.csv,2010,0.0,1.0
15931,Lobos sucios,128425,0,128425,2016.csv,2016,0.0,1.0
15932,August Friends,128384,0,128384,2011.csv,2011,0.0,1.0
15933,Nauryz Jam,128376,0,128376,2017.csv,2017,0.0,1.0
15934,Sai Gon in the Rain,128358,0,128358,2020.csv,2020,0.0,1.0
15935,The Metropolitan Opera HD Live: Verdi: Un Ballo in Maschera,128352,0,128352,2013.csv,2013,0.0,1.0
15936,Fatal Nightmare,128296,0,128296,2019.csv,2019,0.0,1.0
15937,Stars Above,128280,0,128280,2012.csv,2012,0.0,1.0
15938,Where Hands Touch,128269,67743,60526,2018.csv,2018,0.5281322844958641,0.47186771550413587
15939,Stonewall Uprising,128203,128203,0,2010.csv,2010,1.0,0.0
15940,Maracaná,128167,0,128167,2014.csv,2014,0.0,1.0
15941,Bolero de Noche,128128,0,128128,2011.csv,2011,0.0,1.0
15942,Harry Potter and the Prisoner of Azkaban 2020 Re-release,128104,0,128104,2020.csv,2020,0.0,1.0
15943,Sara e Marti,128092,0,128092,2019.csv,2019,0.0,1.0
15944,Good Morning and Good Night,128079,0,128079,2019.csv,2019,0.0,1.0
15945,Infernal Affairs 2016 Re-release,128026,0,128026,2016.csv,2016,0.0,1.0
15946,Febiofest 2010,128026,0,128026,2010.csv,2010,0.0,1.0
15947,Memleket meselesi,128009,0,128009,2010.csv,2010,0.0,1.0
15948,David Loman,127999,0,127999,2013.csv,2013,0.0,1.0
15949,Don't Click 2013 Re-release,127971,0,127971,2013.csv,2013,0.0,1.0
15950,Street Lights,127938,0,127938,2018.csv,2018,0.0,1.0
15951,Hidden in the Spotlight,127884,0,127884,2020.csv,2020,0.0,1.0
15952,Zweisitzrakete,127853,0,127853,2013.csv,2013,0.0,1.0
15953,Computer Chess,127852,102041,25811,2013.csv,2013,0.7981181365954385,0.20188186340456152
15954,Kuttanadan Marpappa,127843,0,127843,2018.csv,2018,0.0,1.0
15955,The Return of Don Camillo,127840,0,127840,2011.csv,2011,0.0,1.0
15956,The Worthy,127839,0,127839,2017.csv,2017,0.0,1.0
15957,Eetu ja Konna,127766,0,127766,2011.csv,2011,0.0,1.0
15958,Work Hard - Play Hard,127733,0,127733,2012.csv,2012,0.0,1.0
15959,Living on Love Alone,127722,0,127722,2010.csv,2010,0.0,1.0
15960,Harry Potter and the Half-Blood Prince 2020 Re-release,127700,0,127700,2020.csv,2020,0.0,1.0
15961,Theeradha Vilaiyattu Pillai,127667,0,127667,2010.csv,2010,0.0,1.0
15962,The Guest,127625,0,127625,2019.csv,2019,0.0,1.0
15963,Theeya Velai Seiyyanum Kumaru,127603,0,127603,2013.csv,2013,0.0,1.0
15964,The Return of Buratino,127568,0,127568,2013.csv,2013,0.0,1.0
15965,Petty Letters and Love Crimes,127563,0,127563,2010.csv,2010,0.0,1.0
15966,Nicostratos the Pelican 2012 Re-release,127558,0,127558,2012.csv,2012,0.0,1.0
15967,Steve Jobs: The Lost Interview,127541,105710,21831,2011.csv,2011,0.8288315130036615,0.17116848699633844
15968,Above the Sky,127533,0,127533,2019.csv,2019,0.0,1.0
15969,Young Female Warrior,127410,0,127410,2019.csv,2019,0.0,1.0
15970,Benda Bilili!,127362,13420,113942,2010.csv,2010,0.10536894835194172,0.8946310516480583
15971,Anne of Green Gables,127345,0,127345,2016.csv,2016,0.0,1.0
15972,Sleepless in Seattle 2018 Re-release,127281,127281,0,2018.csv,2018,1.0,0.0
15973,Makala,127271,0,127271,2017.csv,2017,0.0,1.0
15974,A Band Called Death,127257,127257,0,2013.csv,2013,1.0,0.0
15975,Burst of Youth,127225,0,127225,2017.csv,2017,0.0,1.0
15976,Asesinos inocentes,127157,0,127157,2015.csv,2015,0.0,1.0
15977,Journal de France,127060,0,127060,2012.csv,2012,0.0,1.0
15978,1911 2013 Re-release,126983,0,126983,2013.csv,2013,0.0,1.0
15979,Noah Land,126962,0,126962,2020.csv,2020,0.0,1.0
15980,The Metropolitan Opera HD Live: Dvorák: Rusalka,126962,0,126962,2014.csv,2014,0.0,1.0
15981,The King,126931,0,126931,2019.csv,2019,0.0,1.0
15982,Skylines,126795,0,126795,2020.csv,2020,0.0,1.0
15983,Chimes at Midnight,126724,126724,0,2016.csv,2016,1.0,0.0
15984,The Mosquito Net,126716,0,126716,2010.csv,2010,0.0,1.0
15985,Mid-night,126654,0,126654,2018.csv,2018,0.0,1.0
15986,The Boss's Daughter,126647,0,126647,2016.csv,2016,0.0,1.0
15987,Silent Night,126594,14567,112027,2012.csv,2012,0.11506864464350601,0.884931355356494
15988,Blue Lodge,126535,0,126535,2011.csv,2011,0.0,1.0
15989,Ikaw ang pag-ibig,126531,0,126531,2011.csv,2011,0.0,1.0
15990,Forgotten Christmas,126523,0,126523,2019.csv,2019,0.0,1.0
15991,Banat El Amm,126455,0,126455,2012.csv,2012,0.0,1.0
15992,The Unfamiliar,126360,0,126360,2020.csv,2020,0.0,1.0
15993,Eskil & Trinidad,126323,0,126323,2013.csv,2013,0.0,1.0
15994,The Intruder,126315,0,126315,2010.csv,2010,0.0,1.0
15995,Escape Fire: The Fight to Rescue American Healthcare,126238,126238,0,2012.csv,2012,1.0,0.0
15996,I Now Pronounce You Black and White,126218,0,126218,2010.csv,2010,0.0,1.0
15997,Tra la terra e il cielo,126199,0,126199,2016.csv,2016,0.0,1.0
15998,The Arbor,126182,21620,104562,2010.csv,2010,0.17133981074955223,0.8286601892504478
15999,Harry Potter and the Order of the Phoenix 2020 Re-release,126170,0,126170,2020.csv,2020,0.0,1.0
16000,Sparrows,126165,0,126165,2015.csv,2015,0.0,1.0
16001,Niraali,126149,0,126149,2018.csv,2018,0.0,1.0
16002,Mortal,126068,0,126068,2020.csv,2020,0.0,1.0
16003,The Anomaly,126027,0,126027,2014.csv,2014,0.0,1.0
16004,Killer Mermaid,126005,0,126005,2014.csv,2014,0.0,1.0
16005,Love Me,125932,0,125932,2013.csv,2013,0.0,1.0
16006,Guardians of Oz 2017 Re-release,125927,0,125927,2017.csv,2017,0.0,1.0
16007,Day and Night,125917,0,125917,2010.csv,2010,0.0,1.0
16008,Recoil,125912,0,125912,2014.csv,2014,0.0,1.0
16009,The Great Buster,125807,118344,7463,2018.csv,2018,0.9406789765275382,0.059321023472461785
16010,18am Padi,125766,0,125766,2019.csv,2019,0.0,1.0
16011,Wonder Mama,125725,0,125725,2015.csv,2015,0.0,1.0
16012,Europa Report,125687,125687,0,2013.csv,2013,1.0,0.0
16013,Realive,125680,0,125680,2017.csv,2017,0.0,1.0
16014,Paris Is Burning 2019 Re-release,125677,125677,0,2019.csv,2019,1.0,0.0
16015,Only,125603,0,125603,2020.csv,2020,0.0,1.0
16016,Looking for love,125587,0,125587,2018.csv,2018,0.0,1.0
16017,Bayram Abi,125553,0,125553,2016.csv,2016,0.0,1.0
16018,Brave Men's Blood,125366,0,125366,2014.csv,2014,0.0,1.0
16019,Falsifier,125348,0,125348,2013.csv,2013,0.0,1.0
16020,This Changes Everything,125348,64988,60360,2019.csv,2019,0.5184606056738041,0.48153939432619586
16021,Rescuers,125267,0,125267,2015.csv,2015,0.0,1.0
16022,Exodus 2014 Re-release,125249,0,125249,2014.csv,2014,0.0,1.0
16023,The B-Side: Elsa Dorfman's Portrait Photography,125227,125227,0,2017.csv,2017,1.0,0.0
16024,Diane Has the Right Shape,125220,0,125220,2017.csv,2017,0.0,1.0
16025,Cell No. 7,125127,0,125127,2020.csv,2020,0.0,1.0
16026,Turning Mecards W: Secret of Bandain,124933,0,124933,2018.csv,2018,0.0,1.0
16027,Goon: Last of the Enforcers,124875,0,124875,2017.csv,2017,0.0,1.0
16028,"Señorita María, la falda de la montaña",124865,0,124865,2017.csv,2017,0.0,1.0
16029,Quella peste di Sophie,124864,0,124864,2016.csv,2016,0.0,1.0
16030,Spinning Plates,124856,112449,12407,2013.csv,2013,0.9006295252130454,0.09937047478695457
16031,Silent Souls 2012 Re-release,124839,0,124839,2012.csv,2012,0.0,1.0
16032,"A Dark, Dark Man",124792,0,124792,2020.csv,2020,0.0,1.0
16033,Newness,124783,0,124783,2017.csv,2017,0.0,1.0
16034,Spooks and Spirits,124757,0,124757,2013.csv,2013,0.0,1.0
16035,Mary Magdalene 2019 Re-release,124741,124741,0,2019.csv,2019,1.0,0.0
16036,Every Secret Thing,124733,103536,21197,2015.csv,2015,0.8300610103180394,0.16993898968196067
16037,Pegasus: Pony with a Broken Wing,124732,0,124732,2019.csv,2019,0.0,1.0
16038,Hymn: Sarah Brightman in Concert,124707,113274,11433,2018.csv,2018,0.9083211046693449,0.09167889533065506
16039,Cin Azabi,124685,0,124685,2019.csv,2019,0.0,1.0
16040,Ran 2010 Re-release,124673,124673,0,2010.csv,2010,1.0,0.0
16041,Offside 2011 Re-release,124637,0,124637,2011.csv,2011,0.0,1.0
16042,Vo Gian Dao,124606,0,124606,2019.csv,2019,0.0,1.0
16043,A Tuba to Cuba,124592,121772,2820,2019.csv,2019,0.9773661230255554,0.022633876974444588
16044,Khallet Warde,124586,0,124586,2011.csv,2011,0.0,1.0
16045,'85: The Greatest Team in Football History,124573,124573,0,2018.csv,2018,1.0,0.0
16046,Final: The Rapture,124561,124561,0,2013.csv,2013,1.0,0.0
16047,Catalunya über alles!,124558,0,124558,2011.csv,2011,0.0,1.0
16048,Vidal Sassoon: The Movie,124532,85974,38558,2011.csv,2011,0.6903767706292359,0.30962322937076414
16049,Peur de rien,124504,0,124504,2016.csv,2016,0.0,1.0
16050,Kae Dai Kidthung,124501,0,124501,2015.csv,2015,0.0,1.0
16051,BanG Dream! FILM LIVE,124473,0,124473,2019.csv,2019,0.0,1.0
16052,Un petit air de famille,124359,0,124359,2019.csv,2019,0.0,1.0
16053,Riot,124358,0,124358,2016.csv,2016,0.0,1.0
16054,Het doet zo zeer,124343,0,124343,2017.csv,2017,0.0,1.0
16055,The M Riders: Finding Pangu,124318,0,124318,2018.csv,2018,0.0,1.0
16056,Post Tenebras Lux,124279,39185,85094,2012.csv,2012,0.31529864257034573,0.6847013574296542
16057,The Square,124244,124244,0,2013.csv,2013,1.0,0.0
16058,Deed,124192,0,124192,2013.csv,2013,0.0,1.0
16059,Baztan,124149,0,124149,2013.csv,2013,0.0,1.0
16060,Will,124104,0,124104,2011.csv,2011,0.0,1.0
16061,Escuela para Seductores,124071,0,124071,2020.csv,2020,0.0,1.0
16062,Haram,124043,0,124043,2014.csv,2014,0.0,1.0
16063,Marguerite & Julien,123918,0,123918,2015.csv,2015,0.0,1.0
16064,Préjudice,123868,0,123868,2015.csv,2015,0.0,1.0
16065,Knights of Badassdom,123854,123854,0,2014.csv,2014,1.0,0.0
16066,Wings of Desire 2018 Re-release,123830,123830,0,2018.csv,2018,1.0,0.0
16067,The Magic of Belle Isle,123821,102388,21433,2012.csv,2012,0.8269033524200257,0.1730966475799743
16068,Love Isn't Always on Time,123774,0,123774,2014.csv,2014,0.0,1.0
16069,Lifsleikni Gillz,123757,0,123757,2014.csv,2014,0.0,1.0
16070,Puncture,123700,68945,54755,2011.csv,2011,0.5573565076798707,0.44264349232012934
16071,Appropriate Behavior,123699,46912,76787,2015.csv,2015,0.37924316283882653,0.6207568371611735
16072,#Sohavégetnemérös,123694,0,123694,2016.csv,2016,0.0,1.0
16073,Utneunnamja Gamdokpan,123657,0,123657,2019.csv,2019,0.0,1.0
16074,Antigone,123645,0,123645,2020.csv,2020,0.0,1.0
16075,In the Open,123609,0,123609,2012.csv,2012,0.0,1.0
16076,Oliver Sacks: His Own Life,123593,0,123593,2020.csv,2020,0.0,1.0
16077,The Technician,123588,0,123588,2015.csv,2015,0.0,1.0
16078,Good as You,123536,0,123536,2012.csv,2012,0.0,1.0
16079,Soberano 2: A Heroica Conquista do Mundial de 2005,123488,0,123488,2012.csv,2012,0.0,1.0
16080,Sigur Rós: Inni,123482,123482,0,2011.csv,2011,1.0,0.0
16081,Funny Soccer,123459,0,123459,2016.csv,2016,0.0,1.0
16082,Downtown 81 2019 Re-release,123387,123387,0,2019.csv,2019,1.0,0.0
16083,Code M,123377,0,123377,2015.csv,2015,0.0,1.0
16084,Dwae-ji-ui wang,123341,0,123341,2011.csv,2011,0.0,1.0
16085,Payback Season,123319,0,123319,2012.csv,2012,0.0,1.0
16086,Easy Rider 2019 Re-release,123276,123276,0,2019.csv,2019,1.0,0.0
16087,The White Lions,123275,0,123275,2011.csv,2011,0.0,1.0
16088,Must Have Been Love,123263,0,123263,2012.csv,2012,0.0,1.0
16089,La Niña de Maracaibo,123251,0,123251,2012.csv,2012,0.0,1.0
16090,Altergeist,123233,0,123233,2015.csv,2015,0.0,1.0
16091,Somer Son,123191,0,123191,2015.csv,2015,0.0,1.0
16092,God's Faithful Servant: Barla,123093,0,123093,2011.csv,2011,0.0,1.0
16093,"Cometa: Him, His Dog and Their World",123090,0,123090,2017.csv,2017,0.0,1.0
16094,Azap,123066,0,123066,2015.csv,2015,0.0,1.0
16095,Letters to Father Jacob 2012 Re-release,123060,0,123060,2012.csv,2012,0.0,1.0
16096,Thunderdome Never Dies,122970,0,122970,2019.csv,2019,0.0,1.0
16097,The Last Mountain,122961,122961,0,2011.csv,2011,1.0,0.0
16098,Ashby,122919,4631,118288,2015.csv,2015,0.03767521701282959,0.9623247829871704
16099,Don't Take me Home,122890,0,122890,2017.csv,2017,0.0,1.0
16100,Warren Miller's Face of Winter,122855,0,122855,2019.csv,2019,0.0,1.0
16101,Blood Fest,122833,82774,40059,2018.csv,2018,0.6738742845977872,0.32612571540221275
16102,"14 Days, 12 Nights",122806,122530,276,2020.csv,2020,0.9977525528068661,0.002247447193133886
16103,The Crossing,122784,0,122784,2010.csv,2010,0.0,1.0
16104,Truyên Ngan,122699,0,122699,2019.csv,2019,0.0,1.0
16105,Ho Ho Ho 2009 Re-release,122644,0,122644,2010.csv,2010,0.0,1.0
16106,Do I Sound Gay?,122595,119388,3207,2015.csv,2015,0.9738406949712468,0.026159305028753212
16107,Kamchatka Bears. Life Begins,122573,0,122573,2018.csv,2018,0.0,1.0
16108,Wonderful Losers: A Different World,122413,0,122413,2018.csv,2018,0.0,1.0
16109,Dark Country 2011 Re-release,122407,0,122407,2011.csv,2011,0.0,1.0
16110,Iris,122370,0,122370,2011.csv,2011,0.0,1.0
16111,Saguni,122345,0,122345,2012.csv,2012,0.0,1.0
16112,Lanetli Anahtar,122295,0,122295,2016.csv,2016,0.0,1.0
16113,Grease 2010 Sing-a-long,122251,0,122251,2011.csv,2011,0.0,1.0
16114,The Windmill,122230,0,122230,2017.csv,2017,0.0,1.0
16115,Tragedy Girls,122211,61899,60312,2017.csv,2017,0.506492868890689,0.49350713110931094
16116,Hab,122191,0,122191,2020.csv,2020,0.0,1.0
16117,Ik Sandhu Hunda Si,122172,0,122172,2020.csv,2020,0.0,1.0
16118,DQE's Peter Pan: The New Adventures,122137,0,122137,2018.csv,2018,0.0,1.0
16119,The Night Watchman,122073,0,122073,2016.csv,2016,0.0,1.0
16120,Remember Me,122062,0,122062,2019.csv,2019,0.0,1.0
16121,Fan of Amoory,121977,0,121977,2018.csv,2018,0.0,1.0
16122,Almost 40,121953,0,121953,2018.csv,2018,0.0,1.0
16123,The Boy and the World,121928,0,121928,2014.csv,2014,0.0,1.0
16124,The Ones Below,121827,12488,109339,2016.csv,2016,0.10250601262445927,0.8974939873755408
16125,Tremors,121813,23911,97902,2019.csv,2019,0.19629267812138276,0.8037073218786173
16126,Pontioi New Generation = Neon genean,121809,0,121809,2011.csv,2011,0.0,1.0
16127,Im-Eul Wi-Han Haeng-Jin-Gok,121729,0,121729,2018.csv,2018,0.0,1.0
16128,Yu-Gi-Oh!: The Movie - Pyramid of Light 2018 Re-release,121688,121688,0,2018.csv,2018,1.0,0.0
16129,Dead or Alive 1918,121687,0,121687,2012.csv,2012,0.0,1.0
16130,Magalir Mattum,121591,0,121591,2017.csv,2017,0.0,1.0
16131,Letters to Elena,121254,8511,112743,2012.csv,2012,0.07019149883715177,0.9298085011628482
16132,Zero Tolerance,121245,0,121245,2015.csv,2015,0.0,1.0
16133,Rsasa Tayche,121212,0,121212,2011.csv,2011,0.0,1.0
16134,Casa Grande,121209,0,121209,2015.csv,2015,0.0,1.0
16135,Brothel Lights,121196,0,121196,2011.csv,2011,0.0,1.0
16136,Afflicted,121179,121179,0,2014.csv,2014,1.0,0.0
16137,Gürbüz: Hadi Allah'a Emanet,121169,0,121169,2018.csv,2018,0.0,1.0
16138,Surkhi Bindi,121163,0,121163,2019.csv,2019,0.0,1.0
16139,Snekker Andersen og Julenissen 2017 Re-release,121145,0,121145,2017.csv,2017,0.0,1.0
16140,Little Feather,121142,0,121142,2016.csv,2016,0.0,1.0
16141,Wool-Ji-Ma Ton-Ze 2: Shu-Keu-Ran Ba-Ba,121103,0,121103,2020.csv,2020,0.0,1.0
16142,In Jackson Heights,121094,121094,0,2015.csv,2015,1.0,0.0
16143,Georgettan's Pooram,121084,0,121084,2017.csv,2017,0.0,1.0
16144,Michael,121034,15715,105319,2011.csv,2011,0.12983954921757523,0.8701604507824248
16145,The Girl Without Hands,121020,21787,99233,2016.csv,2016,0.1800280945298298,0.8199719054701702
16146,Darling,120958,0,120958,2012.csv,2012,0.0,1.0
16147,Fullir Vasar,120925,0,120925,2018.csv,2018,0.0,1.0
16148,Like Crazy 2017 Re-release,120920,0,120920,2017.csv,2017,0.0,1.0
16149,This House,120916,0,120916,2013.csv,2013,0.0,1.0
16150,Beyond the Hill,120911,0,120911,2012.csv,2012,0.0,1.0
16151,Miss Sharon Jones!,120880,120880,0,2016.csv,2016,1.0,0.0
16152,Bhajjo Veero Ve,120839,0,120839,2018.csv,2018,0.0,1.0
16153,"I Love You, You're Perfect, Now Change!",120837,0,120837,2019.csv,2019,0.0,1.0
16154,Better Living Through Chemistry,120823,75143,45680,2014.csv,2014,0.6219262888688412,0.3780737111311588
16155,Dark Light,120818,0,120818,2019.csv,2019,0.0,1.0
16156,Masaan,120809,0,120809,2015.csv,2015,0.0,1.0
16157,The Retirement,120806,0,120806,2019.csv,2019,0.0,1.0
16158,Hockney 2016 Re-release,120745,120745,0,2016.csv,2016,1.0,0.0
16159,Bangzi Melody,120690,0,120690,2018.csv,2018,0.0,1.0
16160,Cowgirls 'n Angels,120680,120680,0,2012.csv,2012,1.0,0.0
16161,Feo pero Sabroso,120645,0,120645,2019.csv,2019,0.0,1.0
16162,To Crack Bloggers,120507,0,120507,2016.csv,2016,0.0,1.0
16163,Araf/Somewhere in Between 2012 Re-release,120461,0,120461,2012.csv,2012,0.0,1.0
16164,Spark: A Burning Man Story,120459,120459,0,2013.csv,2013,1.0,0.0
16165,Fight,120354,0,120354,2017.csv,2017,0.0,1.0
16166,Alles unter Kontrolle,120340,0,120340,2015.csv,2015,0.0,1.0
16167,Hostage,120324,0,120324,2014.csv,2014,0.0,1.0
16168,Memories of Murder 2020 Re-release,120321,0,120321,2020.csv,2020,0.0,1.0
16169,Para Elisa 2015 Re-release,120276,0,120276,2015.csv,2015,0.0,1.0
16170,The Cases,120248,0,120248,2012.csv,2012,0.0,1.0
16171,Foodfight!,120141,0,120141,2012.csv,2012,0.0,1.0
16172,Singh vs. Kaur,120137,0,120137,2013.csv,2013,0.0,1.0
16173,Close to You,120121,0,120121,2016.csv,2016,0.0,1.0
16174,Jakten på Berlusconi,120094,0,120094,2014.csv,2014,0.0,1.0
16175,Blood Glacier,120090,0,120090,2013.csv,2013,0.0,1.0
16176,The Interval 2012 Re-release,120048,0,120048,2012.csv,2012,0.0,1.0
16177,Piano Trojan,120000,0,120000,2013.csv,2013,0.0,1.0
16178,Blank City,119929,116037,3892,2011.csv,2011,0.9675474655838038,0.03245253441619625
16179,This Ain't California,119925,0,119925,2012.csv,2012,0.0,1.0
16180,Avant qu'on explose,119894,119894,0,2019.csv,2019,1.0,0.0
16181,Masameer the Movie,119886,0,119886,2020.csv,2020,0.0,1.0
16182,Majesty,119864,0,119864,2010.csv,2010,0.0,1.0
16183,The Pearl Button,119753,42166,77587,2015.csv,2015,0.35210808915016745,0.6478919108498326
16184,The Anomaly 2019 Re-release,119730,0,119730,2019.csv,2019,0.0,1.0
16185,Like There's No Tomorrow,119643,0,119643,2012.csv,2012,0.0,1.0
16186,Süper incir,119627,0,119627,2013.csv,2013,0.0,1.0
16187,Nowhere Home,119613,0,119613,2012.csv,2012,0.0,1.0
16188,Tum: My Pledge of Love,119580,0,119580,2011.csv,2011,0.0,1.0
16189,Richie,119473,0,119473,2017.csv,2017,0.0,1.0
16190,"Daddy, I'm a Zombie",119440,0,119440,2012.csv,2012,0.0,1.0
16191,Epicentro,119413,0,119413,2020.csv,2020,0.0,1.0
16192,Xico's Journey,119373,0,119373,2020.csv,2020,0.0,1.0
16193,Digging for Fire,119364,119364,0,2015.csv,2015,1.0,0.0
16194,Notturno,119354,0,119354,2020.csv,2020,0.0,1.0
16195,La Estrella,119322,0,119322,2013.csv,2013,0.0,1.0
16196,Carmina or Blow Up,119298,0,119298,2012.csv,2012,0.0,1.0
16197,Valley of the Heart's Delight,119290,119290,0,2010.csv,2010,1.0,0.0
16198,Celine: Through the Eyes of the World,119274,0,119274,2010.csv,2010,0.0,1.0
16199,A Good Night,119128,0,119128,2011.csv,2011,0.0,1.0
16200,Psycho-Pass,119127,0,119127,2015.csv,2015,0.0,1.0
16201,Hovory s TGM,119125,0,119125,2018.csv,2018,0.0,1.0
16202,Remember the Goal,119100,119100,0,2016.csv,2016,1.0,0.0
16203,Conor McGregor: Notorious,119054,0,119054,2017.csv,2017,0.0,1.0
16204,La scoperta dell'alba,118999,0,118999,2013.csv,2013,0.0,1.0
16205,Il paese delle spose infelici,118984,0,118984,2011.csv,2011,0.0,1.0
16206,Paradise in Service,118809,0,118809,2014.csv,2014,0.0,1.0
16207,Until Forever 2016 Re-release,118795,105358,13437,2016.csv,2016,0.8868891788374932,0.11311082116250684
16208,Kedbet Kol Youm,118747,0,118747,2016.csv,2016,0.0,1.0
16209,National Theater Live: Cyrano de Bergerac,118698,86300,32398,2019.csv,2019,0.727055215757637,0.27294478424236296
16210,Harjeeta,118688,0,118688,2018.csv,2018,0.0,1.0
16211,Neither Heaven Nor Earth,118663,12810,105853,2015.csv,2015,0.10795277382166303,0.892047226178337
16212,Chandigarh Amritsar Chandigarh,118655,0,118655,2019.csv,2019,0.0,1.0
16213,The Levelling,118451,3040,115411,2017.csv,2017,0.025664620813669787,0.9743353791863302
16214,Fyrir framan annað fólk,118423,0,118423,2016.csv,2016,0.0,1.0
16215,Poker,118330,0,118330,2010.csv,2010,0.0,1.0
16216,Shareek,118315,0,118315,2015.csv,2015,0.0,1.0
16217,Sandakozhi 2,118295,0,118295,2018.csv,2018,0.0,1.0
16218,Band Vaaje,118218,0,118218,2019.csv,2019,0.0,1.0
16219,Molly & Wors,118215,0,118215,2013.csv,2013,0.0,1.0
16220,See What I'm Saying: The Deaf Entertainers Documentary,118206,118206,0,2010.csv,2010,1.0,0.0
16221,Styx,118188,70794,47394,2018.csv,2018,0.5989948218093207,0.40100517819067927
16222,America,118169,0,118169,2018.csv,2018,0.0,1.0
16223,Succo di marca,118144,0,118144,2011.csv,2011,0.0,1.0
16224,Udo Proksch: Out of Control,118074,0,118074,2010.csv,2010,0.0,1.0
16225,Fate Stay Night Heaven's Feel,117983,0,117983,2020.csv,2020,0.0,1.0
16226,Come to Daddy,117947,96713,21234,2020.csv,2020,0.8199699865193689,0.18003001348063113
16227,Atlikarinca,117909,0,117909,2011.csv,2011,0.0,1.0
16228,Gretskiy Oreshek,117906,0,117906,2018.csv,2018,0.0,1.0
16229,Lavakusha,117850,0,117850,2017.csv,2017,0.0,1.0
16230,Le rire de ma mère,117812,0,117812,2018.csv,2018,0.0,1.0
16231,Tannoura Maxi,117797,0,117797,2012.csv,2012,0.0,1.0
16232,Victor,117755,117755,0,2016.csv,2016,1.0,0.0
16233,The Decoy Bride,117754,759,116995,2011.csv,2011,0.006445640912410619,0.9935543590875894
16234,Biet Doi Tu Than,117735,0,117735,2015.csv,2015,0.0,1.0
16235,Freakonomics,117678,101270,16408,2010.csv,2010,0.8605686704396743,0.13943132956032564
16236,100 Yen Love,117642,0,117642,2016.csv,2016,0.0,1.0
16237,Fridge,117479,0,117479,2012.csv,2012,0.0,1.0
16238,Bisbee '17,117470,117470,0,2018.csv,2018,1.0,0.0
16239,Botero,117400,0,117400,2019.csv,2019,0.0,1.0
16240,Magic Boys,117392,0,117392,2012.csv,2012,0.0,1.0
16241,Tieteybit,117379,0,117379,2020.csv,2020,0.0,1.0
16242,Ghost Sword,117363,0,117363,2019.csv,2019,0.0,1.0
16243,Moroccan Gigolos,117342,0,117342,2013.csv,2013,0.0,1.0
16244,Takien: The Haunted Tree,117338,0,117338,2010.csv,2010,0.0,1.0
16245,George Takei's Allegiance 2018 Re-release,117162,117162,0,2018.csv,2018,1.0,0.0
16246,Casting na lásku,117151,0,117151,2020.csv,2020,0.0,1.0
16247,Chivas la película,117122,0,117122,2018.csv,2018,0.0,1.0
16248,Jauja 2014 Re-release,117117,60231,56886,2014.csv,2014,0.5142805912036681,0.48571940879633185
16249,Startap,117111,0,117111,2014.csv,2014,0.0,1.0
16250,Michel Petrucciani,117063,0,117063,2011.csv,2011,0.0,1.0
16251,On the Sly,117045,0,117045,2018.csv,2018,0.0,1.0
16252,Knock Out 2014 Re-release,117034,0,117034,2014.csv,2014,0.0,1.0
16253,What Happiness Is,117016,0,117016,2012.csv,2012,0.0,1.0
16254,Rodinka,116996,0,116996,2010.csv,2010,0.0,1.0
16255,The Metropolitan Opera HD Live: Shostakovich: The Nose,116978,0,116978,2013.csv,2013,0.0,1.0
16256,Spellbound,116900,0,116900,2019.csv,2019,0.0,1.0
16257,Garden Lovers,116890,0,116890,2014.csv,2014,0.0,1.0
16258,Everything Will Be Fine,116875,0,116875,2010.csv,2010,0.0,1.0
16259,Shadows and Faces,116862,0,116862,2011.csv,2011,0.0,1.0
16260,This Is Not a Movie,116801,0,116801,2011.csv,2011,0.0,1.0
16261,Olvidados,116795,0,116795,2014.csv,2014,0.0,1.0
16262,Gimme the Loot,116783,104442,12341,2013.csv,2013,0.8943253726997936,0.10567462730020637
16263,Lamb of God 2016 Re-release,116744,0,116744,2016.csv,2016,0.0,1.0
16264,20.000 Besos,116733,0,116733,2013.csv,2013,0.0,1.0
16265,Three Summers,116720,0,116720,2020.csv,2020,0.0,1.0
16266,Çagrilan,116692,0,116692,2016.csv,2016,0.0,1.0
16267,Catching Feelings,116645,0,116645,2018.csv,2018,0.0,1.0
16268,Alice in Earnestland,116614,0,116614,2015.csv,2015,0.0,1.0
16269,Besser als nix,116592,0,116592,2014.csv,2014,0.0,1.0
16270,Bir Nefes Yeter,116587,0,116587,2017.csv,2017,0.0,1.0
16271,A Case of You,116559,4187,112372,2013.csv,2013,0.035921722046345625,0.9640782779536544
16272,How to Train Our Dragon,116521,0,116521,2018.csv,2018,0.0,1.0
16273,Mermaid Down,116466,0,116466,2019.csv,2019,0.0,1.0
16274,The Undefeated,116381,116381,0,2011.csv,2011,1.0,0.0
16275,Ci devo pensare,116366,0,116366,2015.csv,2015,0.0,1.0
16276,Touching Home,116353,116353,0,2010.csv,2010,1.0,0.0
16277,Anything for Jackson,116317,0,116317,2021.csv,2021,0.0,1.0
16278,And the Oskar Goes To..,116304,0,116304,2019.csv,2019,0.0,1.0
16279,Yildizlar da Kayar: Das Borak,116241,0,116241,2016.csv,2016,0.0,1.0
16280,The Art of Flight,116134,0,116134,2012.csv,2012,0.0,1.0
16281,Scare Campaign,116023,0,116023,2016.csv,2016,0.0,1.0
16282,Lost in Munich,115922,0,115922,2015.csv,2015,0.0,1.0
16283,Happy Old Year,115871,0,115871,2020.csv,2020,0.0,1.0
16284,The Underwater Adventures of Sadko,115861,0,115861,2018.csv,2018,0.0,1.0
16285,Peri Masali,115810,0,115810,2014.csv,2014,0.0,1.0
16286,Ironclad: Battle for Blood,115791,0,115791,2014.csv,2014,0.0,1.0
16287,Mob Psycho 100,115766,115766,0,2019.csv,2019,1.0,0.0
16288,I Am Divine,115739,81497,34242,2013.csv,2013,0.7041446703358418,0.2958553296641582
16289,The Metropolitan Opera HD Live: Tchaikovsky: Eugene Onegin,115732,0,115732,2013.csv,2013,0.0,1.0
16290,A Club After Dinner,115665,0,115665,2013.csv,2013,0.0,1.0
16291,Robodog,115654,0,115654,2016.csv,2016,0.0,1.0
16292,The Invisible Front,115650,0,115650,2014.csv,2014,0.0,1.0
16293,Superwelt,115620,0,115620,2015.csv,2015,0.0,1.0
16294,Desaster,115616,0,115616,2015.csv,2015,0.0,1.0
16295,Swathanthryam Ardharathriyil,115571,0,115571,2018.csv,2018,0.0,1.0
16296,Evliya Çelebi: The Fountain of Youth,115523,0,115523,2014.csv,2014,0.0,1.0
16297,Zakwakani,115518,0,115518,2016.csv,2016,0.0,1.0
16298,Headshot,115511,1373,114138,2011.csv,2011,0.011886313857554691,0.9881136861424453
16299,The Legend of the Five,115490,0,115490,2020.csv,2020,0.0,1.0
16300,Baby 2015 Re-release,115444,0,115444,2015.csv,2015,0.0,1.0
16301,Carmina y amén. 2016 Re-release,115415,0,115415,2016.csv,2016,0.0,1.0
16302,Exit 2019 Re-release,115351,0,115351,2019.csv,2019,0.0,1.0
16303,Happy End 2010 Re-release,115321,0,115321,2010.csv,2010,0.0,1.0
16304,Hardkor Disko,115311,0,115311,2014.csv,2014,0.0,1.0
16305,FLCL Progressive: Stone Skipping,115304,0,115304,2020.csv,2020,0.0,1.0
16306,The Innocence,115260,0,115260,2020.csv,2020,0.0,1.0
16307,For 80 Days,115251,0,115251,2010.csv,2010,0.0,1.0
16308,Agent 2000: Die Laksman,115246,0,115246,2014.csv,2014,0.0,1.0
16309,"Siberia, Monamour",115240,0,115240,2011.csv,2011,0.0,1.0
16310,Miss Hanoi,115198,0,115198,2018.csv,2018,0.0,1.0
16311,The Mafia Is No Longer What It Used to Be,115125,0,115125,2019.csv,2019,0.0,1.0
16312,Meeting the Giant,115073,0,115073,2014.csv,2014,0.0,1.0
16313,Vimaanam,115048,0,115048,2017.csv,2017,0.0,1.0
16314,Jurassic World 2021 Re-release,115000,115000,0,2021.csv,2021,1.0,0.0
16315,Year of Grace,114975,0,114975,2012.csv,2012,0.0,1.0
16316,Brothers' Nest,114968,0,114968,2018.csv,2018,0.0,1.0
16317,Nai-Kai-Jeow,114960,0,114960,2017.csv,2017,0.0,1.0
16318,Caged No More,114959,114959,0,2016.csv,2016,1.0,0.0
16319,In the Room,114945,0,114945,2016.csv,2016,0.0,1.0
16320,Dementia,114940,0,114940,2014.csv,2014,0.0,1.0
16321,The Almost Man,114925,0,114925,2012.csv,2012,0.0,1.0
16322,Curiosa,114900,0,114900,2019.csv,2019,0.0,1.0
16323,Nejsledovanejsi,114842,0,114842,2017.csv,2017,0.0,1.0
16324,Cabin Fever,114835,0,114835,2016.csv,2016,0.0,1.0
16325,Hunter x Hunter,114796,0,114796,2013.csv,2013,0.0,1.0
16326,Returning of Red Flag Canal,114785,0,114785,2019.csv,2019,0.0,1.0
16327,The Fault Is Not Yours,114693,0,114693,2019.csv,2019,0.0,1.0
16328,Coriolanus 2014 Re-release,114671,0,114671,2014.csv,2014,0.0,1.0
16329,Nostalgia,114603,114603,0,2018.csv,2018,1.0,0.0
16330,Moving On,114575,0,114575,2020.csv,2020,0.0,1.0
16331,Fighting Fear,114551,0,114551,2011.csv,2011,0.0,1.0
16332,Babalarin Babasi,114540,0,114540,2016.csv,2016,0.0,1.0
16333,The Metropolitan Opera HD Live: Donizetti: Maria Stuarda,114462,0,114462,2013.csv,2013,0.0,1.0
16334,Seven Fright Nights,114402,0,114402,2017.csv,2017,0.0,1.0
16335,The World to Come,114379,114379,0,2021.csv,2021,1.0,0.0
16336,Doctor Who: The Power of the Daleks,114379,0,114379,2016.csv,2016,0.0,1.0
16337,Sympathy for the Devil,114301,51150,63151,2019.csv,2019,0.44750264652102784,0.5524973534789722
16338,The Journey,114290,0,114290,2014.csv,2014,0.0,1.0
16339,Supershow 3D,114290,0,114290,2011.csv,2011,0.0,1.0
16340,John McEnroe: In the Realm of Perfection,114289,90964,23325,2018.csv,2018,0.795912117526621,0.2040878824733789
16341,Sharknado 2: The Second One,114229,0,114229,2014.csv,2014,0.0,1.0
16342,Jitters,114203,0,114203,2010.csv,2010,0.0,1.0
16343,Muhurlu Kosk,114164,0,114164,2011.csv,2011,0.0,1.0
16344,Vision,114146,0,114146,2018.csv,2018,0.0,1.0
16345,Pattas,114121,0,114121,2020.csv,2020,0.0,1.0
16346,Star Wars: May the 4th Marathon,114089,0,114089,2014.csv,2014,0.0,1.0
16347,El peso de la ley,114080,0,114080,2017.csv,2017,0.0,1.0
16348,Jack to a King: The Swansea Story,114061,0,114061,2014.csv,2014,0.0,1.0
16349,The Holy Family,114025,0,114025,2019.csv,2019,0.0,1.0
16350,Sharp the Bull,114006,0,114006,2019.csv,2019,0.0,1.0
16351,Ain't in It for My Health: A Film About Levon Helm,113966,113966,0,2013.csv,2013,1.0,0.0
16352,Bodied,113956,113956,0,2018.csv,2018,1.0,0.0
16353,Escape from Stalin's Death Camp,113934,0,113934,2017.csv,2017,0.0,1.0
16354,Majstori,113914,0,113914,2014.csv,2014,0.0,1.0
16355,The Legend of Baron To'a,113880,0,113880,2020.csv,2020,0.0,1.0
16356,Azem 2: Cin Garezi,113871,0,113871,2015.csv,2015,0.0,1.0
16357,The Woman Who Loves Giraffes,113858,113858,0,2019.csv,2019,1.0,0.0
16358,From A to B,113855,0,113855,2015.csv,2015,0.0,1.0
16359,35 and Ticking,113794,113794,0,2011.csv,2011,1.0,0.0
16360,The Broken Key,113772,0,113772,2017.csv,2017,0.0,1.0
16361,A Christmas Carol,113730,0,113730,2020.csv,2020,0.0,1.0
16362,The Man Who Surprised Everyone,113717,0,113717,2018.csv,2018,0.0,1.0
16363,Search Party,113692,0,113692,2014.csv,2014,0.0,1.0
16364,Business on WeChat,113615,0,113615,2019.csv,2019,0.0,1.0
16365,Swimming for Gold,113605,0,113605,2020.csv,2020,0.0,1.0
16366,Tibetan Dog 2014 Re-release,113600,0,113600,2014.csv,2014,0.0,1.0
16367,The Goonies 2015 Re-release,113538,113538,0,2015.csv,2015,1.0,0.0
16368,31 Million Reasons,113480,0,113480,2012.csv,2012,0.0,1.0
16369,Století Miroslava Zikmunda,113469,0,113469,2014.csv,2014,0.0,1.0
16370,"We Love You, Sally Carmichael!",113435,113435,0,2017.csv,2017,1.0,0.0
16371,Goodalochana,113380,0,113380,2017.csv,2017,0.0,1.0
16372,Mi rifaccio il trullo,113361,0,113361,2016.csv,2016,0.0,1.0
16373,Radical Evil,113348,0,113348,2014.csv,2014,0.0,1.0
16374,Kissing You,113334,0,113334,2017.csv,2017,0.0,1.0
16375,Abacus: Small Enough to Jail,113278,113278,0,2017.csv,2017,1.0,0.0
16376,God the Father,113276,113276,0,2014.csv,2014,1.0,0.0
16377,Living,113196,0,113196,2012.csv,2012,0.0,1.0
16378,A Simple Life 2013 Re-release,113178,0,113178,2013.csv,2013,0.0,1.0
16379,Burn 2012 Re-release,113173,113173,0,2012.csv,2012,1.0,0.0
16380,Road Hard,113169,113169,0,2015.csv,2015,1.0,0.0
16381,Police Story,113164,113164,0,2019.csv,2019,1.0,0.0
16382,Upgrade 2020 Re-release,113126,0,113126,2020.csv,2020,0.0,1.0
16383,Bewakoofiyaan,112986,0,112986,2014.csv,2014,0.0,1.0
16384,Family Film,112926,0,112926,2016.csv,2016,0.0,1.0
16385,De held,112917,0,112917,2016.csv,2016,0.0,1.0
16386,Kulyas: Lanetin Bedeli,112901,0,112901,2019.csv,2019,0.0,1.0
16387,Tokio,112853,0,112853,2015.csv,2015,0.0,1.0
16388,Filmworker,112828,102609,10219,2018.csv,2018,0.9094285106533839,0.09057148934661609
16389,The Changeover,112749,0,112749,2017.csv,2017,0.0,1.0
16390,Glory: A Tale of Mistaken Identities,112688,0,112688,2012.csv,2012,0.0,1.0
16391,Follow Me: The Yoni Netanyahu Story,112679,112679,0,2012.csv,2012,1.0,0.0
16392,A Common Man,112633,0,112633,2013.csv,2013,0.0,1.0
16393,"Sonora, the Devil's Highway",112633,0,112633,2019.csv,2019,0.0,1.0
16394,Mylene Farmer 2019 - The Film,112613,0,112613,2019.csv,2019,0.0,1.0
16395,Bordo Bereliler Afrin,112588,0,112588,2018.csv,2018,0.0,1.0
16396,Love Records: Gimme Some Love,112569,0,112569,2016.csv,2016,0.0,1.0
16397,A Boy. A Girl. A Dream.,112552,112552,0,2018.csv,2018,1.0,0.0
16398,Nasipse Olur,112535,0,112535,2020.csv,2020,0.0,1.0
16399,A Tor Bella Monaca non piove mai,112440,0,112440,2019.csv,2019,0.0,1.0
16400,The Recall,112357,22943,89414,2017.csv,2017,0.20419733527951084,0.7958026647204891
16401,'n Man Soos My Pa,112340,0,112340,2015.csv,2015,0.0,1.0
16402,Muzzikanti,112337,0,112337,2017.csv,2017,0.0,1.0
16403,"Hale County This Morning, This Evening",112282,112282,0,2018.csv,2018,1.0,0.0
16404,Taiwan,112254,0,112254,2010.csv,2010,0.0,1.0
16405,The Dawn Wall,112191,112191,0,2018.csv,2018,1.0,0.0
16406,Penton: The John Penton Story,112159,112159,0,2014.csv,2014,1.0,0.0
16407,Ankur Arora Murder Case,112110,0,112110,2013.csv,2013,0.0,1.0
16408,Sûpu: Umarekawari no monogatari,112095,0,112095,2012.csv,2012,0.0,1.0
16409,The Light Thief,112091,0,112091,2011.csv,2011,0.0,1.0
16410,The Running Actress,112088,0,112088,2017.csv,2017,0.0,1.0
16411,How Viktor 'The Garlic' Took Alexey 'The Stud' to the Nursing Home,112071,12954,99117,2017.csv,2017,0.11558744010493348,0.8844125598950665
16412,Monopoly (The Bank of Luck),112037,0,112037,2017.csv,2017,0.0,1.0
16413,Marwencol,112036,112036,0,2010.csv,2010,1.0,0.0
16414,A Chance in the World,112007,112007,0,2018.csv,2018,1.0,0.0
16415,When Animals Dream,111952,0,111952,2014.csv,2014,0.0,1.0
16416,Una noche,111903,100887,11016,2013.csv,2013,0.9015575989919842,0.09844240100801586
16417,My Bebe Love: #KiligPaMore,111808,0,111808,2016.csv,2016,0.0,1.0
16418,Rendel: Dark Vengeance,111795,0,111795,2017.csv,2017,0.0,1.0
16419,Endangered Species,111756,0,111756,2017.csv,2017,0.0,1.0
16420,Saint John of Las Vegas,111731,102645,9086,2010.csv,2010,0.9186796860316295,0.08132031396837046
16421,Taxi Ballad,111686,0,111686,2012.csv,2012,0.0,1.0
16422,1915,111682,111682,0,2015.csv,2015,1.0,0.0
16423,Hard Kill,111523,0,111523,2020.csv,2020,0.0,1.0
16424,The Perfect Wave,111486,0,111486,2014.csv,2014,0.0,1.0
16425,Grigoriy Butlitskiy and Igor Ozornin: Staryi novyi god,111484,0,111484,2020.csv,2020,0.0,1.0
16426,Kanchana 3,111447,0,111447,2019.csv,2019,0.0,1.0
16427,Death Row Family,111443,0,111443,2019.csv,2019,0.0,1.0
16428,Halley's Comet,111411,0,111411,2020.csv,2020,0.0,1.0
16429,Ethel & Ernest,111385,0,111385,2016.csv,2016,0.0,1.0
16430,Rich Hill,111376,111376,0,2014.csv,2014,1.0,0.0
16431,Baby Shower,111351,0,111351,2011.csv,2011,0.0,1.0
16432,Rain: The Flower of Doom,111282,0,111282,2014.csv,2014,0.0,1.0
16433,Backtrack Boys,111273,0,111273,2018.csv,2018,0.0,1.0
16434,Side Effect,111272,0,111272,2020.csv,2020,0.0,1.0
16435,The Honeymoon Suite,111271,0,111271,2020.csv,2020,0.0,1.0
16436,Elevator to the Gallows 2016 Re-release,111267,111267,0,2016.csv,2016,1.0,0.0
16437,Running with the Devil,111218,0,111218,2019.csv,2019,0.0,1.0
16438,"Wild Horse, Wild Ride",111205,111205,0,2012.csv,2012,1.0,0.0
16439,A Paris Education,111197,21598,89599,2018.csv,2018,0.19423185877316834,0.8057681412268317
16440,The Metropolitan Opera HD Live: Mozart: Le nozze di Figaro,111158,0,111158,2014.csv,2014,0.0,1.0
16441,Let the Music Play,111125,0,111125,2015.csv,2015,0.0,1.0
16442,Strangerland,111107,17472,93635,2015.csv,2015,0.15725381839128047,0.8427461816087195
16443,Boquerón,111078,0,111078,2015.csv,2015,0.0,1.0
16444,Runaway from Home,111076,0,111076,2010.csv,2010,0.0,1.0
16445,Ummah - Unter Freunden,111059,0,111059,2013.csv,2013,0.0,1.0
16446,El secreto del medallón de jade,111012,0,111012,2013.csv,2013,0.0,1.0
16447,Predicament,111003,0,111003,2010.csv,2010,0.0,1.0
16448,Gartxot,110955,0,110955,2011.csv,2011,0.0,1.0
16449,Steel Rain 2,110914,0,110914,2020.csv,2020,0.0,1.0
16450,The Obama Effect,110904,110904,0,2012.csv,2012,1.0,0.0
16451,Sov bizinis,110887,0,110887,2011.csv,2011,0.0,1.0
16452,Aa Gaye Munde U.K. De,110868,0,110868,2014.csv,2014,0.0,1.0
16453,Ping-Keu-Pong Ci-Ne-Ma Con-Seo-Teu: Woo-Ju-Dae-Tam-Heom,110861,0,110861,2020.csv,2020,0.0,1.0
16454,The Priest,110855,0,110855,2021.csv,2021,0.0,1.0
16455,Press,110820,0,110820,2011.csv,2011,0.0,1.0
16456,Assassination Games,110784,0,110784,2012.csv,2012,0.0,1.0
16457,Apartment in Athens,110784,0,110784,2012.csv,2012,0.0,1.0
16458,The Overnighters,110763,110763,0,2014.csv,2014,1.0,0.0
16459,Super Teacher,110752,0,110752,2017.csv,2017,0.0,1.0
16460,Duran Duran: Unstaged,110746,110746,0,2014.csv,2014,1.0,0.0
16461,West,110740,0,110740,2014.csv,2014,0.0,1.0
16462,Honey Bee 2: Celebrations,110736,0,110736,2017.csv,2017,0.0,1.0
16463,O Filho Eterno,110693,0,110693,2016.csv,2016,0.0,1.0
16464,Jozi,110666,0,110666,2010.csv,2010,0.0,1.0
16465,Au plus près du soleil,110574,0,110574,2015.csv,2015,0.0,1.0
16466,Kubilay,110543,0,110543,2010.csv,2010,0.0,1.0
16467,Indoo Ki Jawani,110538,0,110538,2020.csv,2020,0.0,1.0
16468,Black Death 2015 Re-release,110434,0,110434,2015.csv,2015,0.0,1.0
16469,Soup Opera,110362,0,110362,2010.csv,2010,0.0,1.0
16470,The Day That Lasted 21 Years,110358,0,110358,2013.csv,2013,0.0,1.0
16471,Kutty,110342,0,110342,2010.csv,2010,0.0,1.0
16472,The Perfect Family,110313,110313,0,2012.csv,2012,1.0,0.0
16473,Miluji te modre,110294,0,110294,2017.csv,2017,0.0,1.0
16474,The Trouble with Terkel,110289,110289,0,2017.csv,2017,1.0,0.0
16475,I Sell Love,110272,0,110272,2014.csv,2014,0.0,1.0
16476,Luna,110142,0,110142,2018.csv,2018,0.0,1.0
16477,Uttama Villain,110119,0,110119,2015.csv,2015,0.0,1.0
16478,West 2015 Re-release,110117,0,110117,2015.csv,2015,0.0,1.0
16479,Jadoo,110073,0,110073,2013.csv,2013,0.0,1.0
16480,Funhouse,110064,0,110064,2020.csv,2020,0.0,1.0
16481,Jirga,110056,0,110056,2018.csv,2018,0.0,1.0
16482,I Am a Soldier,110052,0,110052,2015.csv,2015,0.0,1.0
16483,Roar,110048,110048,0,2015.csv,2015,1.0,0.0
16484,Keloglan,109895,0,109895,2018.csv,2018,0.0,1.0
16485,Best Worst Movie,109895,109895,0,2010.csv,2010,1.0,0.0
16486,Love H2O,109879,0,109879,2015.csv,2015,0.0,1.0
16487,The Poisoning Angel,109862,0,109862,2017.csv,2017,0.0,1.0
16488,Maybe a Love Story,109858,0,109858,2018.csv,2018,0.0,1.0
16489,Death Whisper,109845,0,109845,2019.csv,2019,0.0,1.0
16490,Mortal Affair,109818,0,109818,2016.csv,2016,0.0,1.0
16491,The Fifth Element 2017 Re-release,109786,0,109786,2017.csv,2017,0.0,1.0
16492,1944,109768,0,109768,2015.csv,2015,0.0,1.0
16493,Babylon,109749,109749,0,2019.csv,2019,1.0,0.0
16494,Guard,109723,0,109723,2019.csv,2019,0.0,1.0
16495,Get Outta Here,109716,0,109716,2015.csv,2015,0.0,1.0
16496,Zero Days,109649,109649,0,2016.csv,2016,1.0,0.0
16497,Anohana the Movie: The Flower We Saw That Day (Ano hi mita hana no namae wo bokutachi wa mada shiran,109630,109630,0,2014.csv,2014,1.0,0.0
16498,"Memories to Choke On, Drinks to Wash Them Down",109569,0,109569,2020.csv,2020,0.0,1.0
16499,Very Female Stories,109553,0,109553,2020.csv,2020,0.0,1.0
16500,Eel Squad,109487,0,109487,2019.csv,2019,0.0,1.0
16501,Cameraperson,109464,102033,7431,2016.csv,2016,0.9321146678360008,0.06788533216399913
16502,Wedding Party 2,109459,11140,98319,2017.csv,2017,0.10177326670260098,0.898226733297399
16503,The Unknown Woman,109427,0,109427,2011.csv,2011,0.0,1.0
16504,Blood Done Sign My Name,109383,109383,0,2010.csv,2010,1.0,0.0
16505,Corniche Kennedy,109292,0,109292,2017.csv,2017,0.0,1.0
16506,The End of the Storm,109282,0,109282,2020.csv,2020,0.0,1.0
16507,Barabbas,109275,0,109275,2019.csv,2019,0.0,1.0
16508,Pocket Listing,109245,0,109245,2014.csv,2014,0.0,1.0
16509,The Hatred,109227,0,109227,2019.csv,2019,0.0,1.0
16510,Love Story 2011 Re-release,109219,0,109219,2011.csv,2011,0.0,1.0
16511,As Canções,109193,0,109193,2011.csv,2011,0.0,1.0
16512,Dragon Guardians,109145,0,109145,2013.csv,2013,0.0,1.0
16513,The Disappearance of Eleanor Rigby: Him,109144,0,109144,2014.csv,2014,0.0,1.0
16514,Ares,109143,0,109143,2016.csv,2016,0.0,1.0
16515,And They Call It Summer,109120,0,109120,2012.csv,2012,0.0,1.0
16516,Nul is nie niks nie,109117,0,109117,2017.csv,2017,0.0,1.0
16517,Patrick: Evil Awakens,109056,0,109056,2014.csv,2014,0.0,1.0
16518,Dinotasia Dinosaur Chronicle,108907,0,108907,2019.csv,2019,0.0,1.0
16519,Once Upon a Time in Paradise,108858,0,108858,2016.csv,2016,0.0,1.0
16520,The Lure,108846,101657,7189,2017.csv,2017,0.9339525568234018,0.06604744317659814
16521,Bagdad Cafe 2016 Re-release,108831,0,108831,2016.csv,2016,0.0,1.0
16522,San Valentino Stories,108819,0,108819,2018.csv,2018,0.0,1.0
16523,Adult Beginners,108808,108808,0,2015.csv,2015,1.0,0.0
16524,Producer,108739,0,108739,2019.csv,2019,0.0,1.0
16525,Sworn Virgin,108681,4636,104045,2015.csv,2015,0.042656950156881146,0.9573430498431188
16526,Maan Karate,108599,0,108599,2014.csv,2014,0.0,1.0
16527,The Venice Syndrome,108575,0,108575,2012.csv,2012,0.0,1.0
16528,Getaway of Love,108489,0,108489,2015.csv,2015,0.0,1.0
16529,The Metropolitan Opera HD Live: Rossini: La Cenerentola,108435,0,108435,2014.csv,2014,0.0,1.0
16530,"I Am Nojoom, Age 10 and Divorced",108396,0,108396,2016.csv,2016,0.0,1.0
16531,Red Sorghum,108371,0,108371,2018.csv,2018,0.0,1.0
16532,Friday Killer,108295,0,108295,2011.csv,2011,0.0,1.0
16533,La résistance de l'air,108232,0,108232,2015.csv,2015,0.0,1.0
16534,Mindfulness and Murder,108202,0,108202,2011.csv,2011,0.0,1.0
16535,Violet & Daisy,108139,17186,90953,2013.csv,2013,0.15892508715634507,0.8410749128436549
16536,Bettie Page Reveals All,108118,108118,0,2013.csv,2013,1.0,0.0
16537,Boonie Bears: Robo-Rumble,108097,0,108097,2017.csv,2017,0.0,1.0
16538,MULT v kino. Vol 117,108067,0,108067,2020.csv,2020,0.0,1.0
16539,The Metropolitan Opera HD Live: Verdi: La Traviata,108039,0,108039,2012.csv,2012,0.0,1.0
16540,Il mio uomo perfetto,107993,0,107993,2018.csv,2018,0.0,1.0
16541,Aby,107969,0,107969,2017.csv,2017,0.0,1.0
16542,The Metropolitan Opera HD Live: Verdi: Ernani,107947,0,107947,2012.csv,2012,0.0,1.0
16543,"Love, Cecil",107940,106057,1883,2017.csv,2017,0.9825551232166018,0.017444876783398185
16544,Shining Star: The Birth of New Luna-Queen,107869,0,107869,2019.csv,2019,0.0,1.0
16545,Tempête,107849,0,107849,2016.csv,2016,0.0,1.0
16546,Velayudham,107843,0,107843,2011.csv,2011,0.0,1.0
16547,Solutions locales pour un désordre global,107831,0,107831,2010.csv,2010,0.0,1.0
16548,Big Bang Show 2010,107801,0,107801,2011.csv,2011,0.0,1.0
16549,Zhang Yimou's: Shadow,107787,0,107787,2018.csv,2018,0.0,1.0
16550,A Distant Neighbourhood,107764,0,107764,2010.csv,2010,0.0,1.0
16551,Bloody Reunion 2010 Re-release,107736,0,107736,2010.csv,2010,0.0,1.0
16552,A Perfectly Normal Family,107733,0,107733,2020.csv,2020,0.0,1.0
16553,The Swan Princess: Royally Undercover,107721,0,107721,2017.csv,2017,0.0,1.0
16554,Circle of Crime,107688,0,107688,2012.csv,2012,0.0,1.0
16555,Vijay and I,107687,0,107687,2013.csv,2013,0.0,1.0
16556,Tormented 2010 Re-release,107673,0,107673,2010.csv,2010,0.0,1.0
16557,Cult,107670,0,107670,2014.csv,2014,0.0,1.0
16558,Kidnapping of Michel Houellebecq,107641,11546,96095,2014.csv,2014,0.10726396075844706,0.892736039241553
16559,The Mortuary Collection,107629,0,107629,2020.csv,2020,0.0,1.0
16560,Au bistro du coin,107618,0,107618,2011.csv,2011,0.0,1.0
16561,"Yo, mi mujer y mi mujer muerta",107576,0,107576,2019.csv,2019,0.0,1.0
16562,Afsar,107548,0,107548,2018.csv,2018,0.0,1.0
16563,Shadow Country,107493,0,107493,2020.csv,2020,0.0,1.0
16564,Becks letzter Sommer,107469,0,107469,2015.csv,2015,0.0,1.0
16565,Revenge of the Green Dragons,107412,0,107412,2014.csv,2014,0.0,1.0
16566,"No Date, No Signature",107368,36444,70924,2018.csv,2018,0.3394307428656583,0.6605692571343417
16567,Cockneys vs Zombies,107348,0,107348,2012.csv,2012,0.0,1.0
16568,Ways Into Love,107306,0,107306,2015.csv,2015,0.0,1.0
16569,Taj Mahal,107305,0,107305,2015.csv,2015,0.0,1.0
16570,Lo que tiene el otro,107296,0,107296,2013.csv,2013,0.0,1.0
16571,The Portuguese Falcon,107279,0,107279,2015.csv,2015,0.0,1.0
16572,Despite the Falling Snow,107257,0,107257,2016.csv,2016,0.0,1.0
16573,The Unknown Saint,107234,0,107234,2020.csv,2020,0.0,1.0
16574,The Kwicky Koala Show: Scream Test/The Big Bang/Flipped Out/Bucking Bull/Old Blowhard/Little White Lie,107213,0,107213,2016.csv,2016,0.0,1.0
16575,Path to the Dream,107199,0,107199,2018.csv,2018,0.0,1.0
16576,Attack on Titan: The Roar of Awakening,107155,0,107155,2018.csv,2018,0.0,1.0
16577,Eclipse,107139,0,107139,2016.csv,2016,0.0,1.0
16578,National Theatre Live: Julius Caesar,107057,107057,0,2018.csv,2018,1.0,0.0
16579,Micimutr,107040,0,107040,2011.csv,2011,0.0,1.0
16580,Varene iz sakury 2011 Re-release,107029,0,107029,2011.csv,2011,0.0,1.0
16581,Jeruzalem,107024,11287,95737,2016.csv,2016,0.10546232620720586,0.8945376737927941
16582,Best Worst Thing That Ever Could Have Happened,106986,106986,0,2016.csv,2016,1.0,0.0
16583,Nicky's Family,106974,0,106974,2011.csv,2011,0.0,1.0
16584,Fear Clinic,106974,0,106974,2015.csv,2015,0.0,1.0
16585,The Lord of the Rings: The Return of the King 2021 Re-release,106953,0,106953,2021.csv,2021,0.0,1.0
16586,In Their Skin,106919,0,106919,2013.csv,2013,0.0,1.0
16587,Reckless,106914,0,106914,2018.csv,2018,0.0,1.0
16588,Shades Of The Heart,106897,0,106897,2021.csv,2021,0.0,1.0
16589,Couples' Night,106875,0,106875,2019.csv,2019,0.0,1.0
16590,The Tales of Hoffmann,106860,91930,14930,2015.csv,2015,0.8602844843720756,0.1397155156279244
16591,Never Grow Old,106796,0,106796,2019.csv,2019,0.0,1.0
16592,The Ignorance of Blood,106784,0,106784,2014.csv,2014,0.0,1.0
16593,Ivory Tower,106771,106771,0,2014.csv,2014,1.0,0.0
16594,Vita Activa: The Spirit of Hannah Arendt,106768,82143,24625,2016.csv,2016,0.7693597332534092,0.23064026674659074
16595,The House on Pine Street,106745,0,106745,2016.csv,2016,0.0,1.0
16596,While She Was Out 2011 Re-release,106678,0,106678,2011.csv,2011,0.0,1.0
16597,7 Years: Journalism Without Journalists,106665,0,106665,2017.csv,2017,0.0,1.0
16598,Seed 2010 Re-release,106652,0,106652,2010.csv,2010,0.0,1.0
16599,A Night at the Louvre: Leonardo da Vinci,106624,0,106624,2020.csv,2020,0.0,1.0
16600,The Girl in the Sun 2019 Re-release,106623,0,106623,2019.csv,2019,0.0,1.0
16601,Myths and Legends: The New Alliance,106569,0,106569,2010.csv,2010,0.0,1.0
16602,The Metropolitan Opera HD Live: Mozart: La clemenza di Tito,106541,0,106541,2012.csv,2012,0.0,1.0
16603,Gang of the Caribbean,106526,0,106526,2016.csv,2016,0.0,1.0
16604,My Friends,106510,0,106510,2016.csv,2016,0.0,1.0
16605,Dekalog 2016 Re-release,106494,106494,0,2016.csv,2016,1.0,0.0
16606,Bene ma non benissimo,106490,0,106490,2019.csv,2019,0.0,1.0
16607,Wrong,106425,46021,60404,2012.csv,2012,0.4324265914963589,0.567573408503641
16608,The Charmer,106379,26167,80212,2018.csv,2018,0.24597899961458558,0.7540210003854144
16609,Redemption Day,106365,0,106365,2021.csv,2021,0.0,1.0
16610,Black Water 2011 Re-release,106364,0,106364,2011.csv,2011,0.0,1.0
16611,Sorry Mom,106364,0,106364,2011.csv,2011,0.0,1.0
16612,Qosty Byogaani,106359,0,106359,2018.csv,2018,0.0,1.0
16613,Six Dance Lessons in Six Weeks,106323,106323,0,2014.csv,2014,1.0,0.0
16614,Escape 2014 Re-release,106320,0,106320,2014.csv,2014,0.0,1.0
16615,Mama Africa,106319,0,106319,2011.csv,2011,0.0,1.0
16616,Jazzy Misfits,106265,0,106265,2020.csv,2020,0.0,1.0
16617,Raketeros,106256,0,106256,2013.csv,2013,0.0,1.0
16618,Sardar Mohammad,106243,0,106243,2017.csv,2017,0.0,1.0
16619,iGirl,106234,0,106234,2016.csv,2016,0.0,1.0
16620,The Bachelors,106212,0,106212,2017.csv,2017,0.0,1.0
16621,Elliot the Littlest Reindeer 2020 Re-release,106199,0,106199,2020.csv,2020,0.0,1.0
16622,Double Identity,106149,0,106149,2010.csv,2010,0.0,1.0
16623,For the Ones We Loved,106143,0,106143,2019.csv,2019,0.0,1.0
16624,National Theatre Live: Macbeth,106136,97857,8279,2018.csv,2018,0.9219963066254617,0.07800369337453833
16625,Amanhã Nunca Mais,106117,0,106117,2011.csv,2011,0.0,1.0
16626,Cin-i ayet,106094,0,106094,2018.csv,2018,0.0,1.0
16627,BoBoiBoy: The Movie,106066,0,106066,2017.csv,2017,0.0,1.0
16628,Hana's Miso Soup,106058,0,106058,2016.csv,2016,0.0,1.0
16629,The Brink,106057,106057,0,2019.csv,2019,1.0,0.0
16630,Lost Girls and Love Hotels,106045,0,106045,2020.csv,2020,0.0,1.0
16631,No Tomorrow,106019,0,106019,2016.csv,2016,0.0,1.0
16632,A Flying Jatt,106015,0,106015,2016.csv,2016,0.0,1.0
16633,The Metropolitan Opera HD Live: Mascagni: Cavalleria Rusticana/Leoncavallo: Pagliacci,106012,0,106012,2015.csv,2015,0.0,1.0
16634,Big Star: Nothing Can Hurt Me,105998,105998,0,2013.csv,2013,1.0,0.0
16635,"Loenatik, te gek!",105960,0,105960,2014.csv,2014,0.0,1.0
16636,Konusan Hayvanlar,105959,0,105959,2019.csv,2019,0.0,1.0
16637,A French Woman,105938,0,105938,2020.csv,2020,0.0,1.0
16638,Shubharathri,105932,0,105932,2019.csv,2019,0.0,1.0
16639,Miss Juneteenth,105908,92349,13559,2020.csv,2020,0.8719737885712128,0.12802621142878726
16640,Araf 3: Cinler Kitabi,105884,0,105884,2019.csv,2019,0.0,1.0
16641,No Turning Back,105842,0,105842,2015.csv,2015,0.0,1.0
16642,Lawrence of Arabia 2012 Re-release,105752,0,105752,2012.csv,2012,0.0,1.0
16643,Before the Wrath,105697,0,105697,2020.csv,2020,0.0,1.0
16644,Jesus Christ Superstar,105659,0,105659,2012.csv,2012,0.0,1.0
16645,Revenge: A Love Story,105638,0,105638,2010.csv,2010,0.0,1.0
16646,Love and Bruises,105592,0,105592,2011.csv,2011,0.0,1.0
16647,Come saltano i pesci,105570,0,105570,2016.csv,2016,0.0,1.0
16648,Shin Godzilla 2019 Re-release,105538,0,105538,2019.csv,2019,0.0,1.0
16649,Peggy Sue Got Married 2020 Re-release,105507,0,105507,2020.csv,2020,0.0,1.0
16650,Crush,105473,0,105473,2013.csv,2013,0.0,1.0
16651,The Roads Not Taken,105439,3518,101921,2020.csv,2020,0.03336526332761122,0.9666347366723888
16652,Cinema Paradiso 2018 Re-release,105418,0,105418,2018.csv,2018,0.0,1.0
16653,Locos por la herencia,105412,0,105412,2019.csv,2019,0.0,1.0
16654,Rat Fever,105367,0,105367,2012.csv,2012,0.0,1.0
16655,Histoire d'un regard,105276,0,105276,2020.csv,2020,0.0,1.0
16656,Zed Plus,105274,0,105274,2014.csv,2014,0.0,1.0
16657,Never Heard,105271,105271,0,2018.csv,2018,1.0,0.0
16658,The Last Recipe: Memory of Giraffe's Tongue 2019 Re-release,105224,0,105224,2019.csv,2019,0.0,1.0
16659,Hablar,105201,0,105201,2015.csv,2015,0.0,1.0
16660,One Step Behind the Seraphim,105176,0,105176,2017.csv,2017,0.0,1.0
16661,Ode to the Goose,105108,0,105108,2018.csv,2018,0.0,1.0
16662,Born Racer,105085,0,105085,2018.csv,2018,0.0,1.0
16663,Afrika na Pionieri,105027,0,105027,2019.csv,2019,0.0,1.0
16664,6.9 on the Richter Scale,105000,0,105000,2017.csv,2017,0.0,1.0
16665,In the Underground,104992,0,104992,2018.csv,2018,0.0,1.0
16666,Cold Case Hammarskjöld,104965,104965,0,2019.csv,2019,1.0,0.0
16667,La banda Picasso,104894,0,104894,2013.csv,2013,0.0,1.0
16668,The Metropolitan Opera HD Live,104850,0,104850,2014.csv,2014,0.0,1.0
16669,Ovunque tu sarai,104839,0,104839,2017.csv,2017,0.0,1.0
16670,A Ciambra,104808,41934,62874,2017.csv,2017,0.4001030455690405,0.5998969544309595
16671,Prince,104807,0,104807,2016.csv,2016,0.0,1.0
16672,Abdu Mouta,104787,0,104787,2012.csv,2012,0.0,1.0
16673,The Terminator 2015 Re-release,104771,0,104771,2015.csv,2015,0.0,1.0
16674,Fatal Visit,104759,0,104759,2020.csv,2020,0.0,1.0
16675,Lima 13,104758,0,104758,2012.csv,2012,0.0,1.0
16676,Singam Puli,104740,0,104740,2011.csv,2011,0.0,1.0
16677,Dictator,104734,104734,0,2016.csv,2016,1.0,0.0
16678,Gold,104688,0,104688,2013.csv,2013,0.0,1.0
16679,Don't Blink,104549,0,104549,2015.csv,2015,0.0,1.0
16680,Misunderstood,104534,0,104534,2014.csv,2014,0.0,1.0
16681,Band Baaja Baaraat,104532,43820,60712,2010.csv,2010,0.4192017755328512,0.5807982244671488
16682,Results,104507,104507,0,2015.csv,2015,1.0,0.0
16683,Bennesbeh Labokra Chou,104305,0,104305,2016.csv,2016,0.0,1.0
16684,Gutian Conference,104270,0,104270,2016.csv,2016,0.0,1.0
16685,Mimosas,104243,0,104243,2016.csv,2016,0.0,1.0
16686,Masha's Songs,104236,0,104236,2020.csv,2020,0.0,1.0
16687,The Loved Ones 2012 Re-release,104229,0,104229,2012.csv,2012,0.0,1.0
16688,Notes on Blindness,104214,0,104214,2016.csv,2016,0.0,1.0
16689,Evangeline,104194,0,104194,2015.csv,2015,0.0,1.0
16690,4 Days in May,104191,0,104191,2011.csv,2011,0.0,1.0
16691,Rangoon,104174,0,104174,2017.csv,2017,0.0,1.0
16692,Kannum Kannum Kollaiyadithaal,104155,0,104155,2020.csv,2020,0.0,1.0
16693,"The Butcher, the Whore and the One-Eyed Man",104140,0,104140,2018.csv,2018,0.0,1.0
16694,16 Sunrises,104117,0,104117,2018.csv,2018,0.0,1.0
16695,Mörkt vatten,104092,0,104092,2012.csv,2012,0.0,1.0
16696,"Salaud, on t'aime. 2017 Re-release",104057,0,104057,2017.csv,2017,0.0,1.0
16697,Heavenly Being with You,104041,0,104041,2019.csv,2019,0.0,1.0
16698,Demon,104038,104038,0,2016.csv,2016,1.0,0.0
16699,Ouija House,104036,0,104036,2018.csv,2018,0.0,1.0
16700,Sid & Aya: Not a Love Story,104030,0,104030,2018.csv,2018,0.0,1.0
16701,We 3,104012,0,104012,2011.csv,2011,0.0,1.0
16702,Play,103990,0,103990,2011.csv,2011,0.0,1.0
16703,Memories of the Wind,103975,0,103975,2015.csv,2015,0.0,1.0
16704,Prevenge,103885,0,103885,2017.csv,2017,0.0,1.0
16705,Na oshchup,103849,0,103849,2010.csv,2010,0.0,1.0
16706,Gise Memuru,103821,0,103821,2011.csv,2011,0.0,1.0
16707,Spasibo dedu za pobedu,103820,0,103820,2019.csv,2019,0.0,1.0
16708,The Disappearance of Eleanor Rigby: Her,103815,0,103815,2014.csv,2014,0.0,1.0
16709,Adult Life Skills,103810,0,103810,2016.csv,2016,0.0,1.0
16710,"Garabandal, Only God Knows",103775,0,103775,2019.csv,2019,0.0,1.0
16711,The Metropolitan Opera HD Live: Verdi: Falstaff,103764,0,103764,2014.csv,2014,0.0,1.0
16712,The Investigator,103739,103739,0,2013.csv,2013,1.0,0.0
16713,Doctor Who: Twice Upon a Time,103709,0,103709,2017.csv,2017,0.0,1.0
16714,Love Steaks,103705,0,103705,2014.csv,2014,0.0,1.0
16715,Luna caliente,103679,0,103679,2010.csv,2010,0.0,1.0
16716,Parahuna,103583,0,103583,2018.csv,2018,0.0,1.0
16717,Big Fortune Hotel,103561,0,103561,2015.csv,2015,0.0,1.0
16718,Pilgrim Hill,103519,0,103519,2013.csv,2013,0.0,1.0
16719,Pivnica,103509,0,103509,2018.csv,2018,0.0,1.0
16720,From Japan to Egypt,103468,0,103468,2017.csv,2017,0.0,1.0
16721,Edge of the Empire,103432,0,103432,2010.csv,2010,0.0,1.0
16722,The Pirates of Somalia,103385,0,103385,2017.csv,2017,0.0,1.0
16723,Kalakalappu 2,103349,0,103349,2018.csv,2018,0.0,1.0
16724,Samij luchij denj,103331,0,103331,2015.csv,2015,0.0,1.0
16725,Anton Chekhov's The Duel,103295,0,103295,2012.csv,2012,0.0,1.0
16726,Nomer Odin,103202,0,103202,2020.csv,2020,0.0,1.0
16727,Calm with Horses,103162,0,103162,2020.csv,2020,0.0,1.0
16728,Takiye: Allah yolunda,103104,0,103104,2010.csv,2010,0.0,1.0
16729,Ala Vykuntapurram Loo,103082,0,103082,2020.csv,2020,0.0,1.0
16730,Perkins' 14,103054,0,103054,2010.csv,2010,0.0,1.0
16731,Stevie Nicks: In Your Dreams,103028,103028,0,2013.csv,2013,1.0,0.0
16732,Paradise Trips,102994,0,102994,2015.csv,2015,0.0,1.0
16733,Bolshoi Ballet: Raymonda,102959,0,102959,2019.csv,2019,0.0,1.0
16734,Puerto Ricans in Paris,102890,102890,0,2016.csv,2016,1.0,0.0
16735,Brake,102819,4876,97943,2012.csv,2012,0.047423141637246036,0.952576858362754
16736,Hockney 2019 Re-release,102753,0,102753,2019.csv,2019,0.0,1.0
16737,La despedida,102717,0,102717,2010.csv,2010,0.0,1.0
16738,Tawai: A Voice from the Forest,102701,0,102701,2017.csv,2017,0.0,1.0
16739,Sadko 2019 Re-release,102664,0,102664,2019.csv,2019,0.0,1.0
16740,Uno anzi due,102661,0,102661,2015.csv,2015,0.0,1.0
16741,Stella Days,102661,0,102661,2012.csv,2012,0.0,1.0
16742,Number 37,102657,0,102657,2018.csv,2018,0.0,1.0
16743,Somebody to Love 2014 Re-release,102648,0,102648,2014.csv,2014,0.0,1.0
16744,Strike a Pose,102610,0,102610,2016.csv,2016,0.0,1.0
16745,Company,102591,0,102591,2012.csv,2012,0.0,1.0
16746,Vay Basima Gelenler! 2 Buçuk,102533,0,102533,2014.csv,2014,0.0,1.0
16747,Spirited Away 2015 Re-release,102480,0,102480,2015.csv,2015,0.0,1.0
16748,The Furies,102428,0,102428,2016.csv,2016,0.0,1.0
16749,The Christmas Family 2,102400,0,102400,2016.csv,2016,0.0,1.0
16750,Dégradé,102395,0,102395,2016.csv,2016,0.0,1.0
16751,Once Upon a Time in Mumbaai,102382,0,102382,2010.csv,2010,0.0,1.0
16752,Mukhtiar Chadha,102365,0,102365,2015.csv,2015,0.0,1.0
16753,Before Sunrise,102348,0,102348,2016.csv,2016,0.0,1.0
16754,Villmarksbarna - En eventyrlig reise,102337,0,102337,2019.csv,2019,0.0,1.0
16755,The Accidental Prime Minister,102300,0,102300,2019.csv,2019,0.0,1.0
16756,Trainspotting 2017 Re-release,102276,0,102276,2017.csv,2017,0.0,1.0
16757,Toiretto,102273,0,102273,2010.csv,2010,0.0,1.0
16758,The Gracefield Incident,102256,0,102256,2017.csv,2017,0.0,1.0
16759,Zwischen Himmel und Erde. Anthroposophie heute 2012 Re-release,102232,0,102232,2012.csv,2012,0.0,1.0
16760,Tanna,102225,46654,55571,2016.csv,2016,0.45638542430912205,0.543614575690878
16761,"Snowflake, the White Gorilla 2017 Re-release",102214,0,102214,2017.csv,2017,0.0,1.0
16762,Ekk Deewana Tha,102181,0,102181,2012.csv,2012,0.0,1.0
16763,Odnoy levoy,102167,0,102167,2015.csv,2015,0.0,1.0
16764,"My Fathers, My Mother and Me",102120,0,102120,2013.csv,2013,0.0,1.0
16765,Gelmeyen Bahar,102095,0,102095,2013.csv,2013,0.0,1.0
16766,Attabu 2,102054,0,102054,2015.csv,2015,0.0,1.0
16767,Egg Plan 2018 Re-release,102030,0,102030,2018.csv,2018,0.0,1.0
16768,Save Your Soul,102030,0,102030,2019.csv,2019,0.0,1.0
16769,Andrei Rublev 2018 Re-release,102021,102021,0,2018.csv,2018,1.0,0.0
16770,Becoming Traviata,102015,62652,39363,2013.csv,2013,0.6141449786796059,0.38585502132039406
16771,My Bromance,102015,0,102015,2014.csv,2014,0.0,1.0
16772,About a Girl,102011,0,102011,2015.csv,2015,0.0,1.0
16773,Tower,101987,101987,0,2016.csv,2016,1.0,0.0
16774,And So It Goes 2016 Re-release,101976,0,101976,2016.csv,2016,0.0,1.0
16775,Undercurrent,101961,0,101961,2010.csv,2010,0.0,1.0
16776,Vic the Viking,101949,0,101949,2020.csv,2020,0.0,1.0
16777,Harry Potter and the Deathly Hallows: Part 2 2016 Re-release,101935,0,101935,2016.csv,2016,0.0,1.0
16778,In the Family,101934,101934,0,2011.csv,2011,1.0,0.0
16779,Hotel by the River,101879,28354,73525,2019.csv,2019,0.2783105448620422,0.7216894551379578
16780,Search for Paradise,101879,0,101879,2010.csv,2010,0.0,1.0
16781,Trouvoete,101846,0,101846,2015.csv,2015,0.0,1.0
16782,Truenos,101818,0,101818,2017.csv,2017,0.0,1.0
16783,Kill Me Three Times,101807,24296,77511,2015.csv,2015,0.23864763719587062,0.7613523628041294
16784,Brave Father Online: Our Story of Final Fantasy XIV,101796,0,101796,2019.csv,2019,0.0,1.0
16785,Magnus,101739,8944,92795,2016.csv,2016,0.08791122381780832,0.9120887761821916
16786,Those Who Remained,101737,0,101737,2019.csv,2019,0.0,1.0
16787,Rubber,101729,100370,1359,2011.csv,2011,0.9866409774990416,0.01335902250095843
16788,Kickboxer: Retaliation,101690,4537,97153,2018.csv,2018,0.044615989772839024,0.955384010227161
16789,Glass Garden,101686,0,101686,2017.csv,2017,0.0,1.0
16790,LOVE by CHANCE,101683,0,101683,2017.csv,2017,0.0,1.0
16791,The Door,101578,0,101578,2019.csv,2019,0.0,1.0
16792,Clubbing,101542,0,101542,2011.csv,2011,0.0,1.0
16793,A Lego Brickumentary,101531,101531,0,2015.csv,2015,1.0,0.0
16794,Blazing Saddles 2013 Re-release,101481,101481,0,2013.csv,2013,1.0,0.0
16795,The Way 2019 Re-release,101446,0,101446,2019.csv,2019,0.0,1.0
16796,Man from Reno,101438,101438,0,2015.csv,2015,1.0,0.0
16797,Mis Peludos Angelitos,101373,0,101373,2016.csv,2016,0.0,1.0
16798,A Ghost of a Chance 2012 Re-release,101373,0,101373,2012.csv,2012,0.0,1.0
16799,James White,101368,101368,0,2015.csv,2015,1.0,0.0
16800,Oru Nalla Naal Paathu Solren,101358,0,101358,2018.csv,2018,0.0,1.0
16801,QT8: The First Eight,101346,51896,49450,2019.csv,2019,0.5120675705010558,0.4879324294989442
16802,Three Weddings,101339,0,101339,2016.csv,2016,0.0,1.0
16803,8th Wonderland,101333,0,101333,2010.csv,2010,0.0,1.0
16804,Before Your Eyes,101327,0,101327,2010.csv,2010,0.0,1.0
16805,The Dark Knight Rises 2020 Re-release,101325,0,101325,2020.csv,2020,0.0,1.0
16806,Korengal,101310,101310,0,2014.csv,2014,1.0,0.0
16807,End of the Century,101301,66309,34992,2019.csv,2019,0.6545739923594042,0.34542600764059583
16808,One Last Deal,101247,0,101247,2019.csv,2019,0.0,1.0
16809,Feed the Fish,101170,101170,0,2010.csv,2010,1.0,0.0
16810,Goodbye Morocco,101139,0,101139,2013.csv,2013,0.0,1.0
16811,Secreto De Confesion,101084,0,101084,2014.csv,2014,0.0,1.0
16812,Miracle,101080,0,101080,2017.csv,2017,0.0,1.0
16813,Beyond Sight: The Derek Rabelo Story,101074,101074,0,2014.csv,2014,1.0,0.0
16814,First Cow,101068,101068,0,2020.csv,2020,1.0,0.0
16815,LKG,101032,0,101032,2019.csv,2019,0.0,1.0
16816,Losers,100903,0,100903,2015.csv,2015,0.0,1.0
16817,The Stand In,100884,0,100884,2020.csv,2020,0.0,1.0
16818,Hermosa juventud,100821,0,100821,2014.csv,2014,0.0,1.0
16819,Ali Baba,100727,0,100727,2018.csv,2018,0.0,1.0
16820,The Good Guy,100688,100688,0,2010.csv,2010,1.0,0.0
16821,Going West,100670,0,100670,2018.csv,2018,0.0,1.0
16822,Our Friend 2021 Re-release,100668,0,100668,2021.csv,2021,0.0,1.0
16823,Trót Yêu,100602,0,100602,2015.csv,2015,0.0,1.0
16824,The Godfather: Part II 2010 Re-release,100594,0,100594,2010.csv,2010,0.0,1.0
16825,Odiyan,100577,0,100577,2018.csv,2018,0.0,1.0
16826,Twinsters,100575,0,100575,2016.csv,2016,0.0,1.0
16827,Collective,100529,0,100529,2020.csv,2020,0.0,1.0
16828,The Man Who Fell to Earth,100468,100072,396,2011.csv,2011,0.996058446470518,0.003941553529482024
16829,The United States of Autism,100403,100403,0,2013.csv,2013,1.0,0.0
16830,One Track Heart: The Story of Krishna Das,100401,100401,0,2013.csv,2013,1.0,0.0
16831,Punane elavhõbe,100354,0,100354,2010.csv,2010,0.0,1.0
16832,Bringing Tibet Home,100336,0,100336,2016.csv,2016,0.0,1.0
16833,All About Nina,100335,100335,0,2018.csv,2018,1.0,0.0
16834,Safer at Home,100323,95643,4680,2021.csv,2021,0.9533506773122813,0.04664932268771867
16835,The Widowed Witch,100318,0,100318,2018.csv,2018,0.0,1.0
16836,8: The Mormon Proposition,100280,100280,0,2010.csv,2010,1.0,0.0
16837,Rejoice and Shout,100237,100237,0,2011.csv,2011,1.0,0.0
16838,Secuestro 2018 Re-release,100228,0,100228,2018.csv,2018,0.0,1.0
16839,Bhutto,100202,100202,0,2010.csv,2010,1.0,0.0
16840,Tiro libero,100178,0,100178,2017.csv,2017,0.0,1.0
16841,Prati Roju Pandaage,100173,0,100173,2019.csv,2019,0.0,1.0
16842,Chaal Jeevi Laiye,100113,0,100113,2019.csv,2019,0.0,1.0
16843,Shimajirou the Movie: Great Adventure on Magic Island,100092,0,100092,2018.csv,2018,0.0,1.0
16844,"Policeman from Rublyovka, New Year's Lawlessness",100054,0,100054,2019.csv,2019,0.0,1.0
16845,Rosita,99994,0,99994,2015.csv,2015,0.0,1.0
16846,Amazona,99990,0,99990,2017.csv,2017,0.0,1.0
16847,Something Good,99978,0,99978,2013.csv,2013,0.0,1.0
16848,The von Trapp Family: A Life of Music,99967,0,99967,2015.csv,2015,0.0,1.0
16849,Jiu Jitsu,99924,0,99924,2020.csv,2020,0.0,1.0
16850,Inna De Yard,99914,0,99914,2019.csv,2019,0.0,1.0
16851,6 Bullets,99861,0,99861,2013.csv,2013,0.0,1.0
16852,Love Comes Lately 2011 Re-release,99742,0,99742,2011.csv,2011,0.0,1.0
16853,Dark Heaven,99720,0,99720,2012.csv,2012,0.0,1.0
16854,The Boy in the Mirror,99697,0,99697,2014.csv,2014,0.0,1.0
16855,Live,99695,0,99695,2020.csv,2020,0.0,1.0
16856,The Family,99673,0,99673,2018.csv,2018,0.0,1.0
16857,Life's a Breeze,99668,0,99668,2013.csv,2013,0.0,1.0
16858,White Lion,99635,0,99635,2010.csv,2010,0.0,1.0
16859,Closeness,99610,0,99610,2017.csv,2017,0.0,1.0
16860,Papi Chulo,99546,84703,14843,2019.csv,2019,0.8508930544672815,0.14910694553271855
16861,Dancing Dreams,99533,0,99533,2010.csv,2010,0.0,1.0
16862,Tom und Hacke,99518,0,99518,2012.csv,2012,0.0,1.0
16863,Camera,99511,0,99511,2018.csv,2018,0.0,1.0
16864,Heavy Water,99503,55446,44057,2019.csv,2019,0.5572294302684341,0.44277056973156587
16865,"Isoroku Yamamoto, the Commander-in-Chief of the Combined Fleet 2014 Re-release",99492,0,99492,2014.csv,2014,0.0,1.0
16866,Meow Wolf: Origin Story,99488,99488,0,2018.csv,2018,1.0,0.0
16867,Son épouse,99484,0,99484,2014.csv,2014,0.0,1.0
16868,The Skeptic 2010 Re-release,99457,0,99457,2010.csv,2010,0.0,1.0
16869,Qarmat Beyitmarmat,99408,0,99408,2019.csv,2019,0.0,1.0
16870,Barcelona 1714,99372,0,99372,2019.csv,2019,0.0,1.0
16871,Citizen Roh,99336,0,99336,2019.csv,2019,0.0,1.0
16872,Eaten by Lions,99276,0,99276,2019.csv,2019,0.0,1.0
16873,Kings of the Evening,99270,99270,0,2010.csv,2010,1.0,0.0
16874,Wise Children,99194,0,99194,2019.csv,2019,0.0,1.0
16875,45 Minutes to Ramallah,99044,0,99044,2013.csv,2013,0.0,1.0
16876,Stuur groete aan Mannetjies Roux,99037,0,99037,2013.csv,2013,0.0,1.0
16877,Six Shooters,98966,0,98966,2011.csv,2011,0.0,1.0
16878,The Story of Racheltjie De Beer,98963,0,98963,2019.csv,2019,0.0,1.0
16879,Mafia: Chapter 1,98941,0,98941,2020.csv,2020,0.0,1.0
16880,Cemetery of Splendor,98932,51950,46982,2015.csv,2015,0.5251081550964298,0.4748918449035701
16881,La pelle dell'orso,98890,0,98890,2016.csv,2016,0.0,1.0
16882,Food and Shelter,98734,0,98734,2015.csv,2015,0.0,1.0
16883,Prey 2019 Re-release,98676,0,98676,2019.csv,2019,0.0,1.0
16884,Only You,98669,0,98669,2019.csv,2019,0.0,1.0
16885,Kanarie,98665,0,98665,2018.csv,2018,0.0,1.0
16886,Ghost Father,98619,0,98619,2019.csv,2019,0.0,1.0
16887,The Boat,98559,0,98559,2019.csv,2019,0.0,1.0
16888,Hooperz,98547,0,98547,2010.csv,2010,0.0,1.0
16889,High Strung Free Dance 2019 Re-release,98481,83891,14590,2019.csv,2019,0.8518495953534184,0.14815040464658158
16890,Aida's Secrets,98468,98468,0,2017.csv,2017,1.0,0.0
16891,Taipei Exchanges,98451,0,98451,2010.csv,2010,0.0,1.0
16892,The Village of Shadows,98437,0,98437,2011.csv,2011,0.0,1.0
16893,Reign of Judges: Title of Liberty - Concept Short,98408,93224,5184,2018.csv,2018,0.9473213559873181,0.052678644012681894
16894,Casino.sk,98336,0,98336,2019.csv,2019,0.0,1.0
16895,Pianists Street,98327,0,98327,2015.csv,2015,0.0,1.0
16896,Blind,98280,12522,85758,2017.csv,2017,0.1274114774114774,0.8725885225885226
16897,Gadaar: The Traitor,98262,0,98262,2015.csv,2015,0.0,1.0
16898,Charlie Says,98240,40685,57555,2019.csv,2019,0.41413884364820847,0.5858611563517915
16899,Asylum Blackout,98201,0,98201,2012.csv,2012,0.0,1.0
16900,2001: A Space Odyssey 2017 Re-release,98147,0,98147,2017.csv,2017,0.0,1.0
16901,The Kiss Addict,98143,0,98143,2018.csv,2018,0.0,1.0
16902,Jazz the Dog,98105,0,98105,2017.csv,2017,0.0,1.0
16903,A Long Goodbye,98096,0,98096,2019.csv,2019,0.0,1.0
16904,Non è vero ma ci credo,98083,0,98083,2018.csv,2018,0.0,1.0
16905,Midnight Record Search,98027,0,98027,2016.csv,2016,0.0,1.0
16906,From the Vine,97995,0,97995,2021.csv,2021,0.0,1.0
16907,The Great Gilly Hopkins,97798,0,97798,2016.csv,2016,0.0,1.0
16908,Father of Invention,97778,0,97778,2011.csv,2011,0.0,1.0
16909,Tim Timmerman: Hope of America,97727,97727,0,2017.csv,2017,1.0,0.0
16910,My Hindu Friend,97713,0,97713,2016.csv,2016,0.0,1.0
16911,The Here After,97699,0,97699,2015.csv,2015,0.0,1.0
16912,Babamin Ceketi,97677,0,97677,2018.csv,2018,0.0,1.0
16913,Cinayet-i Ask,97628,0,97628,2017.csv,2017,0.0,1.0
16914,Cracks in the Shell,97594,0,97594,2012.csv,2012,0.0,1.0
16915,Phoenix Forgotten 2018 Re-release,97583,0,97583,2018.csv,2018,0.0,1.0
16916,Szinglik éjszakája,97582,0,97582,2010.csv,2010,0.0,1.0
16917,Ecstasy,97563,0,97563,2012.csv,2012,0.0,1.0
16918,Benjamin,97521,0,97521,2019.csv,2019,0.0,1.0
16919,Imagine You & Me,97400,0,97400,2016.csv,2016,0.0,1.0
16920,Un Dios prohibido 2014 Re-release,97314,0,97314,2014.csv,2014,0.0,1.0
16921,Äidin toive,97302,0,97302,2015.csv,2015,0.0,1.0
16922,The Garden,97299,0,97299,2020.csv,2020,0.0,1.0
16923,Never Happened,97294,0,97294,2019.csv,2019,0.0,1.0
16924,Apaporis: In Search of One River,97272,0,97272,2012.csv,2012,0.0,1.0
16925,Selección canina,97268,0,97268,2015.csv,2015,0.0,1.0
16926,In Bloom,97236,56092,41144,2013.csv,2013,0.5768645357686454,0.4231354642313546
16927,Difret,97205,49667,47538,2015.csv,2015,0.5109510827632323,0.48904891723676763
16928,Prassthanam,97204,19984,77220,2019.csv,2019,0.20558824739722645,0.7944117526027735
16929,A Field in England,97195,32846,64349,2013.csv,2013,0.3379391944030043,0.6620608055969958
16930,Trash 2015 Re-release,97190,0,97190,2015.csv,2015,0.0,1.0
16931,Shaadi Mein Zaroor Aana,97154,0,97154,2017.csv,2017,0.0,1.0
16932,Little Monsters,97111,0,97111,2019.csv,2019,0.0,1.0
16933,Toorbos,97105,0,97105,2020.csv,2020,0.0,1.0
16934,Killers Anonymous,97092,0,97092,2019.csv,2019,0.0,1.0
16935,Long Live the Family,97091,0,97091,2011.csv,2011,0.0,1.0
16936,Ouija 2016 Re-release,97045,0,97045,2016.csv,2016,0.0,1.0
16937,Dear Tenant,97003,0,97003,2020.csv,2020,0.0,1.0
16938,A Fantastic Fear of Everything,96948,0,96948,2012.csv,2012,0.0,1.0
16939,Kisses 2010 Re-release,96933,81680,15253,2010.csv,2010,0.8426438880463826,0.15735611195361746
16940,And Breathe Normally,96922,0,96922,2018.csv,2018,0.0,1.0
16941,The Match,96920,0,96920,2016.csv,2016,0.0,1.0
16942,Killing Jesus,96912,0,96912,2017.csv,2017,0.0,1.0
16943,Thadam,96878,0,96878,2019.csv,2019,0.0,1.0
16944,Pelle Svanslös,96873,0,96873,2020.csv,2020,0.0,1.0
16945,A Little Help,96868,96868,0,2011.csv,2011,1.0,0.0
16946,Dark Floors 2010 Re-release,96808,0,96808,2010.csv,2010,0.0,1.0
16947,Leviathan,96778,76202,20576,2013.csv,2013,0.7873896960052904,0.21261030399470954
16948,Singin' in the Rain 2013 Re-release,96763,96763,0,2013.csv,2013,1.0,0.0
16949,Gauragangur,96756,0,96756,2010.csv,2010,0.0,1.0
16950,Hardflip,96734,96734,0,2012.csv,2012,1.0,0.0
16951,Sunshine Superman,96715,88097,8618,2015.csv,2015,0.9108928294473453,0.08910717055265471
16952,Godspeed: The Race Across America,96690,96690,0,2018.csv,2018,1.0,0.0
16953,A Poem Is a Naked Person,96592,96592,0,2015.csv,2015,1.0,0.0
16954,Spasti Pushkina,96589,0,96589,2017.csv,2017,0.0,1.0
16955,Swingers,96574,0,96574,2019.csv,2019,0.0,1.0
16956,Fortuna,96548,0,96548,2018.csv,2018,0.0,1.0
16957,Dina,96524,90503,6021,2017.csv,2017,0.9376217313828685,0.06237826861713149
16958,Max Schmeling,96456,0,96456,2010.csv,2010,0.0,1.0
16959,"Warren Miller's Here, There & Everywhere",96449,0,96449,2017.csv,2017,0.0,1.0
16960,Hiroshima Mon Amour 2014 Re-release,96439,96439,0,2014.csv,2014,1.0,0.0
16961,Dear Prudence,96391,0,96391,2010.csv,2010,0.0,1.0
16962,Wyrmwood: Road of the Dead,96372,0,96372,2015.csv,2015,0.0,1.0
16963,Que Pena Tu Familia,96371,0,96371,2013.csv,2013,0.0,1.0
16964,Gordon & Paddy,96265,0,96265,2018.csv,2018,0.0,1.0
16965,Mixed Kebab,96217,0,96217,2012.csv,2012,0.0,1.0
16966,Sisi ... und ich erzähle euch die Wahrheit,96213,0,96213,2012.csv,2012,0.0,1.0
16967,Ku'fa: Cin Kapani,96188,0,96188,2015.csv,2015,0.0,1.0
16968,A Matter of Life and Death 2017 Re-release,96176,0,96176,2017.csv,2017,0.0,1.0
16969,The Cliff,96169,0,96169,2016.csv,2016,0.0,1.0
16970,All Nighter,96162,0,96162,2017.csv,2017,0.0,1.0
16971,Beyaz Hüzün,96158,0,96158,2019.csv,2019,0.0,1.0
16972,My Reincarnation,96115,92822,3293,2011.csv,2011,0.9657389585392498,0.034261041460750145
16973,The Jakes Are Missing,96093,0,96093,2015.csv,2015,0.0,1.0
16974,Beautiful Creatures 2013 Re-release,96089,0,96089,2013.csv,2013,0.0,1.0
16975,Yeh Saali Aashiqui,96017,0,96017,2019.csv,2019,0.0,1.0
16976,The Maiden Heist 2010 Re-release,96008,0,96008,2010.csv,2010,0.0,1.0
16977,Lyubit ne lyubit,95963,0,95963,2014.csv,2014,0.0,1.0
16978,Double Play,95952,0,95952,2017.csv,2017,0.0,1.0
16979,Happy Ending,95948,0,95948,2019.csv,2019,0.0,1.0
16980,Astral Travel,95904,0,95904,2019.csv,2019,0.0,1.0
16981,Canavar Gibi,95872,0,95872,2018.csv,2018,0.0,1.0
16982,A Bigger Splash 2019 Re-release,95826,95826,0,2019.csv,2019,1.0,0.0
16983,Viaje redondo,95742,0,95742,2011.csv,2011,0.0,1.0
16984,Saand Ki Aankh,95724,0,95724,2019.csv,2019,0.0,1.0
16985,"Verdades verdaderas, la vida de Estela",95714,0,95714,2011.csv,2011,0.0,1.0
16986,Yugo & Lala 4 2019 Re-release,95712,0,95712,2019.csv,2019,0.0,1.0
16987,Why Are We Creative: The Centipede's Dilemma,95569,0,95569,2018.csv,2018,0.0,1.0
16988,King of Prism: Shiny Seven Stars IV/King of Prism: Shiny Seven Stars,95554,0,95554,2019.csv,2019,0.0,1.0
16989,Looking for the Holy Land,95549,0,95549,2016.csv,2016,0.0,1.0
16990,Ardor,95549,18565,76984,2014.csv,2014,0.19429821348208773,0.8057017865179122
16991,The Lovers & the Despot,95521,55511,40010,2016.csv,2016,0.5811392259293768,0.4188607740706232
16992,The Academy of Muses,95491,0,95491,2016.csv,2016,0.0,1.0
16993,"Houston, We Have a Problem",95478,0,95478,2016.csv,2016,0.0,1.0
16994,Achcham Yenbadhu Madamaiyada,95375,0,95375,2016.csv,2016,0.0,1.0
16995,Cruel State,95327,0,95327,2015.csv,2015,0.0,1.0
16996,The Final Wish,95215,25183,70032,2019.csv,2019,0.26448563776715855,0.7355143622328415
16997,The Night Eats the World,95208,0,95208,2018.csv,2018,0.0,1.0
16998,Queen of Earth,95183,91218,3965,2015.csv,2015,0.958343401657859,0.04165659834214093
16999,Winter Nomads,95166,0,95166,2012.csv,2012,0.0,1.0
17000,Still,95141,0,95141,2014.csv,2014,0.0,1.0
17001,Crazy Horse 2013 Re-release,95112,0,95112,2013.csv,2013,0.0,1.0
17002,Felak,95109,0,95109,2017.csv,2017,0.0,1.0
17003,Die Tomorrow,95040,0,95040,2017.csv,2017,0.0,1.0
17004,1:13:7 Ek Tera Saath,94950,0,94950,2016.csv,2016,0.0,1.0
17005,Espíritu de triunfo,94945,0,94945,2012.csv,2012,0.0,1.0
17006,The Metropolitan Opera HD Live: Handel: Giulio Cesare,94944,0,94944,2013.csv,2013,0.0,1.0
17007,Blind Intersections,94920,0,94920,2013.csv,2013,0.0,1.0
17008,A Quiet Dream,94829,0,94829,2016.csv,2016,0.0,1.0
17009,That's Not My Dog!,94803,0,94803,2018.csv,2018,0.0,1.0
17010,Saala Khadoos,94787,76931,17856,2016.csv,2016,0.8116197368837499,0.1883802631162501
17011,Ded 005,94783,0,94783,2013.csv,2013,0.0,1.0
17012,Legacy of Lies,94583,0,94583,2020.csv,2020,0.0,1.0
17013,Adios Amigos,94509,0,94509,2016.csv,2016,0.0,1.0
17014,Thupparivaalan,94491,0,94491,2017.csv,2017,0.0,1.0
17015,Frágil equilibrio,94453,0,94453,2016.csv,2016,0.0,1.0
17016,One Way Ticket,94447,0,94447,2010.csv,2010,0.0,1.0
17017,100 Meter Leeuloop,94436,0,94436,2013.csv,2013,0.0,1.0
17018,Tower Block,94423,0,94423,2012.csv,2012,0.0,1.0
17019,Astro Gardener,94396,0,94396,2019.csv,2019,0.0,1.0
17020,Another Woman's Face,94366,0,94366,2013.csv,2013,0.0,1.0
17021,Going to Heaven,94334,0,94334,2016.csv,2016,0.0,1.0
17022,The Fight Within,94326,94326,0,2016.csv,2016,1.0,0.0
17023,Finke: There and Back,94205,0,94205,2019.csv,2019,0.0,1.0
17024,Asal Abyadh,94194,0,94194,2016.csv,2016,0.0,1.0
17025,Keep Watching,94178,94178,0,2017.csv,2017,1.0,0.0
17026,Girafada,94119,0,94119,2014.csv,2014,0.0,1.0
17027,What a Beautiful Day 2017 Re-release,94090,0,94090,2017.csv,2017,0.0,1.0
17028,The Importance of Tying Your Own Shoes 2012 Re-release,94069,0,94069,2012.csv,2012,0.0,1.0
17029,The Ploy,94056,0,94056,2016.csv,2016,0.0,1.0
17030,Hey Jude,94029,0,94029,2018.csv,2018,0.0,1.0
17031,Rajini Murugan,94022,0,94022,2016.csv,2016,0.0,1.0
17032,Blue Caprice,93995,93995,0,2013.csv,2013,1.0,0.0
17033,Sir-Ayet 2,93984,0,93984,2019.csv,2019,0.0,1.0
17034,Exhibition on Screen: Lucian Freud - A Self Portrait 2020,93981,0,93981,2020.csv,2020,0.0,1.0
17035,Being Italian with Signora Enrica,93944,0,93944,2011.csv,2011,0.0,1.0
17036,Moterys meluoja geriau. Robertelis. Antroji Banga!,93848,0,93848,2020.csv,2020,0.0,1.0
17037,Bathory: Countess of Blood 2010 Re-release,93817,0,93817,2010.csv,2010,0.0,1.0
17038,Arjun Patiala,93802,0,93802,2019.csv,2019,0.0,1.0
17039,Happy Planet: Tale of Boy 36,93792,0,93792,2018.csv,2018,0.0,1.0
17040,The Good Son,93781,0,93781,2011.csv,2011,0.0,1.0
17041,Leonardo Da Vinci: The Genius in Milan,93685,0,93685,2016.csv,2016,0.0,1.0
17042,Insecure,93634,0,93634,2014.csv,2014,0.0,1.0
17043,War of Dogs,93619,0,93619,2012.csv,2012,0.0,1.0
17044,In Your Hands 2012 Re-release,93573,0,93573,2012.csv,2012,0.0,1.0
17045,Mr & Mrs 420 Returns,93557,0,93557,2018.csv,2018,0.0,1.0
17046,Great White Shark,93529,0,93529,2013.csv,2013,0.0,1.0
17047,Paris Prestige,93433,0,93433,2017.csv,2017,0.0,1.0
17048,Let the Corpses Tan,93409,93409,0,2018.csv,2018,1.0,0.0
17049,Super Model Fantasy,93348,0,93348,2019.csv,2019,0.0,1.0
17050,Highway 318,93338,0,93338,2019.csv,2019,0.0,1.0
17051,First Lady,93298,93298,0,2020.csv,2020,1.0,0.0
17052,Simo Times Three,93296,0,93296,2012.csv,2012,0.0,1.0
17053,The Runner,93296,0,93296,2015.csv,2015,0.0,1.0
17054,Tunnel of Bones,93243,0,93243,2011.csv,2011,0.0,1.0
17055,The One World Festival,93236,0,93236,2010.csv,2010,0.0,1.0
17056,15+ Coming of Age,93155,0,93155,2017.csv,2017,0.0,1.0
17057,El último justo 2011 Re-release,93147,0,93147,2011.csv,2011,0.0,1.0
17058,Crebinsky,93126,0,93126,2011.csv,2011,0.0,1.0
17059,Amphetamine,93077,0,93077,2010.csv,2010,0.0,1.0
17060,Will You Still Love Me Tomorrow?,93046,6694,86352,2013.csv,2013,0.07194290995851514,0.9280570900414848
17061,Rang De,93043,0,93043,2021.csv,2021,0.0,1.0
17062,Malapata,93039,0,93039,2017.csv,2017,0.0,1.0
17063,Shimajiro and the Rainbow Oasis,93001,0,93001,2017.csv,2017,0.0,1.0
17064,Psycho Goreman,92982,92780,202,2020.csv,2020,0.9978275365124433,0.0021724634875567314
17065,Trauma Center,92968,0,92968,2019.csv,2019,0.0,1.0
17066,Geçmis Olsun,92938,0,92938,2019.csv,2019,0.0,1.0
17067,Before the World Ends,92934,0,92934,2010.csv,2010,0.0,1.0
17068,A Tale of Three Sisters,92931,0,92931,2019.csv,2019,0.0,1.0
17069,Louis Theroux's Altered States,92922,0,92922,2018.csv,2018,0.0,1.0
17070,Memory of the Dead,92877,0,92877,2013.csv,2013,0.0,1.0
17071,A Season in France,92817,0,92817,2018.csv,2018,0.0,1.0
17072,Sotka,92812,0,92812,2018.csv,2018,0.0,1.0
17073,"Pup-o, ma!",92805,0,92805,2018.csv,2018,0.0,1.0
17074,World Famous Lover,92765,0,92765,2020.csv,2020,0.0,1.0
17075,Vamps,92748,3361,89387,2012.csv,2012,0.03623797817742701,0.963762021822573
17076,El bosc,92744,0,92744,2012.csv,2012,0.0,1.0
17077,Scream 4 2012 Re-release,92734,0,92734,2012.csv,2012,0.0,1.0
17078,A Paper Marriage,92700,0,92700,2018.csv,2018,0.0,1.0
17079,A Real Vermeer,92684,0,92684,2016.csv,2016,0.0,1.0
17080,Master of Oil Painting,92673,0,92673,2018.csv,2018,0.0,1.0
17081,The First Time,92654,22836,69818,2012.csv,2012,0.24646534418373733,0.7535346558162627
17082,The Moneychanger,92640,0,92640,2019.csv,2019,0.0,1.0
17083,"Der Mann, der über Autos sprang",92549,0,92549,2011.csv,2011,0.0,1.0
17084,María (y los demás),92508,0,92508,2016.csv,2016,0.0,1.0
17085,The Fourth Phase,92447,0,92447,2016.csv,2016,0.0,1.0
17086,Jota de Saura,92378,0,92378,2016.csv,2016,0.0,1.0
17087,Fuchsia the Mini-Witch 2011 Re-release,92331,0,92331,2011.csv,2011,0.0,1.0
17088,We Are the Heat,92317,0,92317,2018.csv,2018,0.0,1.0
17089,Morgue,92266,0,92266,2020.csv,2020,0.0,1.0
17090,American: The Bill Hicks Story,92234,92234,0,2011.csv,2011,1.0,0.0
17091,Hledá se prezident,92223,0,92223,2013.csv,2013,0.0,1.0
17092,Tom wa Jimi,92202,0,92202,2013.csv,2013,0.0,1.0
17093,Into the Forest,92166,9995,82171,2016.csv,2016,0.10844563070980621,0.8915543692901938
17094,Volcano,92148,0,92148,2011.csv,2011,0.0,1.0
17095,A Ilha dos Cães,92075,0,92075,2017.csv,2017,0.0,1.0
17096,The NeverEnding Story 2016 Re-release,92049,0,92049,2016.csv,2016,0.0,1.0
17097,Vampirina's Fang-Tastic Party,92042,0,92042,2019.csv,2019,0.0,1.0
17098,Nancy,92000,80115,11885,2018.csv,2018,0.8708152173913043,0.12918478260869565
17099,Apocalypse Now Redux 2010 Re-release,91923,0,91923,2010.csv,2010,0.0,1.0
17100,The Beautiful Days of Aranjuez,91854,0,91854,2016.csv,2016,0.0,1.0
17101,"Politics, Instructions Manual",91832,0,91832,2016.csv,2016,0.0,1.0
17102,Rak 555,91831,0,91831,2012.csv,2012,0.0,1.0
17103,Acres and Acres,91827,0,91827,2016.csv,2016,0.0,1.0
17104,Time Trial,91775,0,91775,2018.csv,2018,0.0,1.0
17105,A Pact,91634,0,91634,2013.csv,2013,0.0,1.0
17106,Generation War,91595,91595,0,2014.csv,2014,1.0,0.0
17107,Mother Teresa of Cats,91575,0,91575,2010.csv,2010,0.0,1.0
17108,Hello I Am David!,91561,0,91561,2015.csv,2015,0.0,1.0
17109,Apnée,91515,0,91515,2016.csv,2016,0.0,1.0
17110,Legends from the Sky,91462,91462,0,2015.csv,2015,1.0,0.0
17111,Ask Uykusu,91460,0,91460,2017.csv,2017,0.0,1.0
17112,Other People,91441,91441,0,2016.csv,2016,1.0,0.0
17113,Pulp Fiction 2017 Re-release,91374,0,91374,2017.csv,2017,0.0,1.0
17114,The Heart,91344,0,91344,2019.csv,2019,0.0,1.0
17115,Comfort and Consolation in France,91324,0,91324,2017.csv,2017,0.0,1.0
17116,Song Without a Name,91313,0,91313,2020.csv,2020,0.0,1.0
17117,Evil Bong 3: The Wrath of Bong,91260,91260,0,2011.csv,2011,1.0,0.0
17118,May in the Summer 2016 Re-release,91250,0,91250,2016.csv,2016,0.0,1.0
17119,The Story of Lovers Rock,91205,0,91205,2011.csv,2011,0.0,1.0
17120,Sherlock Toms,91196,0,91196,2017.csv,2017,0.0,1.0
17121,Morris from America,91151,91151,0,2016.csv,2016,1.0,0.0
17122,A Kind of Murder,91149,2915,88234,2016.csv,2016,0.03198060318818638,0.9680193968118136
17123,Right Here Waiting For You,91148,0,91148,2019.csv,2019,0.0,1.0
17124,El Buen Pedro,91146,0,91146,2012.csv,2012,0.0,1.0
17125,"Serce, Serduszko I Wyprawa Na Koniec Swiata",91034,0,91034,2014.csv,2014,0.0,1.0
17126,Days of Harvest,91024,0,91024,2012.csv,2012,0.0,1.0
17127,Super Master&Disciple,91014,0,91014,2018.csv,2018,0.0,1.0
17128,Mapplethorpe,91002,91002,0,2019.csv,2019,1.0,0.0
17129,BANDSTAND: The Broadway Musical on Screen 2018 Re-release,91000,91000,0,2018.csv,2018,1.0,0.0
17130,She Shears,90973,0,90973,2018.csv,2018,0.0,1.0
17131,Manhattan 2019 Re-release,90966,0,90966,2019.csv,2019,0.0,1.0
17132,Renacidos - El Padre Pío cambió sus vidas,90954,0,90954,2019.csv,2019,0.0,1.0
17133,Breaking News in Yuba County,90933,0,90933,2021.csv,2021,0.0,1.0
17134,La Dolce Vita 2020 Re-release,90931,0,90931,2020.csv,2020,0.0,1.0
17135,Choose,90901,0,90901,2012.csv,2012,0.0,1.0
17136,Because of Grácia,90878,90878,0,2017.csv,2017,1.0,0.0
17137,El-Qird Beyitkallem,90850,0,90850,2017.csv,2017,0.0,1.0
17138,Porto,90849,15126,75723,2017.csv,2017,0.16649605389162236,0.8335039461083776
17139,"Ireesha, The Daughter of Elf-king",90804,0,90804,2019.csv,2019,0.0,1.0
17140,Heropanti,90785,63649,27136,2014.csv,2014,0.7010959960345872,0.2989040039654128
17141,Beasts of No Nation,90777,90777,0,2015.csv,2015,1.0,0.0
17142,Yuri!!! On Ice,90751,81878,8873,2018.csv,2018,0.902226972705535,0.09777302729446508
17143,Loopers: The Caddie's Long Walk,90679,90679,0,2019.csv,2019,1.0,0.0
17144,Jack & Daniel,90663,0,90663,2019.csv,2019,0.0,1.0
17145,Miss Nobody,90647,0,90647,2011.csv,2011,0.0,1.0
17146,Moonwalkers,90646,0,90646,2016.csv,2016,0.0,1.0
17147,Preparations to Be Together for an Unknown Period of Time,90632,0,90632,2020.csv,2020,0.0,1.0
17148,492: A Man Called Death,90630,0,90630,2018.csv,2018,0.0,1.0
17149,The Missing Paper,90611,0,90611,2016.csv,2016,0.0,1.0
17150,The Good Neighbor,90573,0,90573,2016.csv,2016,0.0,1.0
17151,Black Mercedes,90549,0,90549,2019.csv,2019,0.0,1.0
17152,Smaller and Smaller Circles,90548,0,90548,2017.csv,2017,0.0,1.0
17153,Fireworks Wednesday 2016 Re-release,90519,90519,0,2016.csv,2016,1.0,0.0
17154,Bobby Fischer Against the World,90511,0,90511,2011.csv,2011,0.0,1.0
17155,A Five Star Life 2016 Re-release,90503,0,90503,2016.csv,2016,0.0,1.0
17156,Damo & Ivor The Movie,90496,0,90496,2018.csv,2018,0.0,1.0
17157,The Girl and Death,90477,0,90477,2013.csv,2013,0.0,1.0
17158,A Serious Game,90456,0,90456,2016.csv,2016,0.0,1.0
17159,Atlit,90456,0,90456,2015.csv,2015,0.0,1.0
17160,TED 2016,90414,0,90414,2016.csv,2016,0.0,1.0
17161,Agir abi,90393,0,90393,2011.csv,2011,0.0,1.0
17162,Mr. Jones,90388,0,90388,2014.csv,2014,0.0,1.0
17163,Minding the Gap,90328,11998,78330,2018.csv,2018,0.1328270303781773,0.8671729696218227
17164,Korso,90212,0,90212,2014.csv,2014,0.0,1.0
17165,Rolling Home with a Bull,90171,0,90171,2010.csv,2010,0.0,1.0
17166,The Goalkeeper,90168,0,90168,2018.csv,2018,0.0,1.0
17167,2 Nights Till Morning,90144,0,90144,2016.csv,2016,0.0,1.0
17168,Dark Horse,90136,90136,0,2015.csv,2015,1.0,0.0
17169,Evil Woman,90124,0,90124,2013.csv,2013,0.0,1.0
17170,King's Faith,90106,90106,0,2013.csv,2013,1.0,0.0
17171,Rivercide: The Secret Six,90057,0,90057,2019.csv,2019,0.0,1.0
17172,Poker Generation,90057,0,90057,2012.csv,2012,0.0,1.0
17173,Malati di sesso,90054,0,90054,2018.csv,2018,0.0,1.0
17174,Super Hero Taisen Z: Kamen Rider vs. Super Sentai vs. Space Sheriff 2014 Re-release,90039,0,90039,2014.csv,2014,0.0,1.0
17175,Die Windpomp,90000,0,90000,2014.csv,2014,0.0,1.0
17176,Running for Grace,89988,89988,0,2018.csv,2018,1.0,0.0
17177,Khara Khaar,89983,0,89983,2021.csv,2021,0.0,1.0
17178,Rattle the Cage,89983,0,89983,2015.csv,2015,0.0,1.0
17179,The Forgotten Ones,89884,0,89884,2010.csv,2010,0.0,1.0
17180,Proximity,89884,0,89884,2017.csv,2017,0.0,1.0
17181,Iz Ufy s lyubovyu,89864,0,89864,2017.csv,2017,0.0,1.0
17182,A Million Little Pieces,89825,0,89825,2019.csv,2019,0.0,1.0
17183,Pump,89787,89787,0,2014.csv,2014,1.0,0.0
17184,I Still Hide to Smoke,89784,0,89784,2017.csv,2017,0.0,1.0
17185,Afterimage 2019 Re-release,89739,0,89739,2019.csv,2019,0.0,1.0
17186,Uncle,89724,0,89724,2018.csv,2018,0.0,1.0
17187,Panchavarnathatha,89709,0,89709,2018.csv,2018,0.0,1.0
17188,The Man Who Stole Banksy,89674,0,89674,2018.csv,2018,0.0,1.0
17189,Ya ne takoy. Ya ne takaya,89667,0,89667,2019.csv,2019,0.0,1.0
17190,Pushwagner,89646,0,89646,2011.csv,2011,0.0,1.0
17191,Sharafat Gayi Tel Lene,89637,0,89637,2015.csv,2015,0.0,1.0
17192,The Shimajiro Movie: Shimajiro in Bookland,89611,0,89611,2016.csv,2016,0.0,1.0
17193,Ghadi 2015 Re-release,89606,0,89606,2015.csv,2015,0.0,1.0
17194,The Lost Choices,89553,0,89553,2015.csv,2015,0.0,1.0
17195,The Principle,89543,89543,0,2014.csv,2014,1.0,0.0
17196,Max Winslow and the House of Secrets,89532,31250,58282,2020.csv,2020,0.3490372157440915,0.6509627842559085
17197,X-Large,89525,0,89525,2011.csv,2011,0.0,1.0
17198,Oy Vey! My Son Is Gay!!,89507,89507,0,2010.csv,2010,1.0,0.0
17199,Her Sey Mümkün,89479,0,89479,2017.csv,2017,0.0,1.0
17200,The Salt of Tears,89465,0,89465,2020.csv,2020,0.0,1.0
17201,The Conquerors,89451,0,89451,2013.csv,2013,0.0,1.0
17202,Somebody Up There Likes Me,89435,89435,0,2013.csv,2013,1.0,0.0
17203,Queen,89381,0,89381,2018.csv,2018,0.0,1.0
17204,Farming,89374,0,89374,2019.csv,2019,0.0,1.0
17205,The Song of Cotton,89372,0,89372,2016.csv,2016,0.0,1.0
17206,Cat on a Hot Tin Roof,89332,89332,0,2018.csv,2018,1.0,0.0
17207,Vendetta,89297,0,89297,2011.csv,2011,0.0,1.0
17208,Knife in the Clear Water,89226,0,89226,2018.csv,2018,0.0,1.0
17209,Pieles,89208,0,89208,2017.csv,2017,0.0,1.0
17210,Salvation Boulevard,89182,28468,60714,2011.csv,2011,0.31921239712049515,0.6807876028795048
17211,10 Segundos para Vencer,89178,0,89178,2018.csv,2018,0.0,1.0
17212,Marafon,89145,0,89145,2013.csv,2013,0.0,1.0
17213,Gimme Some Respect,89099,0,89099,2010.csv,2010,0.0,1.0
17214,Dakuaan Da Munda,89088,0,89088,2018.csv,2018,0.0,1.0
17215,Relocos y repasados,89085,0,89085,2013.csv,2013,0.0,1.0
17216,karantina XII,89044,0,89044,2018.csv,2018,0.0,1.0
17217,Permission,89043,0,89043,2018.csv,2018,0.0,1.0
17218,Apaixonados: O Filme,89043,0,89043,2016.csv,2016,0.0,1.0
17219,Sming,89038,0,89038,2014.csv,2014,0.0,1.0
17220,Night of the Living Dead,89029,89029,0,2017.csv,2017,1.0,0.0
17221,Jupiter's Moon,89019,0,89019,2017.csv,2017,0.0,1.0
17222,Superhelde,89012,0,89012,2011.csv,2011,0.0,1.0
17223,The Bad Intentions,89011,0,89011,2011.csv,2011,0.0,1.0
17224,Ovunque proteggimi,88944,0,88944,2018.csv,2018,0.0,1.0
17225,Berzah: Cin Alemi,88878,0,88878,2016.csv,2016,0.0,1.0
17226,Converso,88850,0,88850,2017.csv,2017,0.0,1.0
17227,Battle Up,88843,0,88843,2015.csv,2015,0.0,1.0
17228,Panya Raenu 4,88769,0,88769,2014.csv,2014,0.0,1.0
17229,This Is Not a Film,88758,77016,11742,2012.csv,2012,0.8677076995876428,0.1322923004123572
17230,Old Master Q 2010,88756,0,88756,2011.csv,2011,0.0,1.0
17231,Maceraci Yüzgeçler: Büyük Gösteri,88716,0,88716,2020.csv,2020,0.0,1.0
17232,Zibilla,88667,0,88667,2019.csv,2019,0.0,1.0
17233,Friendsgiving,88637,0,88637,2020.csv,2020,0.0,1.0
17234,The Mojicons 2,88579,0,88579,2018.csv,2018,0.0,1.0
17235,My First Wedding 2013 Re-release,88523,0,88523,2013.csv,2013,0.0,1.0
17236,Looking for Eric 2018 Re-release,88487,0,88487,2018.csv,2018,0.0,1.0
17237,"Sneak Previews: Neighbors, Sharky's Machine, Ghost Story, Pennies from Heaven",88441,0,88441,2016.csv,2016,0.0,1.0
17238,Vai,88402,0,88402,2019.csv,2019,0.0,1.0
17239,The Open Door,88401,0,88401,2016.csv,2016,0.0,1.0
17240,Ma' Rosa,88390,0,88390,2016.csv,2016,0.0,1.0
17241,Witch,88367,0,88367,2019.csv,2019,0.0,1.0
17242,L'amore fa male,88355,0,88355,2011.csv,2011,0.0,1.0
17243,The Lumber Baron,88336,88336,0,2019.csv,2019,1.0,0.0
17244,Crazy on the Outside,88335,88335,0,2010.csv,2010,1.0,0.0
17245,Alamaara,88327,0,88327,2017.csv,2017,0.0,1.0
17246,Jewtopia,88327,46437,41890,2013.csv,2013,0.5257395813284726,0.4742604186715274
17247,Not Forgotten 2010 Re-release,88311,0,88311,2010.csv,2010,0.0,1.0
17248,Beloved Clara 2010 Re-release,88273,0,88273,2010.csv,2010,0.0,1.0
17249,The Fallen,88245,0,88245,2020.csv,2020,0.0,1.0
17250,Reshenie o likvidatsii,88242,0,88242,2018.csv,2018,0.0,1.0
17251,Sonhos Roubados,88222,0,88222,2010.csv,2010,0.0,1.0
17252,Cupid Arrow,88163,0,88163,2016.csv,2016,0.0,1.0
17253,Love Like Poison,88154,0,88154,2010.csv,2010,0.0,1.0
17254,Darbareye Elly 2012 Re-release,88107,0,88107,2012.csv,2012,0.0,1.0
17255,Money for Nothing: Inside the Federal Reserve,88045,88045,0,2013.csv,2013,1.0,0.0
17256,La Bohème 2010 Re-release,87990,0,87990,2010.csv,2010,0.0,1.0
17257,Jim Allison: Breakthrough,87984,87984,0,2019.csv,2019,1.0,0.0
17258,Lovetown,87944,0,87944,2012.csv,2012,0.0,1.0
17259,Warren Miller's Chasing Shadows,87918,0,87918,2016.csv,2016,0.0,1.0
17260,The Dinner 2017 Re-release,87843,0,87843,2017.csv,2017,0.0,1.0
17261,Hyena Road,87768,1430,86338,2015.csv,2015,0.01629295415185489,0.9837070458481451
17262,Solaris 2019 Re-release,87768,0,87768,2019.csv,2019,0.0,1.0
17263,Three Husbands,87765,0,87765,2019.csv,2019,0.0,1.0
17264,The Cartel,87763,87763,0,2010.csv,2010,1.0,0.0
17265,Between Two Waters,87763,0,87763,2018.csv,2018,0.0,1.0
17266,Ocean Waves,87738,87738,0,2016.csv,2016,1.0,0.0
17267,Cross the Line,87736,0,87736,2020.csv,2020,0.0,1.0
17268,Glory,87728,18415,69313,2017.csv,2017,0.2099101769104505,0.7900898230895496
17269,Exporting Raymond,87727,87727,0,2011.csv,2011,1.0,0.0
17270,Ostravak Ostravski,87687,0,87687,2016.csv,2016,0.0,1.0
17271,Author: The JT LeRoy Story,87686,85999,1687,2016.csv,2016,0.9807608968364391,0.019239103163560888
17272,Amalia the Secretary,87661,0,87661,2018.csv,2018,0.0,1.0
17273,Angel on My Nerves,87648,0,87648,2015.csv,2015,0.0,1.0
17274,Goldstone 2018 Re-release,87639,87639,0,2018.csv,2018,1.0,0.0
17275,Ne skazhu,87633,0,87633,2010.csv,2010,0.0,1.0
17276,All at Sea,87591,0,87591,2012.csv,2012,0.0,1.0
17277,I Phone You,87583,0,87583,2011.csv,2011,0.0,1.0
17278,Inferior Student Qiao Xi,87578,0,87578,2019.csv,2019,0.0,1.0
17279,Hearts and Bones,87522,0,87522,2020.csv,2020,0.0,1.0
17280,Miss Bala 2019 Re-release,87514,0,87514,2019.csv,2019,0.0,1.0
17281,The Memory of Water,87427,0,87427,2019.csv,2019,0.0,1.0
17282,Solum,87419,0,87419,2019.csv,2019,0.0,1.0
17283,The Pack,87370,0,87370,2015.csv,2015,0.0,1.0
17284,Silent Summer,87305,0,87305,2014.csv,2014,0.0,1.0
17285,The Veil of Twilight,87275,0,87275,2014.csv,2014,0.0,1.0
17286,Voice from the Stone,87273,0,87273,2017.csv,2017,0.0,1.0
17287,Savage State,87243,0,87243,2020.csv,2020,0.0,1.0
17288,Dead Man Talking,87237,0,87237,2012.csv,2012,0.0,1.0
17289,Return of Sergeant Lapins,87232,0,87232,2010.csv,2010,0.0,1.0
17290,The Smell of Us,87212,0,87212,2015.csv,2015,0.0,1.0
17291,Taxi Driver 2011 Re-release,87154,0,87154,2011.csv,2011,0.0,1.0
17292,Force of Execution,87122,0,87122,2014.csv,2014,0.0,1.0
17293,Tante Hilda!,87101,0,87101,2014.csv,2014,0.0,1.0
17294,Naughty Jatts,87084,0,87084,2013.csv,2013,0.0,1.0
17295,Ali 2019 Re-release,87081,0,87081,2019.csv,2019,0.0,1.0
17296,Pauline & François,87081,0,87081,2010.csv,2010,0.0,1.0
17297,Vultures,87074,0,87074,2018.csv,2018,0.0,1.0
17298,Boy Upside Down,87072,0,87072,2014.csv,2014,0.0,1.0
17299,Isla Bonita,87037,0,87037,2015.csv,2015,0.0,1.0
17300,You Got Served: Beat the World 2013 Re-release,87017,0,87017,2013.csv,2013,0.0,1.0
17301,Donbass,86985,0,86985,2018.csv,2018,0.0,1.0
17302,Reung Rak Rawang Ther,86963,0,86963,2012.csv,2012,0.0,1.0
17303,Tayemnyy shchodennyk Symona Petlyury,86957,0,86957,2018.csv,2018,0.0,1.0
17304,Musudan,86953,0,86953,2016.csv,2016,0.0,1.0
17305,I Loved You So Much,86950,0,86950,2013.csv,2013,0.0,1.0
17306,The Third Man 2019 Re-release,86941,0,86941,2019.csv,2019,0.0,1.0
17307,Nobody Nose,86919,0,86919,2019.csv,2019,0.0,1.0
17308,Love Is a Story,86910,0,86910,2015.csv,2015,0.0,1.0
17309,Dünyanin En Güzel Kokusu 2,86884,0,86884,2017.csv,2017,0.0,1.0
17310,10 Horas para o Natal,86872,0,86872,2020.csv,2020,0.0,1.0
17311,ECCO,86858,86858,0,2019.csv,2019,1.0,0.0
17312,Miss Sixty 2016 Re-release,86849,0,86849,2016.csv,2016,0.0,1.0
17313,Singularity,86822,4176,82646,2017.csv,2017,0.04809840823754348,0.9519015917624565
17314,Never Say Goodbye,86766,0,86766,2018.csv,2018,0.0,1.0
17315,Teurumatsyo,86761,0,86761,2011.csv,2011,0.0,1.0
17316,Vault,86741,29491,57250,2019.csv,2019,0.3399891631408446,0.6600108368591554
17317,Gueros,86736,60114,26622,2015.csv,2015,0.6930686220254566,0.30693137797454345
17318,Lowdown Dirty Criminals,86730,0,86730,2020.csv,2020,0.0,1.0
17319,School Life,86616,37381,49235,2017.csv,2017,0.4315715341276439,0.5684284658723562
17320,Njan Prakashan,86540,0,86540,2018.csv,2018,0.0,1.0
17321,Scattered Cloud,86494,0,86494,2012.csv,2012,0.0,1.0
17322,Ikizler firarda,86487,0,86487,2012.csv,2012,0.0,1.0
17323,Yang Jingyu,86463,0,86463,2019.csv,2019,0.0,1.0
17324,Beuys,86451,65410,21041,2018.csv,2018,0.7566135730066743,0.2433864269933257
17325,El Kharmouty,86450,0,86450,2017.csv,2017,0.0,1.0
17326,"My Love, Don't Cross That River 2016 Re-release",86446,86446,0,2016.csv,2016,1.0,0.0
17327,Play It Like Godard,86419,0,86419,2012.csv,2012,0.0,1.0
17328,Our Grand Despair,86315,0,86315,2011.csv,2011,0.0,1.0
17329,A Stray Goat,86313,0,86313,2017.csv,2017,0.0,1.0
17330,Crazy Wisdom: The Life & Times of Chogyam Trungpa Rinpoche,86202,86202,0,2011.csv,2011,1.0,0.0
17331,Devadas,86187,0,86187,2018.csv,2018,0.0,1.0
17332,Muhalif baskan,86171,0,86171,2013.csv,2013,0.0,1.0
17333,Jab Tak Hai Jaan 2014 Re-release,86154,0,86154,2014.csv,2014,0.0,1.0
17334,Wesalna wela b'adna?,86119,0,86119,2018.csv,2018,0.0,1.0
17335,Rapt 2011 Re-release,86028,45759,40269,2011.csv,2011,0.5319082159296973,0.4680917840703027
17336,Mudbound,85955,0,85955,2017.csv,2017,0.0,1.0
17337,Para toda la muerte,85948,0,85948,2020.csv,2020,0.0,1.0
17338,Kabr-i Cin Mühür,85929,0,85929,2016.csv,2016,0.0,1.0
17339,The Importance of Being Earnest on Stage,85874,0,85874,2016.csv,2016,0.0,1.0
17340,Schaste V Konverte,85856,0,85856,2020.csv,2020,0.0,1.0
17341,Tab Hunter Confidential,85812,85812,0,2015.csv,2015,1.0,0.0
17342,Approved for Adoption,85786,0,85786,2012.csv,2012,0.0,1.0
17343,Somewhere Amazing,85767,0,85767,2015.csv,2015,0.0,1.0
17344,Nhan Duyen: Nguoi Yeu Tien Kiep,85762,0,85762,2019.csv,2019,0.0,1.0
17345,Uitvlucht,85646,0,85646,2016.csv,2016,0.0,1.0
17346,Casa Por Carcel,85590,0,85590,2017.csv,2017,0.0,1.0
17347,Vsyo prosto,85541,0,85541,2012.csv,2012,0.0,1.0
17348,Belated Confession,85457,0,85457,2019.csv,2019,0.0,1.0
17349,Dil Diyan Gallan,85456,0,85456,2019.csv,2019,0.0,1.0
17350,Three Tenors: Voices For Eternity,85432,0,85432,2020.csv,2020,0.0,1.0
17351,Jackals,85410,0,85410,2017.csv,2017,0.0,1.0
17352,Korku Komedi: Bana Normal Aktiviteler,85332,0,85332,2016.csv,2016,0.0,1.0
17353,Kabukicho Love Hotel,85261,0,85261,2015.csv,2015,0.0,1.0
17354,Poomaram,85232,0,85232,2018.csv,2018,0.0,1.0
17355,Cathedrals of Culture,85229,0,85229,2014.csv,2014,0.0,1.0
17356,7 Below,85226,0,85226,2012.csv,2012,0.0,1.0
17357,Kontributsiya,85193,0,85193,2016.csv,2016,0.0,1.0
17358,Trabant at the End of the World,85165,0,85165,2014.csv,2014,0.0,1.0
17359,Benim Adim Osman,85086,0,85086,2018.csv,2018,0.0,1.0
17360,Hallåhallå 2015 Re-release,85063,0,85063,2015.csv,2015,0.0,1.0
17361,Breakout Brothers,85037,0,85037,2021.csv,2021,0.0,1.0
17362,Skid Row Marathon,84997,84997,0,2019.csv,2019,1.0,0.0
17363,National Theatre Live: Collaborators,84968,0,84968,2012.csv,2012,0.0,1.0
17364,My Good Enemy,84966,0,84966,2010.csv,2010,0.0,1.0
17365,Drops of Joy,84944,0,84944,2014.csv,2014,0.0,1.0
17366,Waking Sleeping Beauty,84918,80741,4177,2010.csv,2010,0.9508113709696413,0.0491886290303587
17367,Hypersomnia,84893,0,84893,2017.csv,2017,0.0,1.0
17368,Secrets of the Wind,84892,0,84892,2020.csv,2020,0.0,1.0
17369,Planet Ottakring,84841,0,84841,2015.csv,2015,0.0,1.0
17370,Alone 2010 Re-release,84821,0,84821,2010.csv,2010,0.0,1.0
17371,Ran 2016 Re-release,84789,66097,18692,2016.csv,2016,0.779546875184281,0.22045312481571902
17372,Ira,84739,0,84739,2018.csv,2018,0.0,1.0
17373,Forgiveness,84723,0,84723,2010.csv,2010,0.0,1.0
17374,Paradise Drifters,84699,0,84699,2020.csv,2020,0.0,1.0
17375,The Lord of the Rings: The Two Towers 2021 Re-release,84695,0,84695,2021.csv,2021,0.0,1.0
17376,The Songs We Sang,84661,0,84661,2016.csv,2016,0.0,1.0
17377,My Father's War,84612,0,84612,2016.csv,2016,0.0,1.0
17378,Wretches & Jabberers,84610,84610,0,2011.csv,2011,1.0,0.0
17379,The Dark Knight 2018 Re-release,84589,0,84589,2020.csv,2020,0.0,1.0
17380,Visitors,84577,84577,0,2014.csv,2014,1.0,0.0
17381,Turbal Rayeh Jay,84533,0,84533,2018.csv,2018,0.0,1.0
17382,River at Far North,84497,0,84497,2016.csv,2016,0.0,1.0
17383,She Stoops to Conquer,84448,0,84448,2012.csv,2012,0.0,1.0
17384,Woodstock,84440,84440,0,2019.csv,2019,1.0,0.0
17385,Heaven Knows What,84417,80734,3683,2015.csv,2015,0.9563713470035656,0.04362865299643437
17386,All Is Well,84399,0,84399,2019.csv,2019,0.0,1.0
17387,Closeness 2019 Re-release,84398,0,84398,2019.csv,2019,0.0,1.0
17388,Home Alone 2: Lost in New York 2018 Re-release,84376,0,84376,2018.csv,2018,0.0,1.0
17389,Gypsy Spirit: Harri Stojka - Eine Reise,84370,0,84370,2010.csv,2010,0.0,1.0
17390,Beloved 2020 Re-release,84354,0,84354,2020.csv,2020,0.0,1.0
17391,Los Perros,84353,0,84353,2017.csv,2017,0.0,1.0
17392,Meciar,84329,0,84329,2017.csv,2017,0.0,1.0
17393,Bir ses böler geceyi,84321,0,84321,2012.csv,2012,0.0,1.0
17394,Bo fung hon ji,84321,0,84321,2016.csv,2016,0.0,1.0
17395,"Oslo, August 31st 2014 Re-release",84301,0,84301,2014.csv,2014,0.0,1.0
17396,Psalm 21,84299,0,84299,2010.csv,2010,0.0,1.0
17397,The Diabolical,84259,0,84259,2015.csv,2015,0.0,1.0
17398,Chapter & Verse,84147,84147,0,2017.csv,2017,1.0,0.0
17399,All My Children,84108,0,84108,2014.csv,2014,0.0,1.0
17400,Paradise,84108,0,84108,2014.csv,2014,0.0,1.0
17401,J. Kessels,84054,0,84054,2015.csv,2015,0.0,1.0
17402,Pure,84013,0,84013,2010.csv,2010,0.0,1.0
17403,Los Sures,83992,83992,0,2016.csv,2016,1.0,0.0
17404,The Disappearance of My Mother,83930,24951,58979,2019.csv,2019,0.29728345049445964,0.7027165495055403
17405,Satellite Shankar,83896,0,83896,2019.csv,2019,0.0,1.0
17406,Mountain Cry,83878,0,83878,2016.csv,2016,0.0,1.0
17407,Bull Fighting,83863,0,83863,2014.csv,2014,0.0,1.0
17408,Crock of Gold: A Few Rounds with Shane MacGowan,83863,2455,81408,2020.csv,2020,0.029273934869966493,0.9707260651300335
17409,Upin & Ipin: Keris Siamang Tunggal,83857,0,83857,2019.csv,2019,0.0,1.0
17410,Paramparça,83786,0,83786,2010.csv,2010,0.0,1.0
17411,Jeronimo,83762,0,83762,2019.csv,2019,0.0,1.0
17412,La fine équipe,83738,0,83738,2016.csv,2016,0.0,1.0
17413,Little King Macius 2010 Re-release,83671,0,83671,2010.csv,2010,0.0,1.0
17414,Big Village Lights,83670,0,83670,2017.csv,2017,0.0,1.0
17415,Francesco und der Papst,83637,0,83637,2011.csv,2011,0.0,1.0
17416,Honeymoon Plan,83595,0,83595,2017.csv,2017,0.0,1.0
17417,"Nico, 1988",83558,73304,10254,2018.csv,2018,0.8772828454486704,0.12271715455132962
17418,Monsoon,83446,0,83446,2020.csv,2020,0.0,1.0
17419,The Mayor,83444,0,83444,2016.csv,2016,0.0,1.0
17420,The Haunted House Project,83322,0,83322,2010.csv,2010,0.0,1.0
17421,The Big Step,83298,0,83298,2020.csv,2020,0.0,1.0
17422,Sailaja Reddy Alludu,83262,0,83262,2018.csv,2018,0.0,1.0
17423,The Lodger: A Story of the London Fog 2012 Re-release,83260,0,83260,2012.csv,2012,0.0,1.0
17424,Gaza,83221,0,83221,2019.csv,2019,0.0,1.0
17425,In the Trap,83215,0,83215,2019.csv,2019,0.0,1.0
17426,Happy Home,83205,0,83205,2019.csv,2019,0.0,1.0
17427,Ice,83188,0,83188,2012.csv,2012,0.0,1.0
17428,Wonderlus,83164,0,83164,2018.csv,2018,0.0,1.0
17429,The Hero of Color City 2015 Re-release,83147,0,83147,2015.csv,2015,0.0,1.0
17430,The Look,83137,19988,63149,2011.csv,2011,0.2404224352574666,0.7595775647425335
17431,Omission,83109,0,83109,2013.csv,2013,0.0,1.0
17432,The Pluto Moment,83081,0,83081,2018.csv,2018,0.0,1.0
17433,Vitriol,83077,0,83077,2012.csv,2012,0.0,1.0
17434,The Kindness of Strangers,83042,2705,80337,2019.csv,2019,0.032573878278461504,0.9674261217215385
17435,A Vigilante,83012,0,83012,2019.csv,2019,0.0,1.0
17436,Hateship Loveship,83008,54030,28978,2014.csv,2014,0.6509011179645335,0.34909888203546646
17437,Necrophobia 3D,82995,0,82995,2014.csv,2014,0.0,1.0
17438,Mercenary,82933,0,82933,2016.csv,2016,0.0,1.0
17439,Our Women 2016 Re-release,82931,0,82931,2016.csv,2016,0.0,1.0
17440,Under Pressure,82867,0,82867,2016.csv,2016,0.0,1.0
17441,Chambord,82841,0,82841,2019.csv,2019,0.0,1.0
17442,Vertigo,82778,0,82778,2019.csv,2019,0.0,1.0
17443,Shopping,82756,0,82756,2013.csv,2013,0.0,1.0
17444,Alien Abduction,82725,12897,69828,2014.csv,2014,0.15590208522212148,0.8440979147778785
17445,"Guru: Bhagwan, His Secretary & His Bodyguard",82718,0,82718,2010.csv,2010,0.0,1.0
17446,Doctor Who: The Woman Who Fell to Earth,82698,82698,0,2018.csv,2018,1.0,0.0
17447,Tutte le mie notti,82693,0,82693,2019.csv,2019,0.0,1.0
17448,12 O'Clock Boys,82614,82614,0,2014.csv,2014,1.0,0.0
17449,Lakshyam,82599,0,82599,2017.csv,2017,0.0,1.0
17450,Tatort: Tschiller: Off Duty 2017 Re-release,82596,0,82596,2017.csv,2017,0.0,1.0
17451,Rubbers,82510,0,82510,2015.csv,2015,0.0,1.0
17452,Breakthrough,82480,0,82480,2019.csv,2019,0.0,1.0
17453,The Dude in Me Pre-release,82462,0,82462,2018.csv,2018,0.0,1.0
17454,EXHIBITION: Vermeer and Music: The Art of Love and Leisure,82461,0,82461,2013.csv,2013,0.0,1.0
17455,Siempre hay tiempo,82447,0,82447,2010.csv,2010,0.0,1.0
17456,Xi Yang Yang Yu Hui Tai Lang Zhi Kaixin Chuang Long Nian,82427,0,82427,2012.csv,2012,0.0,1.0
17457,Bernie 2015 Re-release,82420,0,82420,2015.csv,2015,0.0,1.0
17458,Meet Me in St. Louis 2011 Re-release,82411,0,82411,2011.csv,2011,0.0,1.0
17459,V/H/S Viral,82409,2756,79653,2014.csv,2014,0.033442949192442575,0.9665570508075574
17460,The Treasure,82392,50203,32189,2016.csv,2016,0.6093188659093116,0.39068113409068844
17461,Shine a Light,82312,0,82312,2010.csv,2010,0.0,1.0
17462,Water & Power,82312,82312,0,2014.csv,2014,1.0,0.0
17463,Valan: Valley of Angels,82283,0,82283,2019.csv,2019,0.0,1.0
17464,Prey,82258,0,82258,2019.csv,2019,0.0,1.0
17465,New Pinocchio,82257,0,82257,2016.csv,2016,0.0,1.0
17466,Bent,82247,0,82247,2018.csv,2018,0.0,1.0
17467,"Paula Rego, Secrets & Stories",82245,0,82245,2017.csv,2017,0.0,1.0
17468,Careful What You Wish For,82230,0,82230,2015.csv,2015,0.0,1.0
17469,Demons Never Die,82225,0,82225,2011.csv,2011,0.0,1.0
17470,The Cleansing Hour,82216,0,82216,2020.csv,2020,0.0,1.0
17471,Naachiyaar,82191,0,82191,2018.csv,2018,0.0,1.0
17472,Hvernig á að vera Klassa Drusla,82183,0,82183,2021.csv,2021,0.0,1.0
17473,On the Basis of Sex 2020 Re-release,82150,82150,0,2020.csv,2020,1.0,0.0
17474,Dogs,82144,0,82144,2016.csv,2016,0.0,1.0
17475,Nativity! 2010 Re-release,82081,0,82081,2010.csv,2010,0.0,1.0
17476,Puthan Panam,82067,0,82067,2017.csv,2017,0.0,1.0
17477,Just a Beginning,82066,0,82066,2012.csv,2012,0.0,1.0
17478,Artilheiro,82030,0,82030,2012.csv,2012,0.0,1.0
17479,Wind with the Gone,82012,0,82012,2010.csv,2010,0.0,1.0
17480,Once Upon a Time Veronica,81925,0,81925,2012.csv,2012,0.0,1.0
17481,Los pájaros se van con la muerte,81920,0,81920,2013.csv,2013,0.0,1.0
17482,Posledniy bogatyr 2019 Re-release,81918,0,81918,2019.csv,2019,0.0,1.0
17483,The Whale,81881,81881,0,2011.csv,2011,1.0,0.0
17484,Silk Road Hero: Khan's Arrow,81873,0,81873,2016.csv,2016,0.0,1.0
17485,What We Forgot to Remember,81870,0,81870,2020.csv,2020,0.0,1.0
17486,House No. 7,81834,0,81834,2018.csv,2018,0.0,1.0
17487,King Cobra,81757,81757,0,2016.csv,2016,1.0,0.0
17488,Saimon & Tada Takashi,81727,0,81727,2019.csv,2019,0.0,1.0
17489,Mad to Be Normal,81725,0,81725,2017.csv,2017,0.0,1.0
17490,The Big Four,81690,0,81690,2010.csv,2010,0.0,1.0
17491,Stray,81688,0,81688,2018.csv,2018,0.0,1.0
17492,UNindian,81633,0,81633,2015.csv,2015,0.0,1.0
17493,Vontade e Vencer,81628,0,81628,2015.csv,2015,0.0,1.0
17494,Diamond Island,81613,0,81613,2016.csv,2016,0.0,1.0
17495,Inkubus,81600,81600,0,2011.csv,2011,1.0,0.0
17496,The Kovak Box 2011 Re-release,81580,0,81580,2011.csv,2011,0.0,1.0
17497,Hush,81578,0,81578,2012.csv,2012,0.0,1.0
17498,Little Manhattan 2018 Re-release,81561,0,81561,2018.csv,2018,0.0,1.0
17499,Be Alarmed,81557,0,81557,2017.csv,2017,0.0,1.0
17500,Hotel Salvation,81540,0,81540,2017.csv,2017,0.0,1.0
17501,Riders of Pylos,81538,0,81538,2011.csv,2011,0.0,1.0
17502,Alone with You,81494,0,81494,2013.csv,2013,0.0,1.0
17503,The Golden Horse,81476,0,81476,2014.csv,2014,0.0,1.0
17504,The German Friend,81473,0,81473,2012.csv,2012,0.0,1.0
17505,Hating Breitbart,81432,81432,0,2012.csv,2012,1.0,0.0
17506,Pompeii: Captured Love,81382,0,81382,2013.csv,2013,0.0,1.0
17507,The Girl in the Book,81379,8245,73134,2015.csv,2015,0.10131606434092333,0.8986839356590767
17508,OK Kanmani,81340,0,81340,2015.csv,2015,0.0,1.0
17509,Comeback,81323,0,81323,2015.csv,2015,0.0,1.0
17510,"Please, Please Me! 2011 Re-release",81307,0,81307,2011.csv,2011,0.0,1.0
17511,Shopkins World Vacation,81279,0,81279,2017.csv,2017,0.0,1.0
17512,Republic Z,81237,0,81237,2018.csv,2018,0.0,1.0
17513,Mang dao,81235,0,81235,2018.csv,2018,0.0,1.0
17514,We Are What We Are,81214,0,81214,2010.csv,2010,0.0,1.0
17515,Pseudo,81196,0,81196,2013.csv,2013,0.0,1.0
17516,Intrude the Widow Village at Midnight,81191,0,81191,2017.csv,2017,0.0,1.0
17517,La Prima Luce,81146,0,81146,2015.csv,2015,0.0,1.0
17518,Patel Ki Punjabi Shaadi,81088,0,81088,2017.csv,2017,0.0,1.0
17519,Cuentos de la selva,81041,0,81041,2010.csv,2010,0.0,1.0
17520,Yomeddine,81030,11308,69722,2018.csv,2018,0.139553251882019,0.8604467481179809
17521,The Island President,80996,76398,4598,2012.csv,2012,0.9432317645315818,0.05676823546841819
17522,Burning Bush,80943,16731,64212,2013.csv,2013,0.2067010118231348,0.7932989881768652
17523,Woman Walks Ahead,80912,57528,23384,2018.csv,2018,0.7109946608661262,0.28900533913387383
17524,Taur Mittran Di,80879,69510,11369,2012.csv,2012,0.8594319909988996,0.14056800900110042
17525,Kind Hearts and Coronets 2019 Re-release,80795,35948,44847,2019.csv,2019,0.444928522804629,0.555071477195371
17526,Nasty Baby,80772,79800,972,2015.csv,2015,0.98796612687565,0.012033873124350022
17527,The Row,80749,0,80749,2019.csv,2019,0.0,1.0
17528,Braid,80745,0,80745,2019.csv,2019,0.0,1.0
17529,Disciple,80741,0,80741,2013.csv,2013,0.0,1.0
17530,Trace Amounts,80735,80735,0,2015.csv,2015,1.0,0.0
17531,Huan hun 2010 Re-release,80711,0,80711,2010.csv,2010,0.0,1.0
17532,Batman Returns 2019 Re-release,80699,70642,10057,2019.csv,2019,0.8753763987162171,0.12462360128378294
17533,Noura's Dream,80675,0,80675,2019.csv,2019,0.0,1.0
17534,Lasciami per sempre,80666,0,80666,2017.csv,2017,0.0,1.0
17535,Ms. Purple,80657,80657,0,2019.csv,2019,1.0,0.0
17536,Enemies of the People,80654,73171,7483,2010.csv,2010,0.9072209685818434,0.09277903141815658
17537,Winnie Mandela,80634,80634,0,2013.csv,2013,1.0,0.0
17538,Sarvann,80623,0,80623,2017.csv,2017,0.0,1.0
17539,Jack,80552,0,80552,2014.csv,2014,0.0,1.0
17540,Taxiwala,80486,0,80486,2018.csv,2018,0.0,1.0
17541,The Last Dance,80454,0,80454,2014.csv,2014,0.0,1.0
17542,Human,80410,0,80410,2016.csv,2016,0.0,1.0
17543,Two Tales,80380,0,80380,2018.csv,2018,0.0,1.0
17544,The Racer,80361,0,80361,2020.csv,2020,0.0,1.0
17545,The Imagined Wolf,80308,0,80308,2019.csv,2019,0.0,1.0
17546,Impávido,80250,0,80250,2012.csv,2012,0.0,1.0
17547,Dong feng po,80236,0,80236,2010.csv,2010,0.0,1.0
17548,Nurse 3D,80231,0,80231,2014.csv,2014,0.0,1.0
17549,Kim-Gun,80227,0,80227,2019.csv,2019,0.0,1.0
17550,Keep Calm and Snap,80187,0,80187,2019.csv,2019,0.0,1.0
17551,Armstrong,80169,19740,60429,2019.csv,2019,0.24622983946413202,0.753770160535868
17552,For the Love of Spock,80141,80141,0,2016.csv,2016,1.0,0.0
17553,Inhale,80112,4115,75997,2010.csv,2010,0.051365588176552825,0.9486344118234472
17554,For Better or Worse,80111,0,80111,2013.csv,2013,0.0,1.0
17555,Ramaiya Vastavaiya,80108,80108,0,2013.csv,2013,1.0,0.0
17556,iHuman,80105,0,80105,2020.csv,2020,0.0,1.0
17557,We Have Always Lived in the Castle,80094,0,80094,2019.csv,2019,0.0,1.0
17558,Killing Ground,80051,0,80051,2017.csv,2017,0.0,1.0
17559,Mystery Zone: soul Eating Hill,79980,0,79980,2017.csv,2017,0.0,1.0
17560,A Happy Man,79921,0,79921,2010.csv,2010,0.0,1.0
17561,Merhaba Güzel Vatanim,79892,0,79892,2019.csv,2019,0.0,1.0
17562,Bushwick,79888,0,79888,2017.csv,2017,0.0,1.0
17563,En el séptimo día,79887,79887,0,2018.csv,2018,1.0,0.0
17564,Bas Belasi,79856,0,79856,2017.csv,2017,0.0,1.0
17565,Peggy Guggenheim: Art Addict 2017 Re-release,79818,0,79818,2017.csv,2017,0.0,1.0
17566,So So,79812,0,79812,2012.csv,2012,0.0,1.0
17567,Jatt Boys Putt Jattan De,79765,0,79765,2013.csv,2013,0.0,1.0
17568,Gaddalakonda Ganesh,79756,0,79756,2019.csv,2019,0.0,1.0
17569,Juegos inocentes,79723,0,79723,2010.csv,2010,0.0,1.0
17570,Lora ot sutrin do vecher,79721,0,79721,2011.csv,2011,0.0,1.0
17571,That Good Night,79711,0,79711,2018.csv,2018,0.0,1.0
17572,Shepherds and Butchers,79711,0,79711,2016.csv,2016,0.0,1.0
17573,Wie die anderen,79707,0,79707,2015.csv,2015,0.0,1.0
17574,The Wild Fields,79668,0,79668,2018.csv,2018,0.0,1.0
17575,Aurangzeb,79665,0,79665,2013.csv,2013,0.0,1.0
17576,Cleanskin,79664,0,79664,2012.csv,2012,0.0,1.0
17577,10 Rules for Falling in Love 2013 Re-release,79645,0,79645,2013.csv,2013,0.0,1.0
17578,Zone Pro Site: The Moveable Feast,79643,0,79643,2013.csv,2013,0.0,1.0
17579,Harvest of Empire,79627,79627,0,2012.csv,2012,1.0,0.0
17580,Camp X-Ray,79624,13302,66322,2014.csv,2014,0.16706018285943935,0.8329398171405606
17581,Dorst,79623,0,79623,2018.csv,2018,0.0,1.0
17582,El Estudiante 2010 Re-release,79562,0,79562,2010.csv,2010,0.0,1.0
17583,Can't Say Goodbye,79543,0,79543,2017.csv,2017,0.0,1.0
17584,Joanna,79540,0,79540,2010.csv,2010,0.0,1.0
17585,Cherkess,79532,0,79532,2011.csv,2011,0.0,1.0
17586,A Tramway in Jerusalem,79507,0,79507,2019.csv,2019,0.0,1.0
17587,388 Arletta Avenue,79500,0,79500,2012.csv,2012,0.0,1.0
17588,Efsunlu Ayin,79498,0,79498,2020.csv,2020,0.0,1.0
17589,Euphoria,79451,0,79451,2018.csv,2018,0.0,1.0
17590,Between Friends: Ithala,79410,0,79410,2014.csv,2014,0.0,1.0
17591,6 Points About Emma,79406,0,79406,2011.csv,2011,0.0,1.0
17592,Onder het hart,79330,0,79330,2015.csv,2015,0.0,1.0
17593,Amn Dawlat,79298,0,79298,2012.csv,2012,0.0,1.0
17594,Butterfly Sleep,79296,0,79296,2018.csv,2018,0.0,1.0
17595,Ghost Day,79292,0,79292,2012.csv,2012,0.0,1.0
17596,Kiki: Lanet-i Cin,79225,0,79225,2020.csv,2020,0.0,1.0
17597,Kaavalan,79185,0,79185,2011.csv,2011,0.0,1.0
17598,Jayne Mansfield's Car,79178,14836,64342,2013.csv,2013,0.18737528101240244,0.8126247189875976
17599,Alanis,79172,0,79172,2017.csv,2017,0.0,1.0
17600,Harry Potter and the Deathly Hallows: Part 1 2020 Re-release,79140,0,79140,2020.csv,2020,0.0,1.0
17601,Birds of Paradise 2011 Re-release,79136,0,79136,2011.csv,2011,0.0,1.0
17602,Wu Dang,79102,0,79102,2012.csv,2012,0.0,1.0
17603,The Price of Crime,79088,0,79088,2016.csv,2016,0.0,1.0
17604,Rara,79081,0,79081,2016.csv,2016,0.0,1.0
17605,The Descent 2010 Re-release,78974,0,78974,2010.csv,2010,0.0,1.0
17606,Averno,78969,0,78969,2018.csv,2018,0.0,1.0
17607,Concussion,78957,42606,36351,2013.csv,2013,0.5396101675595577,0.4603898324404423
17608,Fort McCoy,78948,78948,0,2014.csv,2014,1.0,0.0
17609,Under the Mark,78920,0,78920,2015.csv,2015,0.0,1.0
17610,How Old Are You?,78897,0,78897,2014.csv,2014,0.0,1.0
17611,Kosmos,78880,0,78880,2010.csv,2010,0.0,1.0
17612,Ivy,78862,0,78862,2015.csv,2015,0.0,1.0
17613,Strawberry Cliff,78809,0,78809,2011.csv,2011,0.0,1.0
17614,Impy's Wonderland 2012 Re-release,78805,0,78805,2012.csv,2012,0.0,1.0
17615,Lanet: Ervah Cinleri,78769,0,78769,2017.csv,2017,0.0,1.0
17616,White Buffalo,78748,0,78748,2011.csv,2011,0.0,1.0
17617,Christ Stopped at Eboli,78736,78736,0,2019.csv,2019,1.0,0.0
17618,Como agua para chocolate 2011 Re-release,78733,0,78733,2011.csv,2011,0.0,1.0
17619,Firstborn,78730,0,78730,2017.csv,2017,0.0,1.0
17620,El Pepe: A Supreme Life,78683,0,78683,2019.csv,2019,0.0,1.0
17621,Playmate,78681,0,78681,2011.csv,2011,0.0,1.0
17622,The Boxcar Children - Surprise Island,78676,78676,0,2018.csv,2018,1.0,0.0
17623,Linhas de Sangue,78649,0,78649,2018.csv,2018,0.0,1.0
17624,Cracks in Concrete,78649,0,78649,2014.csv,2014,0.0,1.0
17625,NTR Kathanayakudu,78538,0,78538,2019.csv,2019,0.0,1.0
17626,Good and Prosperous,78538,0,78538,2017.csv,2017,0.0,1.0
17627,Tim Chong Cho Me,78512,0,78512,2019.csv,2019,0.0,1.0
17628,The Elf Who Stole Christmas,78456,0,78456,2011.csv,2011,0.0,1.0
17629,Babamin Sesi,78440,0,78440,2012.csv,2012,0.0,1.0
17630,West Is West 2014 Re-release,78435,0,78435,2014.csv,2014,0.0,1.0
17631,Nganfa,78427,0,78427,2013.csv,2013,0.0,1.0
17632,G Affairs,78419,0,78419,2019.csv,2019,0.0,1.0
17633,Blackbird,78400,78400,0,2015.csv,2015,1.0,0.0
17634,Lola,78354,0,78354,2019.csv,2019,0.0,1.0
17635,Raabta,78325,0,78325,2017.csv,2017,0.0,1.0
17636,Forrest Gump 2020 Re-release,78318,0,78318,2020.csv,2020,0.0,1.0
17637,Harold and Lillian: A Hollywood Love Story,78301,78301,0,2017.csv,2017,1.0,0.0
17638,Ávaxtakarfan,78296,0,78296,2012.csv,2012,0.0,1.0
17639,Colliding Dreams,78288,78288,0,2016.csv,2016,1.0,0.0
17640,Anesthesia,78270,32163,46107,2016.csv,2016,0.41092372556535073,0.5890762744346493
17641,The Ark of Disperata,78266,0,78266,2017.csv,2017,0.0,1.0
17642,Mobile Home,78255,0,78255,2012.csv,2012,0.0,1.0
17643,FOMO: Fear of Missing Out,78254,0,78254,2019.csv,2019,0.0,1.0
17644,Nekrotronic,78206,0,78206,2019.csv,2019,0.0,1.0
17645,Hate Story IV,78134,0,78134,2018.csv,2018,0.0,1.0
17646,C/O Saira Banu,78132,0,78132,2017.csv,2017,0.0,1.0
17647,Bertsolari,78129,0,78129,2011.csv,2011,0.0,1.0
17648,Joseph et la fille,78108,0,78108,2010.csv,2010,0.0,1.0
17649,Nomad: In the Footsteps of Bruce Chatwin,78100,0,78100,2020.csv,2020,0.0,1.0
17650,Un traductor,78075,13509,64566,2018.csv,2018,0.17302593659942364,0.8269740634005763
17651,Sixth Commandment Cross,78073,0,78073,2012.csv,2012,0.0,1.0
17652,Tak fajn,78067,0,78067,2012.csv,2012,0.0,1.0
17653,11,78066,0,78066,2017.csv,2017,0.0,1.0
17654,Rezo,78053,0,78053,2018.csv,2018,0.0,1.0
17655,Animal Kingdom: Let's go Ape 2015 Re-release,78025,0,78025,2015.csv,2015,0.0,1.0
17656,Jodi Breakers,78024,52618,25406,2012.csv,2012,0.6743822413616323,0.32561775863836767
17657,Henri 4 2011 Re-release,77960,0,77960,2011.csv,2011,0.0,1.0
17658,The Curse of the Handsome Man,77959,0,77959,2020.csv,2020,0.0,1.0
17659,Trans Bavaria,77944,0,77944,2012.csv,2012,0.0,1.0
17660,Friday Night Horror,77918,0,77918,2012.csv,2012,0.0,1.0
17661,Chained,77839,0,77839,2020.csv,2020,0.0,1.0
17662,Yin Lingzhi,77809,0,77809,2016.csv,2016,0.0,1.0
17663,Summer Coda,77769,0,77769,2010.csv,2010,0.0,1.0
17664,The Combination: Redemption,77743,0,77743,2019.csv,2019,0.0,1.0
17665,Chto tvoryat muzhchiny! 2,77740,0,77740,2015.csv,2015,0.0,1.0
17666,Héctor 2015 Re-release,77682,0,77682,2015.csv,2015,0.0,1.0
17667,Doctor Strange 2020 Re-release,77681,0,77681,2020.csv,2020,0.0,1.0
17668,Never Ever,77659,0,77659,2016.csv,2016,0.0,1.0
17669,Belleville Cop 2021 Re-release,77657,0,77657,2021.csv,2021,0.0,1.0
17670,Love Is Strange,77649,0,77649,2012.csv,2012,0.0,1.0
17671,The Birth of New China,77621,0,77621,2019.csv,2019,0.0,1.0
17672,Table No. 21,77621,46720,30901,2013.csv,2013,0.6018989706393888,0.39810102936061115
17673,Joe Cinque's Consolation,77590,0,77590,2016.csv,2016,0.0,1.0
17674,Chevalier,77590,25696,51894,2015.csv,2015,0.3311766980280964,0.6688233019719036
17675,Talento Millonario,77589,0,77589,2017.csv,2017,0.0,1.0
17676,Egg Plan,77571,0,77571,2017.csv,2017,0.0,1.0
17677,Art Idol,77571,0,77571,2012.csv,2012,0.0,1.0
17678,Nightlight,77567,0,77567,2015.csv,2015,0.0,1.0
17679,The Go-Betweens: Right Here,77546,0,77546,2017.csv,2017,0.0,1.0
17680,Agatha and the Truth of Murder,77542,0,77542,2019.csv,2019,0.0,1.0
17681,Firardayiz,77534,0,77534,2017.csv,2017,0.0,1.0
17682,Circo,77466,77466,0,2011.csv,2011,1.0,0.0
17683,"Tiger, Blood in the Mouth",77451,0,77451,2016.csv,2016,0.0,1.0
17684,The Art of the Steal,77450,64065,13385,2014.csv,2014,0.8271788250484183,0.17282117495158167
17685,A Brighter Summer Day,77430,0,77430,2017.csv,2017,0.0,1.0
17686,Willy 1er,77400,0,77400,2016.csv,2016,0.0,1.0
17687,Breaking Upwards,77389,77389,0,2010.csv,2010,1.0,0.0
17688,A Love You,77357,0,77357,2015.csv,2015,0.0,1.0
17689,Presidentintekijät,77334,0,77334,2014.csv,2014,0.0,1.0
17690,The Amityville Murders,77206,0,77206,2019.csv,2019,0.0,1.0
17691,The Clearing,77182,0,77182,2020.csv,2020,0.0,1.0
17692,2008 Royal Philharmonic Symphony,77177,0,77177,2010.csv,2010,0.0,1.0
17693,Vantha Rajavathaan Varuven,77173,0,77173,2019.csv,2019,0.0,1.0
17694,To Catch a Dollar: Muhammad Yunus Banks on America,77142,77142,0,2011.csv,2011,1.0,0.0
17695,Parchi,77110,69431,7679,2018.csv,2018,0.9004149915704838,0.09958500842951627
17696,La semilla del silencio,77096,0,77096,2016.csv,2016,0.0,1.0
17697,The State Against Mandela and the Others,76955,0,76955,2018.csv,2018,0.0,1.0
17698,Jigsaw Puzzle,76938,0,76938,2012.csv,2012,0.0,1.0
17699,The Missing Picture,76933,52164,24769,2014.csv,2014,0.6780445322553391,0.32195546774466094
17700,Fast Color,76916,76916,0,2019.csv,2019,1.0,0.0
17701,Dafne,76899,0,76899,2019.csv,2019,0.0,1.0
17702,Looking Glass,76788,0,76788,2018.csv,2018,0.0,1.0
17703,"My Son, My Son, What Have Ye Done",76739,0,76739,2010.csv,2010,0.0,1.0
17704,Almeno tu nell'universo,76708,0,76708,2011.csv,2011,0.0,1.0
17705,Vengeance 2011 Re-release,76652,0,76652,2011.csv,2011,0.0,1.0
17706,Our Lady of the Nile,76635,0,76635,2020.csv,2020,0.0,1.0
17707,Mademoiselle C,76621,48668,27953,2013.csv,2013,0.6351783453622375,0.3648216546377625
17708,Viaje a Tombuctú,76617,0,76617,2014.csv,2014,0.0,1.0
17709,Pride 2017 Re-release,76600,0,76600,2017.csv,2017,0.0,1.0
17710,Half the Sky,76483,0,76483,2019.csv,2019,0.0,1.0
17711,Dummy,76467,0,76467,2011.csv,2011,0.0,1.0
17712,My Tomorrow,76463,0,76463,2011.csv,2011,0.0,1.0
17713,The New Rijksmuseum - The Film,76460,40578,35882,2015.csv,2015,0.5307088673816375,0.4692911326183625
17714,Dos a la carta,76434,0,76434,2014.csv,2014,0.0,1.0
17715,Dirty Bomb,76414,0,76414,2011.csv,2011,0.0,1.0
17716,Super Bear,76322,0,76322,2020.csv,2020,0.0,1.0
17717,The Man Who Was Too Free,76319,0,76319,2017.csv,2017,0.0,1.0
17718,Zer,76271,0,76271,2017.csv,2017,0.0,1.0
17719,Ever After,76243,0,76243,2019.csv,2019,0.0,1.0
17720,Be with Me,76222,0,76222,2010.csv,2010,0.0,1.0
17721,Broers,76208,0,76208,2017.csv,2017,0.0,1.0
17722,Being AP,76196,0,76196,2015.csv,2015,0.0,1.0
17723,Night Catches Us,76185,76185,0,2010.csv,2010,1.0,0.0
17724,Don't Blink,76134,76134,0,2016.csv,2016,1.0,0.0
17725,Har Kisse Ke Hisse: Kaamyaab,76120,0,76120,2020.csv,2020,0.0,1.0
17726,Thirst 2011 Re-release,76086,0,76086,2011.csv,2011,0.0,1.0
17727,Venky Mama,76083,0,76083,2019.csv,2019,0.0,1.0
17728,93Queen,76056,76056,0,2018.csv,2018,1.0,0.0
17729,Greener Grass,76045,51456,24589,2019.csv,2019,0.6766519823788546,0.3233480176211454
17730,Alibaba,75960,0,75960,2011.csv,2011,0.0,1.0
17731,Daaka,75949,0,75949,2019.csv,2019,0.0,1.0
17732,True Legend 2011 Re-release,75889,0,75889,2011.csv,2011,0.0,1.0
17733,Only Love Can Do This to Me,75888,0,75888,2019.csv,2019,0.0,1.0
17734,Weekend 2012 Re-release,75884,0,75884,2012.csv,2012,0.0,1.0
17735,Whitey: United States of America v. James J. Bulger,75881,75881,0,2014.csv,2014,1.0,0.0
17736,Wish You Were Here 2013 Re-release,75870,46347,29523,2013.csv,2013,0.6108738631870304,0.38912613681296954
17737,Umut Üzümleri,75830,0,75830,2013.csv,2013,0.0,1.0
17738,American Folk 2020 Re-release,75829,0,75829,2020.csv,2020,0.0,1.0
17739,The Dwarves Must Be Crazy,75820,0,75820,2016.csv,2016,0.0,1.0
17740,Afterparty,75812,0,75812,2013.csv,2013,0.0,1.0
17741,Catching Haider,75793,0,75793,2015.csv,2015,0.0,1.0
17742,Into the White 2013 Re-release,75747,704,75043,2013.csv,2013,0.009294097456004858,0.9907059025439952
17743,Rarandoi Veduka Chudham,75705,0,75705,2017.csv,2017,0.0,1.0
17744,Maari 2,75689,0,75689,2018.csv,2018,0.0,1.0
17745,Yongsoon,75674,0,75674,2017.csv,2017,0.0,1.0
17746,Ghost Love Story,75651,0,75651,2011.csv,2011,0.0,1.0
17747,The Allure of Tears,75624,0,75624,2012.csv,2012,0.0,1.0
17748,Twee Grade van Moord,75568,0,75568,2016.csv,2016,0.0,1.0
17749,The Zigzag Kid,75544,0,75544,2012.csv,2012,0.0,1.0
17750,Touch Me Not,75507,13782,61725,2018.csv,2018,0.18252612340577695,0.8174738765942231
17751,The Riot Act,75506,75506,0,2018.csv,2018,1.0,0.0
17752,Swim Little Fish Swim,75504,3877,71627,2014.csv,2014,0.05134827293918203,0.948651727060818
17753,Gold 2018 Re-release,75495,0,75495,2018.csv,2018,0.0,1.0
17754,El Pozo,75469,0,75469,2012.csv,2012,0.0,1.0
17755,"Les trois frères, le retour 2015 Re-release",75454,0,75454,2015.csv,2015,0.0,1.0
17756,We Are Family 2015 Re-release,75421,0,75421,2015.csv,2015,0.0,1.0
17757,Manaslu - Berg der Seelen,75381,0,75381,2019.csv,2019,0.0,1.0
17758,The Valdemar Legacy 2011 Re-release,75345,0,75345,2011.csv,2011,0.0,1.0
17759,Adventures of Petey and Friends,75235,0,75235,2018.csv,2018,0.0,1.0
17760,The Metropolitan Opera HD Live: Lehár: The Merry Widow,75229,0,75229,2015.csv,2015,0.0,1.0
17761,The Canal,75212,0,75212,2014.csv,2014,0.0,1.0
17762,Ting jian xia yu de sheng yin,75212,0,75212,2013.csv,2013,0.0,1.0
17763,Oh Baby,75188,0,75188,2019.csv,2019,0.0,1.0
17764,40-Love,75168,0,75168,2014.csv,2014,0.0,1.0
17765,Heaven on Earth 2010 Re-release,75119,0,75119,2010.csv,2010,0.0,1.0
17766,El Cinco,75067,0,75067,2015.csv,2015,0.0,1.0
17767,Savage,75063,0,75063,2019.csv,2019,0.0,1.0
17768,David Bowie Is 2016 Re-release,75060,0,75060,2016.csv,2016,0.0,1.0
17769,Venise sous la neige,75023,0,75023,2017.csv,2017,0.0,1.0
17770,Crescendo,74993,0,74993,2020.csv,2020,0.0,1.0
17771,My Own Love Song 2011 Re-release,74964,0,74964,2011.csv,2011,0.0,1.0
17772,My Last Valentine in Beirut in 3D,74923,0,74923,2012.csv,2012,0.0,1.0
17773,Bill Nye: Science Guy,74909,74909,0,2017.csv,2017,1.0,0.0
17774,TS Pussy Hunters: Anime: Fucking in a Virtual World w/Transsexual Kitty Doll & Her Pet,74908,0,74908,2012.csv,2012,0.0,1.0
17775,Springsteen and I,74906,0,74906,2013.csv,2013,0.0,1.0
17776,Roco Kingdom: The Desire of Dragon 2014 Re-release,74889,0,74889,2014.csv,2014,0.0,1.0
17777,Where Is Kyra?,74821,59717,15104,2018.csv,2018,0.7981315406102565,0.20186845938974352
17778,Maria do Caritó,74814,0,74814,2019.csv,2019,0.0,1.0
17779,Odnoklassniki,74799,0,74799,2010.csv,2010,0.0,1.0
17780,Snabba Cash 2013 Re-release,74788,0,74788,2013.csv,2013,0.0,1.0
17781,My Missing Valentine,74787,0,74787,2021.csv,2021,0.0,1.0
17782,Raven the Little Rascal 2015 Re-release,74763,0,74763,2015.csv,2015,0.0,1.0
17783,Sami Oxide El Carbone,74757,0,74757,2011.csv,2011,0.0,1.0
17784,Sadako 3D 2013 Re-release,74736,0,74736,2013.csv,2013,0.0,1.0
17785,The Two Horses of Genghis Khan,74716,0,74716,2010.csv,2010,0.0,1.0
17786,The Ornithologist,74714,50511,24203,2016.csv,2016,0.6760580346387558,0.3239419653612442
17787,Above and Beyond: NASA's Journey to Tomorrow,74711,74711,0,2018.csv,2018,1.0,0.0
17788,Stormland,74709,0,74709,2011.csv,2011,0.0,1.0
17789,Batkid Begins: The Wish Heard Around the World,74709,74709,0,2015.csv,2015,1.0,0.0
17790,The Monster,74700,12544,62156,2016.csv,2016,0.16792503346720214,0.8320749665327979
17791,Gunshot,74688,0,74688,2018.csv,2018,0.0,1.0
17792,Ip Man 3 2017 Re-release,74680,0,74680,2017.csv,2017,0.0,1.0
17793,Timmy's Cinema Adventure,74665,0,74665,2020.csv,2020,0.0,1.0
17794,The World Is Mine,74664,0,74664,2015.csv,2015,0.0,1.0
17795,The Flight Before Christmas 2011 Re-release,74646,0,74646,2011.csv,2011,0.0,1.0
17796,Pliusas,74637,0,74637,2018.csv,2018,0.0,1.0
17797,PG lin oi ji yin,74637,0,74637,2016.csv,2016,0.0,1.0
17798,We Come as Friends,74633,50921,23712,2014.csv,2014,0.6822853161470127,0.3177146838529873
17799,At the Devil's Door,74624,0,74624,2015.csv,2015,0.0,1.0
17800,The Elephant King,74589,0,74589,2019.csv,2019,0.0,1.0
17801,Hadewijch,74586,5006,69580,2010.csv,2010,0.0671171533531762,0.9328828466468237
17802,Harry Potter and the Goblet of Fire 2020 Re-release,74533,0,74533,2020.csv,2020,0.0,1.0
17803,Stations of the Cross,74509,1505,73004,2014.csv,2014,0.02019890214604947,0.9798010978539505
17804,Knockout,74457,0,74457,2019.csv,2019,0.0,1.0
17805,Made in Bangladesh,74432,5322,69110,2019.csv,2019,0.07150150472914875,0.9284984952708513
17806,Aznavour by Charles,74394,0,74394,2019.csv,2019,0.0,1.0
17807,Woman Without Piano,74392,0,74392,2010.csv,2010,0.0,1.0
17808,Song Song,74389,0,74389,2021.csv,2021,0.0,1.0
17809,The Poet and the Boy,74371,0,74371,2017.csv,2017,0.0,1.0
17810,El rati horror show,74350,0,74350,2010.csv,2010,0.0,1.0
17811,Reset,74341,5454,68887,2016.csv,2016,0.07336463055379938,0.9266353694462006
17812,No. 1 Chung Ying Street,74337,0,74337,2018.csv,2018,0.0,1.0
17813,The Handmaiden 2019 Re-release,74320,0,74320,2019.csv,2019,0.0,1.0
17814,Muj vysvlecenej denik,74313,0,74313,2012.csv,2012,0.0,1.0
17815,The Apaches,74287,0,74287,2015.csv,2015,0.0,1.0
17816,Two Countries,74236,0,74236,2016.csv,2016,0.0,1.0
17817,Invasion 2018 Re-release,74152,0,74152,2018.csv,2018,0.0,1.0
17818,Cha-lui Taekhobfah,74130,0,74130,2015.csv,2015,0.0,1.0
17819,Karisma Bende,74122,0,74122,2019.csv,2019,0.0,1.0
17820,The Case,74121,0,74121,2018.csv,2018,0.0,1.0
17821,La horse 2011 Re-release,74108,0,74108,2011.csv,2011,0.0,1.0
17822,HDSP: Hunting Down Small Predators,74059,0,74059,2010.csv,2010,0.0,1.0
17823,Where the Fire Burns,74038,0,74038,2012.csv,2012,0.0,1.0
17824,My Neighbor Totoro 2020 Re-release,74019,0,74019,2020.csv,2020,0.0,1.0
17825,Grain,74017,0,74017,2017.csv,2017,0.0,1.0
17826,Organik Ask,74011,0,74011,2018.csv,2018,0.0,1.0
17827,The Boy Downstairs,73988,13638,60350,2018.csv,2018,0.1843271881926799,0.8156728118073201
17828,The Prague Orgy,73940,0,73940,2019.csv,2019,0.0,1.0
17829,The Keeping Room,73922,27166,46756,2015.csv,2015,0.3674954681962068,0.6325045318037932
17830,"All's Well, Ends Well 2012 2016 Re-release",73903,0,73903,2016.csv,2016,0.0,1.0
17831,After Auschwitz,73885,73885,0,2018.csv,2018,1.0,0.0
17832,Wunder der Lebenskraft,73820,0,73820,2015.csv,2015,0.0,1.0
17833,Mogul Mowgli,73785,0,73785,2020.csv,2020,0.0,1.0
17834,Everyday Hero,73772,0,73772,2017.csv,2017,0.0,1.0
17835,King Lear 2014 Re-release,73742,0,73742,2014.csv,2014,0.0,1.0
17836,War Pigs,73701,0,73701,2015.csv,2015,0.0,1.0
17837,Gong-dong-jeong-beom,73686,0,73686,2018.csv,2018,0.0,1.0
17838,Las Malcogidas,73680,0,73680,2017.csv,2017,0.0,1.0
17839,The Island,73676,0,73676,2011.csv,2011,0.0,1.0
17840,Love and Revolution,73621,0,73621,2011.csv,2011,0.0,1.0
17841,Rammstein in Amerika,73592,0,73592,2017.csv,2017,0.0,1.0
17842,Wait for Your Laugh,73585,73585,0,2017.csv,2017,1.0,0.0
17843,Bóg w Krakowie,73579,0,73579,2016.csv,2016,0.0,1.0
17844,Cake 2018 Re-release,73569,0,73569,2018.csv,2018,0.0,1.0
17845,Prodigal Sons,73544,73544,0,2010.csv,2010,1.0,0.0
17846,The Journals of Musan,73523,0,73523,2011.csv,2011,0.0,1.0
17847,National Theatre Live: Man and Superman,73522,0,73522,2015.csv,2015,0.0,1.0
17848,Diwanji Moola Grand Prix,73521,0,73521,2018.csv,2018,0.0,1.0
17849,On the Ice,73492,73492,0,2012.csv,2012,1.0,0.0
17850,AV Idol,73469,0,73469,2013.csv,2013,0.0,1.0
17851,18 Meals 2012 Re-release,73457,0,73457,2012.csv,2012,0.0,1.0
17852,The Lord of the Rings: The Fellowship of the Ring 2021 Re-release,73409,0,73409,2021.csv,2021,0.0,1.0
17853,Goltzius and the Pelican Company,73393,0,73393,2013.csv,2013,0.0,1.0
17854,Primal Rage: The Legend of Konga,73383,21497,51886,2018.csv,2018,0.2929425071201777,0.7070574928798223
17855,Beate,73361,0,73361,2018.csv,2018,0.0,1.0
17856,Goodfellas 2020 Re-release,73358,0,73358,2020.csv,2020,0.0,1.0
17857,Seraphine 2012 Re-release,73326,0,73326,2012.csv,2012,0.0,1.0
17858,Chariots of Fire 2016 Re-release,73324,0,73324,2016.csv,2016,0.0,1.0
17859,Flash Gordon 2020 Re-release,73310,0,73310,2020.csv,2020,0.0,1.0
17860,Meryem,73301,0,73301,2013.csv,2013,0.0,1.0
17861,I Want to Be a Soldier,73293,0,73293,2011.csv,2011,0.0,1.0
17862,Vengeance: A Love Story,73270,4526,68744,2017.csv,2017,0.06177152995769073,0.9382284700423092
17863,Senses 5,73255,0,73255,2018.csv,2018,0.0,1.0
17864,Paradise for the Damned,73244,0,73244,2013.csv,2013,0.0,1.0
17865,Dancing Beethoven,73240,0,73240,2017.csv,2017,0.0,1.0
17866,Marina Abramovic In Brazil: The Space In Between,73237,0,73237,2016.csv,2016,0.0,1.0
17867,Te Ata,73236,73236,0,2017.csv,2017,1.0,0.0
17868,Kaewnee Huajaisan,73235,0,73235,2013.csv,2013,0.0,1.0
17869,"Un Concierto Inolvidable: Nueva Ola, La Película",73192,0,73192,2014.csv,2014,0.0,1.0
17870,"Come, Closer",73187,0,73187,2010.csv,2010,0.0,1.0
17871,Fishtales 2,73161,0,73161,2019.csv,2019,0.0,1.0
17872,Target,73153,0,73153,2011.csv,2011,0.0,1.0
17873,The Tempest,73126,0,73126,2012.csv,2012,0.0,1.0
17874,CoCo Kokila,73124,0,73124,2018.csv,2018,0.0,1.0
17875,Antonio Lopez 1970: Sex Fashion & Disco,73122,43169,29953,2018.csv,2018,0.5903695194332759,0.40963048056672413
17876,Buster's Mal Heart,73121,73121,0,2017.csv,2017,1.0,0.0
17877,Os fenómenos,73103,0,73103,2014.csv,2014,0.0,1.0
17878,Poppie Nongena,73033,0,73033,2020.csv,2020,0.0,1.0
17879,Cerca de tu casa,73021,0,73021,2016.csv,2016,0.0,1.0
17880,Headshot,73010,0,73010,2017.csv,2017,0.0,1.0
17881,Fein Qalby,72973,0,72973,2017.csv,2017,0.0,1.0
17882,5B,72968,72968,0,2019.csv,2019,1.0,0.0
17883,La nostra vita 2013 Re-release,72955,0,72955,2013.csv,2013,0.0,1.0
17884,People in Places,72946,0,72946,2013.csv,2013,0.0,1.0
17885,Ona,72909,0,72909,2017.csv,2017,0.0,1.0
17886,The Human Centipede (First Sequence) 2011 Re-release,72906,0,72906,2011.csv,2011,0.0,1.0
17887,In Another Lifetime,72902,0,72902,2011.csv,2011,0.0,1.0
17888,Swinging with the Finkels,72897,0,72897,2011.csv,2011,0.0,1.0
17889,Fog in August,72895,0,72895,2017.csv,2017,0.0,1.0
17890,Daddy Cool 2010 Re-release,72863,0,72863,2010.csv,2010,0.0,1.0
17891,Super Crazy 2020 Re-release,72847,0,72847,2020.csv,2020,0.0,1.0
17892,Masha and the Bear: The Funniest Episodes,72837,0,72837,2016.csv,2016,0.0,1.0
17893,Ecinni: Tilsimli Mezar,72832,0,72832,2019.csv,2019,0.0,1.0
17894,Wild Witch,72821,0,72821,2018.csv,2018,0.0,1.0
17895,Do Not Resist,72791,72791,0,2016.csv,2016,1.0,0.0
17896,Let It Be,72776,0,72776,2010.csv,2010,0.0,1.0
17897,Mera Naam Shaji,72768,0,72768,2019.csv,2019,0.0,1.0
17898,Banklady,72764,0,72764,2014.csv,2014,0.0,1.0
17899,A.C.O.R.N.S.: Operation Crackdown 2019 Re-release,72758,0,72758,2019.csv,2019,0.0,1.0
17900,The Pro,72731,0,72731,2015.csv,2015,0.0,1.0
17901,Sunset Promise,72674,0,72674,2019.csv,2019,0.0,1.0
17902,Icarus,72643,0,72643,2010.csv,2010,0.0,1.0
17903,Cosa sarà,72624,0,72624,2020.csv,2020,0.0,1.0
17904,The Leadership,72614,0,72614,2020.csv,2020,0.0,1.0
17905,Roseville,72605,0,72605,2013.csv,2013,0.0,1.0
17906,Max 2: White House Hero,72585,0,72585,2017.csv,2017,0.0,1.0
17907,Deadtectives,72559,0,72559,2019.csv,2019,0.0,1.0
17908,"Jerico, the Infinite Flight of Days",72527,0,72527,2016.csv,2016,0.0,1.0
17909,Simple Passion,72358,0,72358,2021.csv,2021,0.0,1.0
17910,Who Gets the Dog?,72353,0,72353,2016.csv,2016,0.0,1.0
17911,Pray: The Story of Patrick Peyton,72347,72347,0,2020.csv,2020,1.0,0.0
17912,Xi Ha Ying Xiong,72265,0,72265,2019.csv,2019,0.0,1.0
17913,Iona,72241,0,72241,2016.csv,2016,0.0,1.0
17914,Blaze and the Monster Machines. Rusty Rivets,72203,0,72203,2019.csv,2019,0.0,1.0
17915,The Seventh Lie,72187,0,72187,2014.csv,2014,0.0,1.0
17916,Dharti,72174,0,72174,2011.csv,2011,0.0,1.0
17917,The Green Wave,72152,0,72152,2011.csv,2011,0.0,1.0
17918,Partisan,72151,0,72151,2015.csv,2015,0.0,1.0
17919,After Tiller,72125,72125,0,2013.csv,2013,1.0,0.0
17920,Take Me Somewhere Nice,72120,0,72120,2019.csv,2019,0.0,1.0
17921,Veil of Tears,72078,72078,0,2014.csv,2014,1.0,0.0
17922,A Fistful of Grapes,72076,0,72076,2016.csv,2016,0.0,1.0
17923,Bunyan and Babe,72060,0,72060,2018.csv,2018,0.0,1.0
17924,Dev,72048,0,72048,2019.csv,2019,0.0,1.0
17925,The Frozen Maze,72044,0,72044,2018.csv,2018,0.0,1.0
17926,My Egg Boy,72031,0,72031,2017.csv,2017,0.0,1.0
17927,Wild,72022,0,72022,2016.csv,2016,0.0,1.0
17928,Nova Lituania,72011,0,72011,2020.csv,2020,0.0,1.0
17929,The Invisible War,71968,71968,0,2012.csv,2012,1.0,0.0
17930,Zabak Ribit,71964,0,71964,2015.csv,2015,0.0,1.0
17931,The Chambermaid Lynn,71918,315,71603,2015.csv,2015,0.004379988320031147,0.9956200116799688
17932,Raiders!: The Story of the Greatest Fan Film Ever Made,71916,71916,0,2016.csv,2016,1.0,0.0
17933,The Woman with the 5 Elephants,71913,0,71913,2010.csv,2010,0.0,1.0
17934,Come and See 2020 Re-release,71909,71909,0,2020.csv,2020,1.0,0.0
17935,An Oversimplification of Her Beauty,71906,71906,0,2013.csv,2013,1.0,0.0
17936,MULT v kino. Vol 118,71894,0,71894,2020.csv,2020,0.0,1.0
17937,The Competition,71870,0,71870,2017.csv,2017,0.0,1.0
17938,Amor-Love,71843,0,71843,2011.csv,2011,0.0,1.0
17939,Luz de Soledad,71806,0,71806,2016.csv,2016,0.0,1.0
17940,The Most Fun You Can Have Dying,71792,0,71792,2012.csv,2012,0.0,1.0
17941,Re-encounter,71763,0,71763,2011.csv,2011,0.0,1.0
17942,As I Lay Dying,71759,16697,55062,2013.csv,2013,0.23268161484970526,0.7673183851502947
17943,Giselle,71754,0,71754,2013.csv,2013,0.0,1.0
17944,Runaway Slave,71737,71737,0,2012.csv,2012,1.0,0.0
17945,Flamenco Flamenco 2014 Re-release,71732,71732,0,2014.csv,2014,1.0,0.0
17946,Chicken People,71723,0,71723,2017.csv,2017,0.0,1.0
17947,"Je t'aime, je t'aime 2014 Re-release",71717,71717,0,2014.csv,2014,1.0,0.0
17948,The Dissident,71715,57000,14715,2020.csv,2020,0.794812800669316,0.20518719933068397
17949,The Day of Chocolate,71714,0,71714,2019.csv,2019,0.0,1.0
17950,Witches in the Woods,71640,0,71640,2019.csv,2019,0.0,1.0
17951,Love and Run,71637,0,71637,2019.csv,2019,0.0,1.0
17952,Russia from Above,71629,0,71629,2021.csv,2021,0.0,1.0
17953,Circles,71617,0,71617,2013.csv,2013,0.0,1.0
17954,Eisenstein in Guanajuato 2015 Re-release,71570,34282,37288,2016.csv,2016,0.4789995808299567,0.5210004191700434
17955,Skeem,71505,0,71505,2011.csv,2011,0.0,1.0
17956,The Four Agreements,71463,0,71463,2013.csv,2013,0.0,1.0
17957,Stare,71453,0,71453,2020.csv,2020,0.0,1.0
17958,The Congressman,71451,71451,0,2016.csv,2016,1.0,0.0
17959,The Body Tree,71432,0,71432,2018.csv,2018,0.0,1.0
17960,The Tashkent Files,71369,0,71369,2019.csv,2019,0.0,1.0
17961,Titanic 2020 Re-release,71352,0,71352,2020.csv,2020,0.0,1.0
17962,Dream Holiday,71345,0,71345,2012.csv,2012,0.0,1.0
17963,O Melhor Verão das Nossas Vidas,71333,0,71333,2020.csv,2020,0.0,1.0
17964,M,71313,0,71313,2017.csv,2017,0.0,1.0
17965,Free Rainer 2010 Re-release,71295,0,71295,2010.csv,2010,0.0,1.0
17966,Pin Cushion,71275,0,71275,2018.csv,2018,0.0,1.0
17967,The Sicilian Girl 2010 Re-release,71239,71239,0,2010.csv,2010,1.0,0.0
17968,Que viva la música,71236,0,71236,2015.csv,2015,0.0,1.0
17969,Pullikkaran Staraa,71225,0,71225,2017.csv,2017,0.0,1.0
17970,My Journey Through French Cinema,71174,52214,18960,2016.csv,2016,0.7336105881361171,0.2663894118638829
17971,"Spirits' Homecoming, Unfinished Story",71158,0,71158,2017.csv,2017,0.0,1.0
17972,The Magic Crystal 2012 Re-release,71141,0,71141,2012.csv,2012,0.0,1.0
17973,Love as Much as Pain,71140,0,71140,2019.csv,2019,0.0,1.0
17974,Miluj ma alebo odid,71130,0,71130,2013.csv,2013,0.0,1.0
17975,Persona,71126,0,71126,2017.csv,2017,0.0,1.0
17976,Walking Too Fast,71105,0,71105,2010.csv,2010,0.0,1.0
17977,Extraterrestrial,71103,0,71103,2016.csv,2016,0.0,1.0
17978,Free Trip to Egypt 2019 Re-release,71087,71087,0,2019.csv,2019,1.0,0.0
17979,Stung,71085,0,71085,2015.csv,2015,0.0,1.0
17980,Nausea,71022,0,71022,2015.csv,2015,0.0,1.0
17981,Rosencrantz and Guildenstern Are Undead,71007,71007,0,2010.csv,2010,1.0,0.0
17982,Drei Eier im Glas,71007,0,71007,2015.csv,2015,0.0,1.0
17983,The Cleaning Lady,71003,0,71003,2019.csv,2019,0.0,1.0
17984,Lunana: A Yak in the Classroom,70996,0,70996,2020.csv,2020,0.0,1.0
17985,Gerontophilia,70964,0,70964,2014.csv,2014,0.0,1.0
17986,Freaks of Nature,70958,70958,0,2015.csv,2015,1.0,0.0
17987,Norman Lear: Just Another Version of You,70950,70950,0,2016.csv,2016,1.0,0.0
17988,Manmadhudu 2,70936,0,70936,2019.csv,2019,0.0,1.0
17989,The Better Angels,70918,70918,0,2014.csv,2014,1.0,0.0
17990,Stoichkov,70889,0,70889,2012.csv,2012,0.0,1.0
17991,Sink,70857,0,70857,2016.csv,2016,0.0,1.0
17992,4:44 Last Day on Earth,70851,17801,53050,2012.csv,2012,0.2512455716927072,0.7487544283072928
17993,Snow in Spring 2012 Re-release,70849,0,70849,2012.csv,2012,0.0,1.0
17994,Miss Lovely,70845,0,70845,2014.csv,2014,0.0,1.0
17995,Drei Stunden,70842,0,70842,2013.csv,2013,0.0,1.0
17996,Butterfly zone - Il senso della farfalla,70836,0,70836,2010.csv,2010,0.0,1.0
17997,Valhalla - The Legend of Thor,70821,0,70821,2020.csv,2020,0.0,1.0
17998,First Love,70765,0,70765,2018.csv,2018,0.0,1.0
17999,Solo el Amor,70759,0,70759,2018.csv,2018,0.0,1.0
18000,Valiant Rooster,70661,0,70661,2015.csv,2015,0.0,1.0
18001,Chhota Bheem Kung Fu Dhamaka,70655,0,70655,2019.csv,2019,0.0,1.0
18002,Milice 2,70639,0,70639,2017.csv,2017,0.0,1.0
18003,How to Build a Girl,70632,70632,0,2020.csv,2020,1.0,0.0
18004,Seasons of Gray,70605,70605,0,2013.csv,2013,1.0,0.0
18005,Fireflies in the Garden 2011 Re-release,70600,70600,0,2011.csv,2011,1.0,0.0
18006,Grass Ring,70589,0,70589,2018.csv,2018,0.0,1.0
18007,GG Bond: Lollipop in Fantasy,70578,0,70578,2019.csv,2019,0.0,1.0
18008,Reverse,70553,0,70553,2015.csv,2015,0.0,1.0
18009,Road to Istanbul,70525,0,70525,2016.csv,2016,0.0,1.0
18010,Drifters,70521,0,70521,2012.csv,2012,0.0,1.0
18011,Go for Sisters,70495,70495,0,2013.csv,2013,1.0,0.0
18012,The Fog 2018 Re-release,70421,70421,0,2018.csv,2018,1.0,0.0
18013,Bar25,70343,0,70343,2012.csv,2012,0.0,1.0
18014,Takim: Mahalle Askina!,70328,0,70328,2015.csv,2015,0.0,1.0
18015,Gaston Lagaffe 2019 Re-release,70328,0,70328,2019.csv,2019,0.0,1.0
18016,Fist & Furious,70303,0,70303,2019.csv,2019,0.0,1.0
18017,Being Frank: The Chris Sievey Story,70301,0,70301,2019.csv,2019,0.0,1.0
18018,Journey to the Shore,70296,0,70296,2015.csv,2015,0.0,1.0
18019,Ladies and Gentlemen: The Rolling Stones,70287,0,70287,2010.csv,2010,0.0,1.0
18020,Tibetan Dog,70273,0,70273,2012.csv,2012,0.0,1.0
18021,Over Your Cities Grass Will Grow,70256,51301,18955,2010.csv,2010,0.7302009792757914,0.2697990207242086
18022,Pervoklashki,70233,0,70233,2013.csv,2013,0.0,1.0
18023,Pazarlari Hiç Sevmem,70177,0,70177,2012.csv,2012,0.0,1.0
18024,Lives in Flames,70168,0,70168,2012.csv,2012,0.0,1.0
18025,Askin Gören Gözlere Ihtiyaci yok,70161,0,70161,2018.csv,2018,0.0,1.0
18026,Kodachrome,70149,0,70149,2018.csv,2018,0.0,1.0
18027,Far from the Sea,70126,0,70126,2016.csv,2016,0.0,1.0
18028,Rememory,70124,0,70124,2018.csv,2018,0.0,1.0
18029,Yanimda Kal,70093,0,70093,2018.csv,2018,0.0,1.0
18030,Moral Order,70086,0,70086,2020.csv,2020,0.0,1.0
18031,Lose My Self,70069,0,70069,2014.csv,2014,0.0,1.0
18032,Hillary: Ocean to Sky,70049,0,70049,2019.csv,2019,0.0,1.0
18033,Wastelander,70045,70045,0,2018.csv,2018,1.0,0.0
18034,Xi Bai Po 2: Wang Er Xiao,70000,0,70000,2013.csv,2013,0.0,1.0
18035,Falling,69972,0,69972,2020.csv,2020,0.0,1.0
18036,Nick Mason's Saucerful of Secrets: Live at the Roundhouse,69967,32444,37523,2020.csv,2020,0.4637043177497963,0.5362956822502036
18037,Ghost in Transit,69965,0,69965,2020.csv,2020,0.0,1.0
18038,Tutta la vita davanti 2010 Re-release,69918,0,69918,2010.csv,2010,0.0,1.0
18039,Toi La Nao Ca Vang,69910,0,69910,2020.csv,2020,0.0,1.0
18040,Stars,69875,0,69875,2017.csv,2017,0.0,1.0
18041,Sarbjit,69867,0,69867,2016.csv,2016,0.0,1.0
18042,Sealers: One Last Hunt,69824,0,69824,2017.csv,2017,0.0,1.0
18043,Turn It Around: The Story of East Bay Punk,69787,69787,0,2017.csv,2017,1.0,0.0
18044,Les deux amis,69782,0,69782,2016.csv,2016,0.0,1.0
18045,Nararet Masr,69779,0,69779,2018.csv,2018,0.0,1.0
18046,Polite People,69745,0,69745,2011.csv,2011,0.0,1.0
18047,Son,69739,55068,14671,2021.csv,2021,0.7896299057915944,0.21037009420840563
18048,I Am Lying Now,69642,0,69642,2019.csv,2019,0.0,1.0
18049,Suddenly Seventeen 2018 Re-release,69616,0,69616,2018.csv,2018,0.0,1.0
18050,Mariposas Verdes,69609,0,69609,2017.csv,2017,0.0,1.0
18051,"She, a Chinese",69595,0,69595,2010.csv,2010,0.0,1.0
18052,Assassination of a High School President,69564,0,69564,2010.csv,2010,0.0,1.0
18053,El Rey del sapo,69547,0,69547,2019.csv,2019,0.0,1.0
18054,Chef Flynn,69542,68407,1135,2018.csv,2018,0.9836789278421674,0.016321072157832676
18055,Vive,69501,0,69501,2017.csv,2017,0.0,1.0
18056,Viaje a Surtsey,69481,0,69481,2013.csv,2013,0.0,1.0
18057,Second Chance,69460,0,69460,2015.csv,2015,0.0,1.0
18058,Hayati Mbahdala,69432,0,69432,2015.csv,2015,0.0,1.0
18059,Back to the Jurassic,69423,4351,65072,2015.csv,2015,0.0626737536551287,0.9373262463448713
18060,Super Furball,69416,0,69416,2019.csv,2019,0.0,1.0
18061,The Metropolitan Opera HD Live: Bizet: The Pearl Fishers,69401,0,69401,2016.csv,2016,0.0,1.0
18062,Zeroville,69396,0,69396,2019.csv,2019,0.0,1.0
18063,An Inconsistent Truth,69394,69394,0,2012.csv,2012,1.0,0.0
18064,The Accordionist's Son,69351,0,69351,2019.csv,2019,0.0,1.0
18065,Into the Forest,69311,0,69311,2017.csv,2017,0.0,1.0
18066,Siddharth,69310,60537,8773,2014.csv,2014,0.8734237483768575,0.1265762516231424
18067,Kamper,69305,0,69305,2016.csv,2016,0.0,1.0
18068,A Soldier's Courage,69290,0,69290,2018.csv,2018,0.0,1.0
18069,Rocky Handsome,69289,0,69289,2016.csv,2016,0.0,1.0
18070,Fuer Elise,69279,0,69279,2015.csv,2015,0.0,1.0
18071,Lego: The Adventures of Clutch Powers,69229,0,69229,2010.csv,2010,0.0,1.0
18072,Jungle Master 2014 Re-release,69229,0,69229,2014.csv,2014,0.0,1.0
18073,Dot 2 Dot,69216,0,69216,2014.csv,2014,0.0,1.0
18074,Luciferina,69209,0,69209,2018.csv,2018,0.0,1.0
18075,Blackia,69193,0,69193,2019.csv,2019,0.0,1.0
18076,Welcome to Argentina,69186,0,69186,2013.csv,2013,0.0,1.0
18077,Blood 13,69175,0,69175,2018.csv,2018,0.0,1.0
18078,The Ape Story,69174,0,69174,2016.csv,2016,0.0,1.0
18079,Madrasapattinam,69160,0,69160,2010.csv,2010,0.0,1.0
18080,The Magic of Children: Magic Attack,69157,0,69157,2016.csv,2016,0.0,1.0
18081,Oshan 14,69089,0,69089,2016.csv,2016,0.0,1.0
18082,Bajatey Raho,69085,55397,13688,2013.csv,2013,0.8018672649634508,0.19813273503654918
18083,Hotel Coolgardie,69057,0,69057,2017.csv,2017,0.0,1.0
18084,Broken Law,69024,0,69024,2020.csv,2020,0.0,1.0
18085,Dachra,69013,0,69013,2019.csv,2019,0.0,1.0
18086,Fireman Sam: Alien Alert 2018 Re-release,68992,0,68992,2018.csv,2018,0.0,1.0
18087,Ek Lief Jou,68973,0,68973,2011.csv,2011,0.0,1.0
18088,The Monk and the Demon,68963,0,68963,2016.csv,2016,0.0,1.0
18089,Kids For Rent,68955,0,68955,2017.csv,2017,0.0,1.0
18090,The White Sheik 2019 re-release,68940,50850,18090,2019.csv,2019,0.737597911227154,0.26240208877284593
18091,Eternal Beauty,68905,0,68905,2020.csv,2020,0.0,1.0
18092,My Entire High School Sinking Into the Sea,68883,68883,0,2017.csv,2017,1.0,0.0
18093,Sniper: Assassin's End,68881,0,68881,2020.csv,2020,0.0,1.0
18094,Wonderful and Loved by All 2010 Re-release,68879,0,68879,2010.csv,2010,0.0,1.0
18095,In the Market,68871,0,68871,2011.csv,2011,0.0,1.0
18096,All Things to All Men,68859,0,68859,2013.csv,2013,0.0,1.0
18097,The Unrepentant Youth,68836,0,68836,2018.csv,2018,0.0,1.0
18098,Klown 2012 Re-release,68795,68795,0,2012.csv,2012,1.0,0.0
18099,Sans adieu,68761,0,68761,2017.csv,2017,0.0,1.0
18100,Vücut,68744,0,68744,2012.csv,2012,0.0,1.0
18101,Strange Powers: Stephin Merritt and the Magnetic Fields,68719,68719,0,2010.csv,2010,1.0,0.0
18102,Anchor and Hope,68709,0,68709,2017.csv,2017,0.0,1.0
18103,Letters to Father Jacob 2011 Re-release,68691,0,68691,2011.csv,2011,0.0,1.0
18104,Karinca Kapani,68669,0,68669,2014.csv,2014,0.0,1.0
18105,John Wick 2020 Re-release,68655,0,68655,2017.csv,2017,0.0,1.0
18106,My Name Is Thomas,68623,0,68623,2018.csv,2018,0.0,1.0
18107,Noma: My Perfect Storm,68622,21130,47492,2015.csv,2015,0.30791874326017893,0.692081256739821
18108,Take Me to the River,68598,68598,0,2014.csv,2014,1.0,0.0
18109,What We've Become,68584,0,68584,2016.csv,2016,0.0,1.0
18110,Mastizaade,68583,43403,25180,2016.csv,2016,0.6328536226178499,0.3671463773821501
18111,Wildflower,68577,18062,50515,2016.csv,2016,0.2633827668168628,0.7366172331831372
18112,Jak uratowac mame,68574,0,68574,2016.csv,2016,0.0,1.0
18113,Station of the Forgotten,68570,0,68570,2010.csv,2010,0.0,1.0
18114,Fragrance,68555,0,68555,2019.csv,2019,0.0,1.0
18115,Resistance,68548,0,68548,2011.csv,2011,0.0,1.0
18116,Qarib Qarib Single,68502,0,68502,2017.csv,2017,0.0,1.0
18117,Outside In,68492,68492,0,2018.csv,2018,1.0,0.0
18118,Ta meg med!,68492,0,68492,2014.csv,2014,0.0,1.0
18119,Art of the Devil 3 2010 Re-release,68491,0,68491,2010.csv,2010,0.0,1.0
18120,Alive and Kicking,68485,68485,0,2017.csv,2017,1.0,0.0
18121,Last Year at Marienbad 2019 Re-release,68402,63425,4977,2019.csv,2019,0.9272389696207713,0.07276103037922868
18122,Santo Cachón,68378,0,68378,2018.csv,2018,0.0,1.0
18123,Budrus,68353,68353,0,2010.csv,2010,1.0,0.0
18124,The Metropolitan Opera HD Live: Wagner: Das Rheingold,68349,0,68349,2010.csv,2010,0.0,1.0
18125,Invisible,68344,0,68344,2019.csv,2019,0.0,1.0
18126,Iblis,68340,0,68340,2018.csv,2018,0.0,1.0
18127,2012: Time for Change,68339,68339,0,2010.csv,2010,1.0,0.0
18128,The Eyes of Orson Welles,68328,10253,58075,2018.csv,2018,0.15005561409670998,0.84994438590329
18129,Road,68325,0,68325,2015.csv,2015,0.0,1.0
18130,El secreto de los 24 escalones,68302,0,68302,2012.csv,2012,0.0,1.0
18131,The Diary of Diana B,68301,0,68301,2019.csv,2019,0.0,1.0
18132,Gloria Del Pacifico,68294,0,68294,2014.csv,2014,0.0,1.0
18133,10x10,68260,2263,65997,2018.csv,2018,0.033152651626135364,0.9668473483738647
18134,Orsai,68259,0,68259,2019.csv,2019,0.0,1.0
18135,Das Leben ist keine Generalprobe,68248,0,68248,2016.csv,2016,0.0,1.0
18136,Maidentrip,68243,68243,0,2013.csv,2013,1.0,0.0
18137,Ribbit 2018 Re-release,68241,0,68241,2018.csv,2018,0.0,1.0
18138,Mick Fleetwood & Friends celebrate the music of Peter Green,68235,0,68235,2021.csv,2021,0.0,1.0
18139,Nightfall in India,68220,0,68220,2014.csv,2014,0.0,1.0
18140,Last Child,68218,0,68218,2018.csv,2018,0.0,1.0
18141,"Sorry, Thanks",68173,0,68173,2011.csv,2011,0.0,1.0
18142,Le Amiche,68167,68167,0,2010.csv,2010,1.0,0.0
18143,Boys in Brazil,68163,0,68163,2014.csv,2014,0.0,1.0
18144,Mommy Is at the Hairdresser's,68130,0,68130,2010.csv,2010,0.0,1.0
18145,The Eulogy,68080,0,68080,2019.csv,2019,0.0,1.0
18146,Sultan,68071,0,68071,2021.csv,2021,0.0,1.0
18147,Simurg,68067,0,68067,2012.csv,2012,0.0,1.0
18148,¡He matado a mi marido!,68017,45777,22240,2019.csv,2019,0.6730229207404032,0.32697707925959685
18149,Nailed,68002,0,68002,2019.csv,2019,0.0,1.0
18150,Hero Naam Yaad Rakhi,67983,0,67983,2015.csv,2015,0.0,1.0
18151,The Japanese Wife,67923,0,67923,2010.csv,2010,0.0,1.0
18152,Your Beauty Is Worth Nothing,67876,0,67876,2013.csv,2013,0.0,1.0
18153,"Habi, la extranjera",67865,0,67865,2013.csv,2013,0.0,1.0
18154,I Am Big Bird: The Caroll Spinney Story,67845,67845,0,2015.csv,2015,1.0,0.0
18155,Ethel & Ernest 2018 Re-release,67842,0,67842,2018.csv,2018,0.0,1.0
18156,"Stroppy Cow, Stubborn Ram",67838,0,67838,2015.csv,2015,0.0,1.0
18157,The Messenger,67816,67816,0,2015.csv,2015,1.0,0.0
18158,Malu de Bicicleta,67754,0,67754,2011.csv,2011,0.0,1.0
18159,Arriya,67752,0,67752,2011.csv,2011,0.0,1.0
18160,Summer in the Forest,67743,45542,22201,2017.csv,2017,0.6722761023279158,0.3277238976720842
18161,Sanam Teri Kasam,67736,22121,45615,2016.csv,2016,0.32657670957836304,0.673423290421637
18162,Frankenstein,67731,0,67731,2011.csv,2011,0.0,1.0
18163,Shgaltana Arjantenia,67717,0,67717,2018.csv,2018,0.0,1.0
18164,Bebê Mais: Bichos II,67704,0,67704,2012.csv,2012,0.0,1.0
18165,The Be All and End All,67698,0,67698,2010.csv,2010,0.0,1.0
18166,1810 - Für eine Handvoll Kaspressknödl,67685,0,67685,2011.csv,2011,0.0,1.0
18167,Madam Butterfly 3D,67675,0,67675,2012.csv,2012,0.0,1.0
18168,That's Not Me,67560,0,67560,2017.csv,2017,0.0,1.0
18169,Premika,67541,0,67541,2017.csv,2017,0.0,1.0
18170,Khandaani Shafakhana,67534,0,67534,2019.csv,2019,0.0,1.0
18171,Lancaster Skies,67522,0,67522,2019.csv,2019,0.0,1.0
18172,Balla con noi - Let's Dance,67512,0,67512,2011.csv,2011,0.0,1.0
18173,The Greasy Strangler,67427,45878,21549,2016.csv,2016,0.6804099248075697,0.3195900751924303
18174,For No Good Reason,67421,67421,0,2014.csv,2014,1.0,0.0
18175,Coco 2010 Re-release,67420,0,67420,2010.csv,2010,0.0,1.0
18176,Making the Five Heartbeats,67415,67415,0,2018.csv,2018,1.0,0.0
18177,Goliath,67406,0,67406,2019.csv,2019,0.0,1.0
18178,We Belong Together,67397,0,67397,2019.csv,2019,0.0,1.0
18179,Jimmy Rivière,67387,0,67387,2011.csv,2011,0.0,1.0
18180,Matthew Bourne's Swan Lake,67347,0,67347,2012.csv,2012,0.0,1.0
18181,Being Frank,67343,67343,0,2019.csv,2019,1.0,0.0
18182,Fidaa,67308,0,67308,2017.csv,2017,0.0,1.0
18183,Ek Joke Net 2,67278,0,67278,2014.csv,2014,0.0,1.0
18184,An Italian Name 2016 Re-release,67264,0,67264,2016.csv,2016,0.0,1.0
18185,The Metropolitan Opera HD Live: Puccini: Madama Butterfly 2011 Re-release,67225,0,67225,2011.csv,2011,0.0,1.0
18186,Parey Hut Love,67194,0,67194,2019.csv,2019,0.0,1.0
18187,Finding Fatimah,67172,0,67172,2017.csv,2017,0.0,1.0
18188,Solitary Man 2013 Re-release,67164,0,67164,2013.csv,2013,0.0,1.0
18189,The Doctor from India,67136,67136,0,2018.csv,2018,1.0,0.0
18190,The Importance of Being Earnest,67121,0,67121,2011.csv,2011,0.0,1.0
18191,The Curse of Sleeping Beauty,67117,0,67117,2016.csv,2016,0.0,1.0
18192,The Sun Behind the Clouds: Tibet's Struggle for Freedom,67095,67095,0,2010.csv,2010,1.0,0.0
18193,The Autobiography of Nicolae Ceausescu,67093,34023,33070,2010.csv,2010,0.5071020821844305,0.4928979178155694
18194,Turbo Kid,67069,67069,0,2015.csv,2015,1.0,0.0
18195,Side by Side,67054,58825,8229,2012.csv,2012,0.8772780147343932,0.12272198526560682
18196,Emir,67048,0,67048,2010.csv,2010,0.0,1.0
18197,Superstar 2019 Re-release,66939,0,66939,2019.csv,2019,0.0,1.0
18198,OceanWorld 3D 2010 Re-release,66843,0,66843,2010.csv,2010,0.0,1.0
18199,Last Days of Spring,66831,0,66831,2020.csv,2020,0.0,1.0
18200,Hon Ma Thuc Tinh,66793,0,66793,2015.csv,2015,0.0,1.0
18201,"3100, Run and Become",66789,65524,1265,2018.csv,2018,0.9810597553489347,0.018940244651065294
18202,Shirley: Visions of Reality,66756,0,66756,2013.csv,2013,0.0,1.0
18203,Rat King,66728,0,66728,2012.csv,2012,0.0,1.0
18204,Siska Deluxe,66709,0,66709,2015.csv,2015,0.0,1.0
18205,Metéora,66708,0,66708,2013.csv,2013,0.0,1.0
18206,Edakkad Battalion 06,66705,0,66705,2019.csv,2019,0.0,1.0
18207,Don't Look Now 2019 Re-release,66700,0,66700,2019.csv,2019,0.0,1.0
18208,Çakallarla Dans 2014 Re-release,66685,0,66685,2014.csv,2014,0.0,1.0
18209,Carta a una sombra,66684,0,66684,2015.csv,2015,0.0,1.0
18210,Pandora's Promise,66680,66680,0,2013.csv,2013,1.0,0.0
18211,Max Rose,66680,66680,0,2016.csv,2016,1.0,0.0
18212,K2 vlastní cestou,66672,0,66672,2020.csv,2020,0.0,1.0
18213,Etlouly Barra,66644,0,66644,2018.csv,2018,0.0,1.0
18214,Jinde Meriye,66637,0,66637,2020.csv,2020,0.0,1.0
18215,De regreso al colegio,66592,0,66592,2017.csv,2017,0.0,1.0
18216,Sei Venezia,66565,0,66565,2012.csv,2012,0.0,1.0
18217,A Fantastic Encounter,66561,0,66561,2019.csv,2019,0.0,1.0
18218,Stockholm,66538,0,66538,2013.csv,2013,0.0,1.0
18219,Amphibious Creature of the Deep,66440,0,66440,2012.csv,2012,0.0,1.0
18220,The Lovers,66428,0,66428,2015.csv,2015,0.0,1.0
18221,Dreams of Glory,66330,0,66330,2013.csv,2013,0.0,1.0
18222,The Rules for Everything,66318,0,66318,2017.csv,2017,0.0,1.0
18223,Soul Mate,66310,0,66310,2020.csv,2020,0.0,1.0
18224,Ap' ta kokala vgalmena,66253,0,66253,2011.csv,2011,0.0,1.0
18225,Rock Me to the Moon,66208,0,66208,2013.csv,2013,0.0,1.0
18226,Blue Velvet 2016 Re-release,66180,0,66180,2016.csv,2016,0.0,1.0
18227,King Georges,66175,66175,0,2016.csv,2016,1.0,0.0
18228,Dancing Across Borders,66166,66166,0,2010.csv,2010,1.0,0.0
18229,Darbe,66145,0,66145,2015.csv,2015,0.0,1.0
18230,Guia In Love,66115,0,66115,2015.csv,2015,0.0,1.0
18231,Frenzy,66111,0,66111,2015.csv,2015,0.0,1.0
18232,Karuppan,66101,0,66101,2017.csv,2017,0.0,1.0
18233,Daddy Cool Munde Fool,66034,0,66034,2013.csv,2013,0.0,1.0
18234,Je suis supporter du Standard,66027,0,66027,2013.csv,2013,0.0,1.0
18235,Out in the Dark,66017,26966,39051,2013.csv,2013,0.4084705454655619,0.5915294545344381
18236,Our Times 2020 Re-release,66017,0,66017,2020.csv,2020,0.0,1.0
18237,The Forger 2016 Re-release,65987,0,65987,2016.csv,2016,0.0,1.0
18238,Always Be My Maybe,65934,0,65934,2016.csv,2016,0.0,1.0
18239,Loops,65915,0,65915,2018.csv,2018,0.0,1.0
18240,Battle for Terra 2012 Re-release,65913,0,65913,2012.csv,2012,0.0,1.0
18241,"Los muertos no se tocan, nene",65874,0,65874,2011.csv,2011,0.0,1.0
18242,Querida voy a comprar cigarrillos y vuelvo 2013 Re-release,65864,0,65864,2013.csv,2013,0.0,1.0
18243,Garden of Eden,65830,0,65830,2015.csv,2015,0.0,1.0
18244,All the Devil's Men,65829,0,65829,2019.csv,2019,0.0,1.0
18245,Tiger House,65821,0,65821,2015.csv,2015,0.0,1.0
18246,On the Run,65798,0,65798,2018.csv,2018,0.0,1.0
18247,Puriyaatha Puthir,65796,0,65796,2017.csv,2017,0.0,1.0
18248,Sonsuz Bir Ask,65761,0,65761,2015.csv,2015,0.0,1.0
18249,Jacob's Kingdom of Heaven,65728,0,65728,2016.csv,2016,0.0,1.0
18250,In Dog's Words,65708,0,65708,2016.csv,2016,0.0,1.0
18251,Satisfaction 1720,65690,0,65690,2016.csv,2016,0.0,1.0
18252,Saadi Love Story,65670,0,65670,2013.csv,2013,0.0,1.0
18253,Man from Podolsk,65651,0,65651,2020.csv,2020,0.0,1.0
18254,Thunderstorm,65633,0,65633,2019.csv,2019,0.0,1.0
18255,Lebanon 2013 Re-release,65632,0,65632,2013.csv,2013,0.0,1.0
18256,Major: The Winning Shot of Friendship 2011 Re-release,65620,0,65620,2011.csv,2011,0.0,1.0
18257,The Metropolitan Opera HD Live: Zandonai: Francesca da Rimini,65581,0,65581,2013.csv,2013,0.0,1.0
18258,St. Peter's and the Papal Basilicas of Rome 3D,65559,0,65559,2016.csv,2016,0.0,1.0
18259,Mama's Music Box,65552,0,65552,2020.csv,2020,0.0,1.0
18260,D-Day,65536,0,65536,2013.csv,2013,0.0,1.0
18261,Thérèse: The Story of Saint Thérèse of Lisieux 2011 Re-release,65527,0,65527,2011.csv,2011,0.0,1.0
18262,Girgitle,65509,0,65509,2019.csv,2019,0.0,1.0
18263,Vroom! Vroom! Vroomiz,65478,0,65478,2016.csv,2016,0.0,1.0
18264,Better Man,65446,0,65446,2018.csv,2018,0.0,1.0
18265,Questo mondo è per te,65444,0,65444,2011.csv,2011,0.0,1.0
18266,Architects of Denial,65424,65424,0,2017.csv,2017,1.0,0.0
18267,The Return,65395,0,65395,2017.csv,2017,0.0,1.0
18268,Dil Vil Pyaar Vyaar,65363,0,65363,2014.csv,2014,0.0,1.0
18269,Gabriel,65343,0,65343,2019.csv,2019,0.0,1.0
18270,Sing Your Song,65310,47718,17592,2012.csv,2012,0.730638493339458,0.26936150666054204
18271,Magamuni,65281,0,65281,2019.csv,2019,0.0,1.0
18272,Love Revisited,65270,0,65270,2017.csv,2017,0.0,1.0
18273,Masterplan,65228,0,65228,2012.csv,2012,0.0,1.0
18274,You've Been Trumped,65220,29273,35947,2012.csv,2012,0.44883471327813557,0.5511652867218645
18275,Staub auf unseren Herzen,65178,0,65178,2013.csv,2013,0.0,1.0
18276,Through a Lens Darkly: Black Photographers and the Emergence of a People,65169,65169,0,2014.csv,2014,1.0,0.0
18277,How to Meet Girls from a Distance,65168,0,65168,2012.csv,2012,0.0,1.0
18278,Mary's Land 2018 Re-release,65164,0,65164,2018.csv,2018,0.0,1.0
18279,House of Cardin,65153,0,65153,2020.csv,2020,0.0,1.0
18280,The Lesson,65142,9045,56097,2015.csv,2015,0.13885051119093672,0.8611494888090633
18281,Nos Passos Do Mestre: Jesus Segundo De O Espiritismo,65126,0,65126,2016.csv,2016,0.0,1.0
18282,Larry Gaye: Renegade Male Flight Attendant,65100,0,65100,2015.csv,2015,0.0,1.0
18283,Racing Dreams,65082,65082,0,2010.csv,2010,1.0,0.0
18284,From the Dark,65057,0,65057,2016.csv,2016,0.0,1.0
18285,The Guest,65036,0,65036,2011.csv,2011,0.0,1.0
18286,Roommates in Love,65032,0,65032,2016.csv,2016,0.0,1.0
18287,Remember the Titans 2021 Re-release,65000,65000,0,2021.csv,2021,1.0,0.0
18288,Lost in the Sun,64987,0,64987,2016.csv,2016,0.0,1.0
18289,Aana Alaralodalaral,64939,0,64939,2017.csv,2017,0.0,1.0
18290,Toys in the Attic 2012 Re-release,64918,64918,0,2012.csv,2012,1.0,0.0
18291,Manolo: the Boy Who Made Shoes for Lizards,64889,60056,4833,2017.csv,2017,0.9255189631524604,0.07448103684753965
18292,Bitten Bullet,64875,0,64875,2011.csv,2011,0.0,1.0
18293,Isle of Dogs 2020 Re-release,64869,0,64869,2020.csv,2020,0.0,1.0
18294,Cymbeline,64851,0,64851,2015.csv,2015,0.0,1.0
18295,Dubcek,64841,0,64841,2018.csv,2018,0.0,1.0
18296,Van Gogh: Of Wheat Fields and Clouded Skies,64828,0,64828,2018.csv,2018,0.0,1.0
18297,Facing the Giants 2010 Re-release,64828,0,64828,2010.csv,2010,0.0,1.0
18298,The School,64760,0,64760,2018.csv,2018,0.0,1.0
18299,The Constable,64754,0,64754,2013.csv,2013,0.0,1.0
18300,Searching for Ingmar Bergman,64742,36686,28056,2018.csv,2018,0.5666491612863366,0.4333508387136635
18301,Pity,64733,0,64733,2018.csv,2018,0.0,1.0
18302,The Jesus Rolls,64648,18169,46479,2019.csv,2019,0.2810450439302067,0.7189549560697933
18303,Le stelle inquiete,64635,0,64635,2011.csv,2011,0.0,1.0
18304,Undercover vs. Undercover,64601,0,64601,2019.csv,2019,0.0,1.0
18305,Sneeukoningin,64601,0,64601,2015.csv,2015,0.0,1.0
18306,"Monrovia, Indiana",64596,63944,652,2018.csv,2018,0.9899064957582513,0.010093504241748714
18307,Rabb Da Radio,64581,0,64581,2017.csv,2017,0.0,1.0
18308,Battle of the Brides,64572,64572,0,2011.csv,2011,1.0,0.0
18309,The Blonde with Bare Breasts,64561,0,64561,2010.csv,2010,0.0,1.0
18310,Aami,64528,0,64528,2018.csv,2018,0.0,1.0
18311,Hidden 2011 Re-release,64512,0,64512,2011.csv,2011,0.0,1.0
18312,The Metropolitan Opera HD Live: Wagner: Tannhäuser,64495,0,64495,2015.csv,2015,0.0,1.0
18313,Let the Fire Burn,64489,64489,0,2013.csv,2013,1.0,0.0
18314,Brawl in Cell Block 99,64453,0,64453,2017.csv,2017,0.0,1.0
18315,Badmaa$h Company,64398,0,64398,2010.csv,2010,0.0,1.0
18316,Paris la blanche,64384,0,64384,2017.csv,2017,0.0,1.0
18317,Grotto,64381,0,64381,2016.csv,2016,0.0,1.0
18318,Les mauvaises herbes,64352,0,64352,2017.csv,2017,0.0,1.0
18319,Krishnarjuna Yudham,64323,0,64323,2018.csv,2018,0.0,1.0
18320,"Papá, soy una zombi 2: Rebelión putrefacta",64319,0,64319,2014.csv,2014,0.0,1.0
18321,No Distance Left to Run,64273,0,64273,2010.csv,2010,0.0,1.0
18322,Ants on a Shrimp,64237,0,64237,2016.csv,2016,0.0,1.0
18323,Tutmayin Beni,64224,0,64224,2016.csv,2016,0.0,1.0
18324,Frankenstein 2012 Re-release,64221,0,64221,2012.csv,2012,0.0,1.0
18325,Coliseo Los Campeones,64215,0,64215,2012.csv,2012,0.0,1.0
18326,Lea,64194,0,64194,2016.csv,2016,0.0,1.0
18327,Kaatrin Mozhi,64149,0,64149,2018.csv,2018,0.0,1.0
18328,Eyal Harifa,64149,0,64149,2015.csv,2015,0.0,1.0
18329,No Way Back,64148,0,64148,2020.csv,2020,0.0,1.0
18330,Paulette 2015 Re-release,64125,29494,34631,2015.csv,2015,0.4599454191033138,0.5400545808966861
18331,Izzie's Way Home,64112,0,64112,2019.csv,2019,0.0,1.0
18332,She is King,64106,0,64106,2017.csv,2017,0.0,1.0
18333,"Paraguay, Droga Y Banana",64105,0,64105,2016.csv,2016,0.0,1.0
18334,Hellbenders,64097,0,64097,2013.csv,2013,0.0,1.0
18335,The Arctic Camels,64091,0,64091,2019.csv,2019,0.0,1.0
18336,How to Be Yours,64070,0,64070,2016.csv,2016,0.0,1.0
18337,Girl Asleep,64056,60289,3767,2016.csv,2016,0.9411920819283127,0.058807918071687275
18338,In the Middle of the River,64054,0,64054,2019.csv,2019,0.0,1.0
18339,Night of the Demons,64040,0,64040,2013.csv,2013,0.0,1.0
18340,Bad Cat 2017 Re-release,64010,0,64010,2017.csv,2017,0.0,1.0
18341,Making Waves: The Art of Cinematic Sound,63998,53144,10854,2019.csv,2019,0.8304009500296884,0.16959904997031158
18342,Ciudad Delirio,63993,0,63993,2014.csv,2014,0.0,1.0
18343,Lilly the Witch: The Journey to Mandolan 2013 Re-release,63975,0,63975,2013.csv,2013,0.0,1.0
18344,Everything Now,63970,0,63970,2016.csv,2016,0.0,1.0
18345,Jealousy,63946,63946,0,2014.csv,2014,1.0,0.0
18346,Oh! My Papa,63867,0,63867,2016.csv,2016,0.0,1.0
18347,The City Below,63842,0,63842,2011.csv,2011,0.0,1.0
18348,Arctic Heart,63828,0,63828,2016.csv,2016,0.0,1.0
18349,Furry Vengeance 2013 Re-release,63813,0,63813,2013.csv,2013,0.0,1.0
18350,Akillara Seza,63804,0,63804,2019.csv,2019,0.0,1.0
18351,The Jungle Book,63803,0,63803,2017.csv,2017,0.0,1.0
18352,A Way Out,63802,0,63802,2018.csv,2018,0.0,1.0
18353,Timon of Athens,63799,0,63799,2012.csv,2012,0.0,1.0
18354,Sheikh Jackson,63798,0,63798,2017.csv,2017,0.0,1.0
18355,Vicky the Viking 2014 Re-release,63796,0,63796,2014.csv,2014,0.0,1.0
18356,Coffee or Tea?,63795,0,63795,2020.csv,2020,0.0,1.0
18357,Roman Polanski: A Film Memoir,63783,0,63783,2012.csv,2012,0.0,1.0
18358,To Love 2017 Re-release,63773,0,63773,2017.csv,2017,0.0,1.0
18359,Go to Heaven Alive,63769,0,63769,2019.csv,2019,0.0,1.0
18360,Circuit,63741,0,63741,2010.csv,2010,0.0,1.0
18361,Wallay,63718,0,63718,2017.csv,2017,0.0,1.0
18362,Rookie Chef,63710,0,63710,2016.csv,2016,0.0,1.0
18363,Now Add Honey,63683,0,63683,2015.csv,2015,0.0,1.0
18364,NN: Sin Identidad,63679,0,63679,2015.csv,2015,0.0,1.0
18365,Richard III 2016 Re-release,63614,0,63614,2016.csv,2016,0.0,1.0
18366,Crystal Swan,63603,0,63603,2018.csv,2018,0.0,1.0
18367,The Details,63595,63595,0,2012.csv,2012,1.0,0.0
18368,Lost Songs of Anatolia,63592,0,63592,2010.csv,2010,0.0,1.0
18369,Equilibrium,63579,0,63579,2017.csv,2017,0.0,1.0
18370,Singing with Angry Bird,63565,0,63565,2018.csv,2018,0.0,1.0
18371,Stitches,63555,0,63555,2012.csv,2012,0.0,1.0
18372,Weekend 2016 Re-release,63526,0,63526,2016.csv,2016,0.0,1.0
18373,House on Willow Street,63514,0,63514,2017.csv,2017,0.0,1.0
18374,Four Lovers,63513,0,63513,2010.csv,2010,0.0,1.0
18375,The Finger,63492,0,63492,2011.csv,2011,0.0,1.0
18376,A Liar's Autobiography: The Untrue Story of Monty Python's Graham Chapman,63469,5102,58367,2012.csv,2012,0.08038570010556334,0.9196142998944367
18377,I Smile Back,63373,58738,4635,2015.csv,2015,0.9268615972101684,0.07313840278983164
18378,Ana Arabia,63370,0,63370,2014.csv,2014,0.0,1.0
18379,Umeå4ever,63353,0,63353,2011.csv,2011,0.0,1.0
18380,The Robot Giant 2017 Re-release,63321,0,63321,2017.csv,2017,0.0,1.0
18381,Rafaël,63320,0,63320,2018.csv,2018,0.0,1.0
18382,Fat Girl Wedding,63312,0,63312,2017.csv,2017,0.0,1.0
18383,Women Soldiers,63297,0,63297,2017.csv,2017,0.0,1.0
18384,KL Gangster 2013 Re-release,63265,0,63265,2013.csv,2013,0.0,1.0
18385,Refrigerantes e Canções de Amor,63258,0,63258,2016.csv,2016,0.0,1.0
18386,The Cameramurderer,63256,0,63256,2010.csv,2010,0.0,1.0
18387,Trapped,63241,63241,0,2016.csv,2016,1.0,0.0
18388,Ultraman Saga 2014 Re-release,63228,0,63228,2014.csv,2014,0.0,1.0
18389,Murieron por encima de sus posibilidades,63206,0,63206,2015.csv,2015,0.0,1.0
18390,Game Over,63183,0,63183,2019.csv,2019,0.0,1.0
18391,8½ 2020 Re-release,63170,0,63170,2020.csv,2020,0.0,1.0
18392,Do Knot Disturb 2012 Re-release,63166,0,63166,2012.csv,2012,0.0,1.0
18393,The Last of the Unjust,63136,40563,22573,2013.csv,2013,0.6424702230106437,0.3575297769893563
18394,George Best: All by Himself,63115,0,63115,2017.csv,2017,0.0,1.0
18395,Before Snowfall,63111,0,63111,2013.csv,2013,0.0,1.0
18396,No Tears for the Dead,63063,63063,0,2014.csv,2014,1.0,0.0
18397,Creative Control,63014,63014,0,2016.csv,2016,1.0,0.0
18398,La mujer del animal,63010,0,63010,2017.csv,2017,0.0,1.0
18399,The Inspired Island Part 2,62994,0,62994,2015.csv,2015,0.0,1.0
18400,Kizkaçiran,62960,0,62960,2016.csv,2016,0.0,1.0
18401,Last of the Haussman,62955,0,62955,2012.csv,2012,0.0,1.0
18402,The First Time,62950,0,62950,2018.csv,2018,0.0,1.0
18403,Amateur Night,62933,0,62933,2016.csv,2016,0.0,1.0
18404,M.C. Escher - Journey to Infinity,62906,0,62906,2019.csv,2019,0.0,1.0
18405,"Love, Antosha",62900,50168,12732,2019.csv,2019,0.7975834658187599,0.20241653418124006
18406,2nd Date Sex,62892,0,62892,2019.csv,2019,0.0,1.0
18407,7 Reasons to Run Away (from Society),62890,0,62890,2019.csv,2019,0.0,1.0
18408,The Corpse of Anna Fritz,62886,0,62886,2015.csv,2015,0.0,1.0
18409,This Time,62827,0,62827,2016.csv,2016,0.0,1.0
18410,The Golden Mean,62811,0,62811,2010.csv,2010,0.0,1.0
18411,The Wind Turns,62772,0,62772,2018.csv,2018,0.0,1.0
18412,Evaru,62744,0,62744,2019.csv,2019,0.0,1.0
18413,Vive la crise,62742,0,62742,2017.csv,2017,0.0,1.0
18414,SMTown Live in Tokyo Special Edition,62741,0,62741,2012.csv,2012,0.0,1.0
18415,The Gardener,62734,62734,0,2018.csv,2018,1.0,0.0
18416,Saint Philip Neri: I Prefer Heaven,62729,0,62729,2012.csv,2012,0.0,1.0
18417,The Swan,62716,2367,60349,2018.csv,2018,0.0377415651508387,0.9622584348491613
18418,Cool It,62713,62713,0,2010.csv,2010,1.0,0.0
18419,Birds Are Singing in Kigali,62670,0,62670,2017.csv,2017,0.0,1.0
18420,Drunk Stoned Brilliant Dead,62660,62660,0,2015.csv,2015,1.0,0.0
18421,Stranded,62620,0,62620,2010.csv,2010,0.0,1.0
18422,The Midnight Sky,62557,0,62557,2020.csv,2020,0.0,1.0
18423,Bunny Drop 2012 Re-release,62546,0,62546,2012.csv,2012,0.0,1.0
18424,Heavenly Shift,62539,0,62539,2013.csv,2013,0.0,1.0
18425,Westernstory,62507,0,62507,2011.csv,2011,0.0,1.0
18426,Raphael - Lord of the Arts,62487,0,62487,2017.csv,2017,0.0,1.0
18427,Goguryeo,62481,0,62481,2016.csv,2016,0.0,1.0
18428,B,62463,0,62463,2015.csv,2015,0.0,1.0
18429,Standoff,62459,0,62459,2016.csv,2016,0.0,1.0
18430,Code Red,62431,0,62431,2014.csv,2014,0.0,1.0
18431,The Metropolitan Opera HD Live: Donizetti: Don Pasquale,62424,0,62424,2010.csv,2010,0.0,1.0
18432,Thoongaavanam,62398,0,62398,2015.csv,2015,0.0,1.0
18433,The Tiger Hunter,62398,62398,0,2017.csv,2017,1.0,0.0
18434,King's Road,62389,0,62389,2010.csv,2010,0.0,1.0
18435,Menekse'den önce,62370,0,62370,2013.csv,2013,0.0,1.0
18436,He Ain't Like That,62358,0,62358,2011.csv,2011,0.0,1.0
18437,Herbs: Songs of Freedom,62322,0,62322,2019.csv,2019,0.0,1.0
18438,Energized,62297,0,62297,2014.csv,2014,0.0,1.0
18439,Mifune: The Last Samurai,62279,62279,0,2016.csv,2016,1.0,0.0
18440,The Italian Job 2020 Re-release,62277,0,62277,2020.csv,2020,0.0,1.0
18441,Diaz: Don't Clean Up This Blood 2013 Re-release,62276,0,62276,2013.csv,2013,0.0,1.0
18442,Thang Máy,62272,0,62272,2020.csv,2020,0.0,1.0
18443,Birthday Card,62184,0,62184,2017.csv,2017,0.0,1.0
18444,Public Speaking,62173,62173,0,2011.csv,2011,1.0,0.0
18445,Ponte Aérea,62173,0,62173,2015.csv,2015,0.0,1.0
18446,Seninki kaç para?,62167,0,62167,2012.csv,2012,0.0,1.0
18447,Rue Huvelin,62121,0,62121,2011.csv,2011,0.0,1.0
18448,Boys of Abu Ghraib,62096,0,62096,2015.csv,2015,0.0,1.0
18449,Come True,62080,62080,0,2021.csv,2021,1.0,0.0
18450,Çilek,62054,0,62054,2014.csv,2014,0.0,1.0
18451,Trigun: Badlands Rumble 2011 Re-release,62027,62027,0,2011.csv,2011,1.0,0.0
18452,Boca,62021,0,62021,2012.csv,2012,0.0,1.0
18453,Arapsaçi,62012,0,62012,2018.csv,2018,0.0,1.0
18454,The Bravest Escort Group,62007,0,62007,2018.csv,2018,0.0,1.0
18455,Kites The Remix,61997,41783,20214,2010.csv,2010,0.6739519654176815,0.3260480345823185
18456,The Grandfather of My Dreams,61966,0,61966,2015.csv,2015,0.0,1.0
18457,Double Trouble and the Magical Mirror,61962,0,61962,2019.csv,2019,0.0,1.0
18458,Aanakkallan,61961,0,61961,2018.csv,2018,0.0,1.0
18459,The Man Who Fell to Earth 2016 Re-release,61920,0,61920,2016.csv,2016,0.0,1.0
18460,"I, Me aur Main",61863,0,61863,2013.csv,2013,0.0,1.0
18461,The Clock of Redha,61862,0,61862,2019.csv,2019,0.0,1.0
18462,Dark Star: HR Gigers Welt,61845,61845,0,2015.csv,2015,1.0,0.0
18463,Aute Retrato,61837,0,61837,2019.csv,2019,0.0,1.0
18464,I Dream in Another Language 2018 Re-release,61824,0,61824,2018.csv,2018,0.0,1.0
18465,Antiviral,61808,0,61808,2013.csv,2013,0.0,1.0
18466,In a Valley of Violence,61797,61797,0,2016.csv,2016,1.0,0.0
18467,If a Tree Falls: A Story of the Earth Liberation Front,61794,61794,0,2011.csv,2011,1.0,0.0
18468,Cura Brochero,61790,0,61790,2016.csv,2016,0.0,1.0
18469,River Runs Red,61789,9893,51896,2018.csv,2018,0.1601094045865769,0.8398905954134231
18470,Port Authority,61744,0,61744,2019.csv,2019,0.0,1.0
18471,Amour Fou,61693,13702,47991,2014.csv,2014,0.22209975199779552,0.7779002480022045
18472,Quill: The Life of a Guide Dog 2012 Re-release,61674,15674,46000,2012.csv,2012,0.2541427505918215,0.7458572494081784
18473,Straight A's,61669,0,61669,2013.csv,2013,0.0,1.0
18474,Ella y el miedo,61669,0,61669,2015.csv,2015,0.0,1.0
18475,The Chief Legend,61616,0,61616,2019.csv,2019,0.0,1.0
18476,666 Cin Musallati,61590,0,61590,2017.csv,2017,0.0,1.0
18477,1971: Beyond Borders,61590,0,61590,2017.csv,2017,0.0,1.0
18478,My Story,61580,0,61580,2018.csv,2018,0.0,1.0
18479,Soledad,61577,0,61577,2018.csv,2018,0.0,1.0
18480,Haani,61502,0,61502,2013.csv,2013,0.0,1.0
18481,Semur: Seytanin Kabilesi,61493,0,61493,2017.csv,2017,0.0,1.0
18482,Viva the Underdogs,61491,0,61491,2020.csv,2020,0.0,1.0
18483,Black Heaven 2012 Re-release,61467,0,61467,2012.csv,2012,0.0,1.0
18484,Backwards,61465,61465,0,2012.csv,2012,1.0,0.0
18485,Cane Toads: The Conquest,61450,0,61450,2010.csv,2010,0.0,1.0
18486,Donald Cried,61406,61406,0,2017.csv,2017,1.0,0.0
18487,Baden Baden,61390,0,61390,2016.csv,2016,0.0,1.0
18488,Münafik,61372,0,61372,2015.csv,2015,0.0,1.0
18489,Cruzadas,61359,0,61359,2011.csv,2011,0.0,1.0
18490,Marama: Rombai - El Viaje,61321,0,61321,2016.csv,2016,0.0,1.0
18491,Evlenmeden Olmaz,61321,0,61321,2015.csv,2015,0.0,1.0
18492,Tattoo,61315,0,61315,2015.csv,2015,0.0,1.0
18493,Never Goin' Back,61271,61271,0,2018.csv,2018,1.0,0.0
18494,Here and Now,61271,13892,47379,2018.csv,2018,0.22673042711886537,0.7732695728811346
18495,The Seasons In Quincy: Four Portraits of John Berger,61267,28456,32811,2016.csv,2016,0.46445884407592997,0.53554115592407
18496,The Outcasts,61250,1455,59795,2017.csv,2017,0.023755102040816326,0.9762448979591837
18497,The Untamed,61249,27593,33656,2017.csv,2017,0.45050531437247954,0.5494946856275205
18498,L'envolée,61206,0,61206,2020.csv,2020,0.0,1.0
18499,Amnesiac,61192,0,61192,2015.csv,2015,0.0,1.0
18500,The Metropolitan Opera HD Live: Donizetti: La Fille du Régiment,61185,0,61185,2019.csv,2019,0.0,1.0
18501,Autopohádky,61164,0,61164,2011.csv,2011,0.0,1.0
18502,Penance,61146,0,61146,2012.csv,2012,0.0,1.0
18503,Incident Light,61139,0,61139,2016.csv,2016,0.0,1.0
18504,Harah Maznuqah,61125,0,61125,2015.csv,2015,0.0,1.0
18505,Interview with a Hitman,61048,0,61048,2012.csv,2012,0.0,1.0
18506,A Family Affair,61045,0,61045,2015.csv,2015,0.0,1.0
18507,Harbinger Down,61036,0,61036,2015.csv,2015,0.0,1.0
18508,The Mountain,61035,61035,0,2019.csv,2019,1.0,0.0
18509,Michael Inside,61034,0,61034,2018.csv,2018,0.0,1.0
18510,Acute Misfortune,61028,0,61028,2019.csv,2019,0.0,1.0
18511,The Bodyguard 2012 Re-release,61020,61020,0,2012.csv,2012,1.0,0.0
18512,Independent Lens: Don't Stop Believin': Everyman's Journey,61018,61018,0,2013.csv,2013,1.0,0.0
18513,The Sacrifice 2017 Re-release,61018,61018,0,2017.csv,2017,1.0,0.0
18514,The House by the Medlar Tree,61010,0,61010,2011.csv,2011,0.0,1.0
18515,Jan Dara 2012 Re-release,60984,0,60984,2012.csv,2012,0.0,1.0
18516,ID:A,60968,0,60968,2011.csv,2011,0.0,1.0
18517,Love U... Mr. Kalakaar!,60956,48557,12399,2011.csv,2011,0.7965909836603452,0.20340901633965483
18518,Carga,60896,0,60896,2018.csv,2018,0.0,1.0
18519,The Wicker Man 2013 Re-release,60891,60891,0,2013.csv,2013,1.0,0.0
18520,It's a Disaster,60818,60818,0,2013.csv,2013,1.0,0.0
18521,A Kid Like Jake,60784,58403,2381,2018.csv,2018,0.9608285075019742,0.039171492498025796
18522,Apprentice,60752,2578,58174,2016.csv,2016,0.042434816960758494,0.9575651830392415
18523,Inversion,60737,0,60737,2017.csv,2017,0.0,1.0
18524,Saklambac,60725,0,60725,2017.csv,2017,0.0,1.0
18525,Open Up to Me,60657,0,60657,2013.csv,2013,0.0,1.0
18526,How to Live Forever,60630,60630,0,2011.csv,2011,1.0,0.0
18527,My Heart Leaps Up,60615,0,60615,2017.csv,2017,0.0,1.0
18528,Kapan,60611,0,60611,2019.csv,2019,0.0,1.0
18529,Viper Club,60607,60607,0,2018.csv,2018,1.0,0.0
18530,A Very Bad Friend,60598,0,60598,2020.csv,2020,0.0,1.0
18531,Everywhere and Nowhere,60594,0,60594,2011.csv,2011,0.0,1.0
18532,Doraemon: Nobita and the Space Heroes 2017 Re-release,60589,0,60589,2017.csv,2017,0.0,1.0
18533,Med Trekkspill Til Operaen,60569,0,60569,2012.csv,2012,0.0,1.0
18534,Los Nadie,60567,0,60567,2016.csv,2016,0.0,1.0
18535,Never Not Love You,60538,0,60538,2018.csv,2018,0.0,1.0
18536,Sicixia,60526,0,60526,2016.csv,2016,0.0,1.0
18537,Sonskyn Beperk,60499,0,60499,2016.csv,2016,0.0,1.0
18538,Retornos,60447,0,60447,2010.csv,2010,0.0,1.0
18539,Horrid Henry,60442,0,60442,2019.csv,2019,0.0,1.0
18540,Too Late,60438,60438,0,2016.csv,2016,1.0,0.0
18541,El club de los buenos infieles,60428,0,60428,2018.csv,2018,0.0,1.0
18542,Ask Bu Mu?,60366,0,60366,2018.csv,2018,0.0,1.0
18543,Papeles en el viento,60358,0,60358,2015.csv,2015,0.0,1.0
18544,Long Way North,60352,0,60352,2016.csv,2016,0.0,1.0
18545,Fallo per papà,60342,0,60342,2012.csv,2012,0.0,1.0
18546,Limelight,60335,60335,0,2011.csv,2011,1.0,0.0
18547,Waiting for Me in Heaven,60326,0,60326,2018.csv,2018,0.0,1.0
18548,Crime After Crime,60291,60291,0,2011.csv,2011,1.0,0.0
18549,Jeziorak,60280,0,60280,2014.csv,2014,0.0,1.0
18550,My Burning Heart,60267,0,60267,2010.csv,2010,0.0,1.0
18551,A Perfect Day 2017 Re-release,60251,0,60251,2017.csv,2017,0.0,1.0
18552,Tongue Cutters,60247,0,60247,2017.csv,2017,0.0,1.0
18553,Meerkat Maantuig,60232,0,60232,2018.csv,2018,0.0,1.0
18554,Wetlands 2014 Re-release,60230,59478,752,2014.csv,2014,0.9875145276440312,0.012485472355968787
18555,Hacker,60228,0,60228,2019.csv,2019,0.0,1.0
18556,Presenting Princess Shaw,60197,60197,0,2016.csv,2016,1.0,0.0
18557,Symphony for Ana,60179,0,60179,2017.csv,2017,0.0,1.0
18558,White Coffin,60171,0,60171,2016.csv,2016,0.0,1.0
18559,Achoura,60148,0,60148,2020.csv,2020,0.0,1.0
18560,Just One Drop,60078,60078,0,2017.csv,2017,1.0,0.0
18561,Gregory Crewdson: Brief Encounters,60064,60064,0,2012.csv,2012,1.0,0.0
18562,Decoding Annie Parker,60048,48390,11658,2014.csv,2014,0.8058553157474021,0.19414468425259793
18563,Before Summer Ends,60046,0,60046,2017.csv,2017,0.0,1.0
18564,Close,60040,0,60040,2019.csv,2019,0.0,1.0
18565,Seytan-i Ins,59994,0,59994,2019.csv,2019,0.0,1.0
18566,Tokyo Night Sky Is Always the Densest Shade of Blue,59989,0,59989,2019.csv,2019,0.0,1.0
18567,Naomi 2013 Re-release,59983,0,59983,2013.csv,2013,0.0,1.0
18568,Muzikál aneb Cesty ke stestí,59961,0,59961,2016.csv,2016,0.0,1.0
18569,The Force,59912,59912,0,2017.csv,2017,1.0,0.0
18570,Summertime 2017 Re-release,59907,0,59907,2017.csv,2017,0.0,1.0
18571,Together Forever 2012 Re-release,59895,0,59895,2012.csv,2012,0.0,1.0
18572,Timon of Athens - RSC Live,59892,0,59892,2019.csv,2019,0.0,1.0
18573,The Story of Chieftain,59841,0,59841,2019.csv,2019,0.0,1.0
18574,The Apostle,59810,0,59810,2012.csv,2012,0.0,1.0
18575,John Fogerty: 50 Year Trip - Live at Red Rocks,59795,59795,0,2019.csv,2019,1.0,0.0
18576,Detour 2010 Re-release,59795,0,59795,2010.csv,2010,0.0,1.0
18577,La vida sense la Sara Amat,59794,0,59794,2019.csv,2019,0.0,1.0
18578,Cake,59789,0,59789,2018.csv,2018,0.0,1.0
18579,Furcht & Zittern,59785,0,59785,2010.csv,2010,0.0,1.0
18580,Promachan Sao-Phansayong,59774,0,59774,2015.csv,2015,0.0,1.0
18581,The Domestics,59766,0,59766,2018.csv,2018,0.0,1.0
18582,Grandes ondes,59738,0,59738,2014.csv,2014,0.0,1.0
18583,Battle Royale 2011 Re-release,59735,0,59735,2011.csv,2011,0.0,1.0
18584,Frontera,59696,59696,0,2014.csv,2014,1.0,0.0
18585,The Hussites,59691,0,59691,2013.csv,2013,0.0,1.0
18586,Buddha in a Traffic Jam,59679,0,59679,2016.csv,2016,0.0,1.0
18587,Load Wedding,59641,0,59641,2018.csv,2018,0.0,1.0
18588,MULT v kino. Vol 119,59624,0,59624,2020.csv,2020,0.0,1.0
18589,Solstorm 2010 Re-release,59571,0,59571,2010.csv,2010,0.0,1.0
18590,El Khalbos,59551,0,59551,2015.csv,2015,0.0,1.0
18591,Opium: Diary of a Madwoman,59534,0,59534,2010.csv,2010,0.0,1.0
18592,Meditation Park,59530,0,59530,2019.csv,2019,0.0,1.0
18593,We Are Together 2011 Re-release,59520,0,59520,2011.csv,2011,0.0,1.0
18594,Barrymore,59495,0,59495,2012.csv,2012,0.0,1.0
18595,Yi Yi 2018 Re-release,59442,0,59442,2018.csv,2018,0.0,1.0
18596,Polina I Tayemnytsia Kinoindustriyi,59440,0,59440,2019.csv,2019,0.0,1.0
18597,Happy Little Submarines 4 - Adventures of Octopus 2019 Re-release,59438,0,59438,2019.csv,2019,0.0,1.0
18598,Action,59433,0,59433,2019.csv,2019,0.0,1.0
18599,Cheap Thrills,59424,59424,0,2014.csv,2014,1.0,0.0
18600,The Extraordinary Voyage,59424,52986,6438,2012.csv,2012,0.8916599353796446,0.1083400646203554
18601,Legend of the Carpathians,59421,0,59421,2018.csv,2018,0.0,1.0
18602,Sweet Dreams,59403,59403,0,2013.csv,2013,1.0,0.0
18603,My Brothers' Crossing,59395,59395,0,2020.csv,2020,1.0,0.0
18604,Mandrill,59395,0,59395,2010.csv,2010,0.0,1.0
18605,Kafir,59365,0,59365,2018.csv,2018,0.0,1.0
18606,Luis Trenker-Der Schmale Grat der Wahrheit,59360,0,59360,2015.csv,2015,0.0,1.0
18607,Red Wine in the Dark Night,59358,0,59358,2015.csv,2015,0.0,1.0
18608,Fantail,59345,0,59345,2014.csv,2014,0.0,1.0
18609,Bomb City,59329,59329,0,2018.csv,2018,1.0,0.0
18610,Exhibition on Screen: Young Picasso,59324,0,59324,2019.csv,2019,0.0,1.0
18611,Motichoor Chaknachoor,59322,0,59322,2019.csv,2019,0.0,1.0
18612,Avane Srimannarayana,59302,0,59302,2020.csv,2020,0.0,1.0
18613,Bang! The Bert Berns Story,59299,59299,0,2017.csv,2017,1.0,0.0
18614,Khruato,59272,0,59272,2015.csv,2015,0.0,1.0
18615,Saint Frances,59257,44330,14927,2020.csv,2020,0.7480972712084648,0.2519027287915352
18616,Rouge amargo,59203,0,59203,2013.csv,2013,0.0,1.0
18617,Innocence of Memories,59171,0,59171,2016.csv,2016,0.0,1.0
18618,War Commanders,59139,0,59139,2018.csv,2018,0.0,1.0
18619,Digimon Adventure tri. Part 4: Loss,59114,59114,0,2018.csv,2018,1.0,0.0
18620,The Trials of Muhammad Ali,59081,59081,0,2013.csv,2013,1.0,0.0
18621,Astral,59048,0,59048,2016.csv,2016,0.0,1.0
18622,Kaaki Sattai,59021,0,59021,2015.csv,2015,0.0,1.0
18623,The Humanity Bureau,58970,0,58970,2018.csv,2018,0.0,1.0
18624,Infection,58953,0,58953,2019.csv,2019,0.0,1.0
18625,King Ping - Tippen Tappen Tödchen,58941,0,58941,2013.csv,2013,0.0,1.0
18626,Tiny Giants 3D,58928,0,58928,2016.csv,2016,0.0,1.0
18627,Lost in London 2017 Re-release,58900,0,58900,2017.csv,2017,0.0,1.0
18628,Breadcrumbs,58892,0,58892,2016.csv,2016,0.0,1.0
18629,Call Sign Banderas,58883,0,58883,2018.csv,2018,0.0,1.0
18630,The One I Wrote for You,58872,58872,0,2014.csv,2014,1.0,0.0
18631,Master of the Universe,58864,0,58864,2013.csv,2013,0.0,1.0
18632,Alps 2016 Re-release,58851,0,58851,2016.csv,2016,0.0,1.0
18633,Oppam,58839,0,58839,2016.csv,2016,0.0,1.0
18634,The Catch,58794,0,58794,2017.csv,2017,0.0,1.0
18635,Thiruttu Payale 2,58759,0,58759,2017.csv,2017,0.0,1.0
18636,The Pass,58755,0,58755,2016.csv,2016,0.0,1.0
18637,Sagrada: The Mystery of Creation 2014 Re-release,58755,58755,0,2014.csv,2014,1.0,0.0
18638,Vacationers,58749,0,58749,2016.csv,2016,0.0,1.0
18639,Horror Love Story Death Road,58719,0,58719,2016.csv,2016,0.0,1.0
18640,Aiyyaa,58703,0,58703,2012.csv,2012,0.0,1.0
18641,Baan Phee Phop Reformation,58701,0,58701,2011.csv,2011,0.0,1.0
18642,The Conformist 2014 Re-release,58657,58657,0,2014.csv,2014,1.0,0.0
18643,Voyage of the Southern Sun,58657,0,58657,2017.csv,2017,0.0,1.0
18644,Outlaws,58652,0,58652,2018.csv,2018,0.0,1.0
18645,Locos de Amor 2018 Re-release,58603,0,58603,2018.csv,2018,0.0,1.0
18646,Horn from the Heart: The Paul Butterfield Story,58597,58597,0,2018.csv,2018,1.0,0.0
18647,Putty Hill,58585,49918,8667,2011.csv,2011,0.852061107792097,0.14793889220790304
18648,Lil' Buck: Real Swan,58552,0,58552,2020.csv,2020,0.0,1.0
18649,The Metropolitan Opera HD Live: Wagner: Die Walküre,58550,0,58550,2019.csv,2019,0.0,1.0
18650,Ray & Liz,58509,0,58509,2019.csv,2019,0.0,1.0
18651,Weekend,58507,0,58507,2015.csv,2015,0.0,1.0
18652,My Little Pony: Rainbow Roadtrip,58498,0,58498,2020.csv,2020,0.0,1.0
18653,Lemon Tree Passage,58496,0,58496,2015.csv,2015,0.0,1.0
18654,Cold of Kalandar,58494,0,58494,2016.csv,2016,0.0,1.0
18655,Solteira Quase Surtando,58444,0,58444,2020.csv,2020,0.0,1.0
18656,The Story of Ulanfu,58423,0,58423,2019.csv,2019,0.0,1.0
18657,The Courier,58387,0,58387,2012.csv,2012,0.0,1.0
18658,Hi Ha Ying Xiong,58358,0,58358,2019.csv,2019,0.0,1.0
18659,Down the River,58291,0,58291,2019.csv,2019,0.0,1.0
18660,War of the Dead,58285,0,58285,2012.csv,2012,0.0,1.0
18661,Eat Sleep Die,58278,0,58278,2013.csv,2013,0.0,1.0
18662,Orlando 2010 Re-release,58198,58198,0,2010.csv,2010,1.0,0.0
18663,Cynthia,58177,58177,0,2018.csv,2018,1.0,0.0
18664,The Metropolitan Opera HD Live: Verdi: Simon Boccanegra,58167,0,58167,2010.csv,2010,0.0,1.0
18665,Oskars Amerika,58154,0,58154,2017.csv,2017,0.0,1.0
18666,Tatsumi,58153,0,58153,2011.csv,2011,0.0,1.0
18667,Burning Bright,58147,0,58147,2012.csv,2012,0.0,1.0
18668,The Zero Theorem 2016 Re-release,58144,0,58144,2016.csv,2016,0.0,1.0
18669,Faust,58132,58132,0,2013.csv,2013,1.0,0.0
18670,Am Ende kommen Touristen 2012 Re-release,58127,0,58127,2012.csv,2012,0.0,1.0
18671,Rutan,58098,0,58098,2017.csv,2017,0.0,1.0
18672,In Search of Greatness,58090,58090,0,2018.csv,2018,1.0,0.0
18673,Aliens 2020 Re-release,58086,0,58086,2020.csv,2020,0.0,1.0
18674,The Uncovering,58064,0,58064,2018.csv,2018,0.0,1.0
18675,The Street,58055,0,58055,2019.csv,2019,0.0,1.0
18676,The Maid 2012 Re-release,58054,0,58054,2012.csv,2012,0.0,1.0
18677,Taklimakan's Drum Beat,58026,0,58026,2017.csv,2017,0.0,1.0
18678,The Dune,57993,0,57993,2014.csv,2014,0.0,1.0
18679,The Reef,57986,0,57986,2011.csv,2011,0.0,1.0
18680,The Boom,57962,57962,0,2017.csv,2017,1.0,0.0
18681,The Yellow Birds,57946,0,57946,2018.csv,2018,0.0,1.0
18682,Reservoir Dogs 2012 Re-release,57934,0,57934,2012.csv,2012,0.0,1.0
18683,Followed by My Men,57839,0,57839,2010.csv,2010,0.0,1.0
18684,Skvis,57780,0,57780,2012.csv,2012,0.0,1.0
18685,Ecinni,57778,0,57778,2018.csv,2018,0.0,1.0
18686,Russkie gruziny. Film pervyy,57763,0,57763,2020.csv,2020,0.0,1.0
18687,Friends Forever 2012 Re-release,57761,0,57761,2012.csv,2012,0.0,1.0
18688,Rififi 2015 Re-release,57749,57749,0,2015.csv,2015,1.0,0.0
18689,The Metropolitan Opera HD Live: Donizetti: Lucia di Lammermoor 2011 Re-release,57742,0,57742,2011.csv,2011,0.0,1.0
18690,E San Old New Song 2,57728,0,57728,2016.csv,2016,0.0,1.0
18691,Vuelo Sobre Ti Zapato 3,57726,0,57726,2015.csv,2015,0.0,1.0
18692,Eye Above Prague,57694,0,57694,2010.csv,2010,0.0,1.0
18693,Desautorizados,57691,0,57691,2010.csv,2010,0.0,1.0
18694,The Deer Hunter 2018 Re-release,57678,0,57678,2018.csv,2018,0.0,1.0
18695,Rangeela Raja,57674,0,57674,2019.csv,2019,0.0,1.0
18696,Joel 2019 Re-release,57638,0,57638,2019.csv,2019,0.0,1.0
18697,Command and Control,57635,57635,0,2016.csv,2016,1.0,0.0
18698,Battleship Potemkin,57620,51198,6422,2011.csv,2011,0.888545643873655,0.11145435612634502
18699,Sangili Bungili Kadhava Thorae,57605,0,57605,2017.csv,2017,0.0,1.0
18700,Playback,57587,264,57323,2012.csv,2012,0.00458436799972216,0.9954156320002778
18701,Sold,57527,57527,0,2016.csv,2016,1.0,0.0
18702,Spider Murphy Gang - Glory Days of Rock 'n' Roll,57506,0,57506,2019.csv,2019,0.0,1.0
18703,"The Poem, My Old Mother",57476,0,57476,2019.csv,2019,0.0,1.0
18704,American Passages,57450,0,57450,2011.csv,2011,0.0,1.0
18705,O Mercado de Notícias,57447,0,57447,2014.csv,2014,0.0,1.0
18706,Meshok bez dna,57420,0,57420,2018.csv,2018,0.0,1.0
18707,Court,57416,22898,34518,2015.csv,2015,0.39880869444057404,0.6011913055594259
18708,Menocchio the Heretic,57404,0,57404,2018.csv,2018,0.0,1.0
18709,Maradonapoli,57389,0,57389,2017.csv,2017,0.0,1.0
18710,Ramen Heads,57345,57345,0,2018.csv,2018,1.0,0.0
18711,Just a Stranger,57338,0,57338,2019.csv,2019,0.0,1.0
18712,Hire a Woman,57306,0,57306,2019.csv,2019,0.0,1.0
18713,Jasper: Penguin Explorer 2011 Re-release,57264,0,57264,2011.csv,2011,0.0,1.0
18714,Daniel,57263,0,57263,2020.csv,2020,0.0,1.0
18715,At Dusk,57259,0,57259,2019.csv,2019,0.0,1.0
18716,Saber Google,57246,0,57246,2016.csv,2016,0.0,1.0
18717,Love of Hope,57229,0,57229,2017.csv,2017,0.0,1.0
18718,Pelle Politibil går i vannet 2014 Re-release,57203,0,57203,2014.csv,2014,0.0,1.0
18719,Run & Jump,57189,20061,37128,2014.csv,2014,0.3507842417248072,0.6492157582751927
18720,Mickey and the Bear,57188,57188,0,2019.csv,2019,1.0,0.0
18721,Watchtower,57187,0,57187,2012.csv,2012,0.0,1.0
18722,For the Good of Others 2011 Re-release,57142,0,57142,2011.csv,2011,0.0,1.0
18723,Karuzela,57106,0,57106,2014.csv,2014,0.0,1.0
18724,Hanna's Homecoming,57096,0,57096,2019.csv,2019,0.0,1.0
18725,Princess Mononoke 2010 Re-release,57095,0,57095,2010.csv,2010,0.0,1.0
18726,The Good Intentions,57093,0,57093,2019.csv,2019,0.0,1.0
18727,I Can Quit Whenever I Want 2016 Re-release,57087,0,57087,2016.csv,2016,0.0,1.0
18728,Back to Stay,57080,0,57080,2012.csv,2012,0.0,1.0
18729,Zalgirio Musis (Battle of Grunwald),57065,0,57065,2019.csv,2019,0.0,1.0
18730,Reencarnación 2013 Re-release,57011,0,57011,2013.csv,2013,0.0,1.0
18731,Legalize Já: Amizade Nunca Morre,57004,0,57004,2018.csv,2018,0.0,1.0
18732,The Metropolitan Opera HD Live: Mozart: Don Giovanni,56991,0,56991,2011.csv,2011,0.0,1.0
18733,The Survivalist,56971,0,56971,2016.csv,2016,0.0,1.0
18734,Dream Breaker,56948,0,56948,2018.csv,2018,0.0,1.0
18735,Rangreza,56903,0,56903,2017.csv,2017,0.0,1.0
18736,My Joy,56857,6298,50559,2011.csv,2011,0.11076912253548375,0.8892308774645162
18737,The Battle of Algiers 2016 Re-release,56853,56853,0,2016.csv,2016,1.0,0.0
18738,Carmen,56804,0,56804,2018.csv,2018,0.0,1.0
18739,Julemandens datter 2,56775,0,56775,2020.csv,2020,0.0,1.0
18740,Number 55,56732,0,56732,2014.csv,2014,0.0,1.0
18741,Batman: Return of the Caped Crusaders,56711,0,56711,2016.csv,2016,0.0,1.0
18742,Provoked: A True Story 2014 Re-release,56710,0,56710,2014.csv,2014,0.0,1.0
18743,The Mirror 2019 Re-release,56704,0,56704,2019.csv,2019,0.0,1.0
18744,Lang Tong,56609,0,56609,2015.csv,2015,0.0,1.0
18745,The Youth,56605,0,56605,2015.csv,2015,0.0,1.0
18746,Seeking Happily Ever After,56580,0,56580,2018.csv,2018,0.0,1.0
18747,Farmageddon,56573,56573,0,2011.csv,2011,1.0,0.0
18748,We Are Legends,56560,0,56560,2019.csv,2019,0.0,1.0
18749,Soy Nero,56551,0,56551,2016.csv,2016,0.0,1.0
18750,Stella 2011 Re-release,56541,0,56541,2011.csv,2011,0.0,1.0
18751,Errementari,56516,0,56516,2018.csv,2018,0.0,1.0
18752,Yugo and Lala,56496,0,56496,2013.csv,2013,0.0,1.0
18753,Muran,56493,30116,26377,2011.csv,2011,0.5330925955428106,0.46690740445718937
18754,Beyond the Black Rainbow,56491,56491,0,2012.csv,2012,1.0,0.0
18755,Bukgandoeui Sipjaga,56445,0,56445,2019.csv,2019,0.0,1.0
18756,Metalhead,56439,0,56439,2013.csv,2013,0.0,1.0
18757,Mamma Mia! Here We Go Again 2020 Re-release,56436,0,56436,2020.csv,2020,0.0,1.0
18758,The String 2010 Re-release,56427,0,56427,2010.csv,2010,0.0,1.0
18759,La mala verdad,56400,0,56400,2011.csv,2011,0.0,1.0
18760,Cargo,56385,0,56385,2018.csv,2018,0.0,1.0
18761,Tess,56364,0,56364,2017.csv,2017,0.0,1.0
18762,The Grizzlies,56361,11650,44711,2020.csv,2020,0.20670321676336473,0.7932967832366352
18763,Echoes of Fear,56360,0,56360,2019.csv,2019,0.0,1.0
18764,The Tortured,56337,0,56337,2011.csv,2011,0.0,1.0
18765,13 2012 Re-release,56288,0,56288,2012.csv,2012,0.0,1.0
18766,Big Men,56286,56286,0,2014.csv,2014,1.0,0.0
18767,Frankenstein 2012 Re-release,56275,0,56275,2012.csv,2012,0.0,1.0
18768,Noor,56272,0,56272,2017.csv,2017,0.0,1.0
18769,Pàtria,56263,0,56263,2017.csv,2017,0.0,1.0
18770,Comic Sans,56259,0,56259,2018.csv,2018,0.0,1.0
18771,Chung Cu Ma,56247,0,56247,2015.csv,2015,0.0,1.0
18772,BoBoiBoy Movie 2,56245,0,56245,2019.csv,2019,0.0,1.0
18773,Sole,56232,0,56232,2019.csv,2019,0.0,1.0
18774,Saving Brinton,56218,56218,0,2017.csv,2017,1.0,0.0
18775,Return to Bollene,56215,0,56215,2018.csv,2018,0.0,1.0
18776,Crooked House 2019 Re-release,56204,0,56204,2019.csv,2019,0.0,1.0
18777,"Madrid, 1987",56203,0,56203,2012.csv,2012,0.0,1.0
18778,Wedding Doll,56196,56196,0,2016.csv,2016,1.0,0.0
18779,Navy Seals vs. Zombies,56191,0,56191,2016.csv,2016,0.0,1.0
18780,The Day Will Come,56187,0,56187,2017.csv,2017,0.0,1.0
18781,Notebook,56166,0,56166,2019.csv,2019,0.0,1.0
18782,False Confessions,56165,29245,26920,2017.csv,2017,0.5206979435591561,0.47930205644084395
18783,The Day 2014 Re-release,56162,0,56162,2014.csv,2014,0.0,1.0
18784,Metallica - Français pour une nuit,56156,0,56156,2019.csv,2019,0.0,1.0
18785,The Perfect Stranger,56141,0,56141,2012.csv,2012,0.0,1.0
18786,Jhalle,56115,0,56115,2019.csv,2019,0.0,1.0
18787,"Iqbal, a Tale of a Fearless Child",56101,0,56101,2016.csv,2016,0.0,1.0
18788,Reklam,56053,0,56053,2012.csv,2012,0.0,1.0
18789,Notebook from My Mother,56047,0,56047,2018.csv,2018,0.0,1.0
18790,Star Nextdoor,56035,0,56035,2017.csv,2017,0.0,1.0
18791,Les deux amis 2019 Re-release,56030,0,56030,2019.csv,2019,0.0,1.0
18792,Dioses y perros,56022,0,56022,2014.csv,2014,0.0,1.0
18793,The Bear,56014,0,56014,2011.csv,2011,0.0,1.0
18794,The Sea of Trees 2018 Re-release,56010,0,56010,2018.csv,2018,0.0,1.0
18795,Évolution,55985,24770,31215,2016.csv,2016,0.4424399392694472,0.5575600607305529
18796,Shang Hun,55966,0,55966,2017.csv,2017,0.0,1.0
18797,Once Upon a Time in the West 2016 Re-release,55890,0,55890,2016.csv,2016,0.0,1.0
18798,Saint Judy 2020 Re-release,55872,0,55872,2020.csv,2020,0.0,1.0
18799,Vitalina Varela,55862,14941,40921,2019.csv,2019,0.2674626758798468,0.7325373241201533
18800,A Mãe é que Sabe,55848,0,55848,2016.csv,2016,0.0,1.0
18801,Terms and Conditions May Apply,55824,55824,0,2013.csv,2013,1.0,0.0
18802,L'autre monde 2010 Re-release,55772,0,55772,2010.csv,2010,0.0,1.0
18803,Bu jian bu san,55750,0,55750,2017.csv,2017,0.0,1.0
18804,Engagement,55741,0,55741,2019.csv,2019,0.0,1.0
18805,Lost in Armenia,55736,0,55736,2016.csv,2016,0.0,1.0
18806,Horses of God,55725,0,55725,2013.csv,2013,0.0,1.0
18807,Povestea unui pierde-vara,55724,0,55724,2018.csv,2018,0.0,1.0
18808,Disappearance,55715,0,55715,2017.csv,2017,0.0,1.0
18809,Hellion,55708,55708,0,2014.csv,2014,1.0,0.0
18810,XX,55668,30911,24757,2017.csv,2017,0.5552741251706546,0.4447258748293454
18811,Cesta vzhuru,55654,0,55654,2015.csv,2015,0.0,1.0
18812,Serdtse mira,55643,0,55643,2018.csv,2018,0.0,1.0
18813,Frida Kahlo,55632,0,55632,2020.csv,2020,0.0,1.0
18814,Recorder: The Marion Stokes Project,55632,55632,0,2019.csv,2019,1.0,0.0
18815,Holidays,55621,0,55621,2016.csv,2016,0.0,1.0
18816,As Good as Dead,55618,1981,53637,2010.csv,2010,0.03561796540688266,0.9643820345931173
18817,Vlad's legacy,55584,0,55584,2016.csv,2016,0.0,1.0
18818,Abou Leila,55581,0,55581,2020.csv,2020,0.0,1.0
18819,Begstvo rogatykh vikingov,55578,0,55578,2019.csv,2019,0.0,1.0
18820,Rumbling,55560,0,55560,2015.csv,2015,0.0,1.0
18821,Liberté,55557,0,55557,2019.csv,2019,0.0,1.0
18822,Pugni chiusi,55539,0,55539,2010.csv,2010,0.0,1.0
18823,Grey Met Shrek,55533,0,55533,2014.csv,2014,0.0,1.0
18824,A Million Colours,55532,0,55532,2012.csv,2012,0.0,1.0
18825,Kaka Ji,55531,0,55531,2019.csv,2019,0.0,1.0
18826,Finding Joe,55518,55518,0,2011.csv,2011,1.0,0.0
18827,Heathers 2018 Re-release,55507,0,55507,2018.csv,2018,0.0,1.0
18828,Entertainment,55506,55506,0,2015.csv,2015,1.0,0.0
18829,Modris,55489,0,55489,2014.csv,2014,0.0,1.0
18830,Banjara - The Truck Driver,55475,0,55475,2018.csv,2018,0.0,1.0
18831,Naam Shabana,55429,0,55429,2017.csv,2017,0.0,1.0
18832,Last Night,55417,0,55417,2017.csv,2017,0.0,1.0
18833,Un amore così grande,55391,0,55391,2018.csv,2018,0.0,1.0
18834,Tridtsat sedmoy roman,55381,0,55381,2011.csv,2011,0.0,1.0
18835,"Moskva, ya terplyu tebya",55379,0,55379,2016.csv,2016,0.0,1.0
18836,Into Eternity,55366,55366,0,2011.csv,2011,1.0,0.0
18837,Timeless Love,55361,0,55361,2012.csv,2012,0.0,1.0
18838,Gone Too Far,55304,0,55304,2014.csv,2014,0.0,1.0
18839,C.O.G.,55301,55301,0,2013.csv,2013,1.0,0.0
18840,Natural Selection,55282,55282,0,2012.csv,2012,1.0,0.0
18841,Imseonggu,55272,0,55272,2011.csv,2011,0.0,1.0
18842,Kart Ahmar,55266,0,55266,2017.csv,2017,0.0,1.0
18843,Candy Planet,55256,0,55256,2016.csv,2016,0.0,1.0
18844,Uchu Sentai Kyuranger vs. Space Squad,55201,0,55201,2018.csv,2018,0.0,1.0
18845,Stockholm 2015 Re-release,55192,0,55192,2015.csv,2015,0.0,1.0
18846,Die Tigerentenbande - Der Film,55191,0,55191,2011.csv,2011,0.0,1.0
18847,Mil coses que faria per tu,55181,0,55181,2017.csv,2017,0.0,1.0
18848,Mamma Mia! 2018 Re-release,55168,39601,15567,2018.csv,2018,0.7178255510440835,0.2821744489559165
18849,Antonio Vega. Tu voz entre otras mil,55104,0,55104,2014.csv,2014,0.0,1.0
18850,Come as You Are 2020 Re-release,55093,0,55093,2020.csv,2020,0.0,1.0
18851,American Dream: Detroit,55092,55092,0,2018.csv,2018,1.0,0.0
18852,Hanna's Sleeping Dogs,55072,0,55072,2016.csv,2016,0.0,1.0
18853,Sinsiran: Yasak Ask,55061,0,55061,2017.csv,2017,0.0,1.0
18854,The Metropolitan Opera HD Live: Verdi: Don Carlo,55056,0,55056,2011.csv,2011,0.0,1.0
18855,The Lovely Month of May,55038,55038,0,2013.csv,2013,1.0,0.0
18856,The Conformist 2011 Re-release,55031,0,55031,2011.csv,2011,0.0,1.0
18857,AquaTales,55029,0,55029,2012.csv,2012,0.0,1.0
18858,Zombeavers,54985,14947,40038,2014.csv,2014,0.27183777393834685,0.7281622260616532
18859,Coda,54948,0,54948,2020.csv,2020,0.0,1.0
18860,The Storytelling Show,54942,0,54942,2010.csv,2010,0.0,1.0
18861,Between Worlds,54941,0,54941,2017.csv,2017,0.0,1.0
18862,I Want You 2014 Re-release,54938,0,54938,2014.csv,2014,0.0,1.0
18863,The Great Mystical Circus,54926,0,54926,2018.csv,2018,0.0,1.0
18864,DAZN Boxing: Canelo Alvarez vs. Rocky Fielding,54916,54916,0,2018.csv,2018,1.0,0.0
18865,City of Tiny Lights,54903,0,54903,2017.csv,2017,0.0,1.0
18866,Haunted,54903,0,54903,2021.csv,2021,0.0,1.0
18867,Never Give Up,54903,0,54903,2016.csv,2016,0.0,1.0
18868,Feu: Crazy Horse Paris,54891,0,54891,2013.csv,2013,0.0,1.0
18869,When Angels Sleep,54850,0,54850,2018.csv,2018,0.0,1.0
18870,Snowmen,54805,54805,0,2011.csv,2011,1.0,0.0
18871,Mr. And Mrs. Oways,54796,0,54796,2012.csv,2012,0.0,1.0
18872,Metallica: Quebec Magnetic,54789,0,54789,2017.csv,2017,0.0,1.0
18873,The Mirror Boy,54771,0,54771,2011.csv,2011,0.0,1.0
18874,Tenderness,54760,0,54760,2013.csv,2013,0.0,1.0
18875,Rainbow Playground,54757,0,54757,2019.csv,2019,0.0,1.0
18876,Sundarapandian,54737,0,54737,2012.csv,2012,0.0,1.0
18877,Paw Patrol: Mission Big Screen,54731,0,54731,2017.csv,2017,0.0,1.0
18878,Don't Cry for Me England,54695,0,54695,2018.csv,2018,0.0,1.0
18879,Orecchie,54681,0,54681,2017.csv,2017,0.0,1.0
18880,Romeo Ranjha,54681,0,54681,2014.csv,2014,0.0,1.0
18881,Bings Kerstfeest en andere Verhalen,54676,0,54676,2020.csv,2020,0.0,1.0
18882,Red Sky,54659,0,54659,2011.csv,2011,0.0,1.0
18883,La capture 2010 Re-release,54655,0,54655,2010.csv,2010,0.0,1.0
18884,The Nature of Existence,54645,54645,0,2010.csv,2010,1.0,0.0
18885,Blade Runner 2019 Re-release,54627,0,54627,2019.csv,2019,0.0,1.0
18886,Berliner Philharmoniker: A Musical Journey in 3D,54604,0,54604,2011.csv,2011,0.0,1.0
18887,What Our Fathers Did: A Nazi Legacy,54603,40119,14484,2015.csv,2015,0.734739849458821,0.2652601505411791
18888,Princess of Rome,54580,0,54580,2015.csv,2015,0.0,1.0
18889,Hotel by the River 2020 Re-release,54565,0,54565,2020.csv,2020,0.0,1.0
18890,The Lottery,54543,54543,0,2010.csv,2010,1.0,0.0
18891,5.18 Hinzpeter Story,54523,0,54523,2018.csv,2018,0.0,1.0
18892,Juliette,54511,0,54511,2013.csv,2013,0.0,1.0
18893,Those Who Fear Are Dead,54481,0,54481,2016.csv,2016,0.0,1.0
18894,The Harimaya Bridge,54473,54473,0,2010.csv,2010,1.0,0.0
18895,Poyraz Karayel: Global Capital,54455,0,54455,2017.csv,2017,0.0,1.0
18896,The Abandoned 2010 Re-release,54439,0,54439,2010.csv,2010,0.0,1.0
18897,Tracker,54437,0,54437,2011.csv,2011,0.0,1.0
18898,A Simple Wedding,54415,54415,0,2020.csv,2020,1.0,0.0
18899,Angels of Sex,54405,0,54405,2012.csv,2012,0.0,1.0
18900,Shining Moment,54379,0,54379,2017.csv,2017,0.0,1.0
18901,Hashima Project,54372,0,54372,2014.csv,2014,0.0,1.0
18902,We Will Sing,54360,0,54360,2015.csv,2015,0.0,1.0
18903,Princess Emmy,54328,0,54328,2019.csv,2019,0.0,1.0
18904,Digimon Adventure tri. Part 6: Future,54324,54324,0,2018.csv,2018,1.0,0.0
18905,Harlan: In the Shadow of Jew Suess,54305,54305,0,2010.csv,2010,1.0,0.0
18906,Remélem legközelebb sikerül meghalnod:),54305,0,54305,2018.csv,2018,0.0,1.0
18907,Wondrous Boccaccio 2016 Re-release,54280,0,54280,2016.csv,2016,0.0,1.0
18908,The Sleeping Beauties,54280,0,54280,2012.csv,2012,0.0,1.0
18909,The Search for General Tso,54275,54275,0,2015.csv,2015,1.0,0.0
18910,The Boy and the Beast 2018 Re-release,54266,0,54266,2018.csv,2018,0.0,1.0
18911,Agava,54251,0,54251,2016.csv,2016,0.0,1.0
18912,The Citizen,54249,0,54249,2017.csv,2017,0.0,1.0
18913,Tout est permis,54226,0,54226,2014.csv,2014,0.0,1.0
18914,Wagner & Me 2012 Re-release,54215,37745,16470,2012.csv,2012,0.6962095361062437,0.30379046389375636
18915,"Sarkari. Hi. Pra. Shale Kasaragodu, Koduge: Ramanna Rai",54213,0,54213,2018.csv,2018,0.0,1.0
18916,Clowntergeist,54209,0,54209,2018.csv,2018,0.0,1.0
18917,Line of Duty,54204,54204,0,2013.csv,2013,1.0,0.0
18918,For Love Let Go,54194,0,54194,2016.csv,2016,0.0,1.0
18919,Journey to the Forbidden Valley,54176,0,54176,2017.csv,2017,0.0,1.0
18920,Saysary Kuelge...,54138,0,54138,2016.csv,2016,0.0,1.0
18921,Wi-seon-ja-deul,54129,0,54129,2015.csv,2015,0.0,1.0
18922,Contracted 2014 Re-release,54116,0,54116,2014.csv,2014,0.0,1.0
18923,Last Passenger,54110,14806,39304,2014.csv,2014,0.2736277952319349,0.7263722047680651
18924,Every Blessed Day 2014 Re-release,54076,0,54076,2014.csv,2014,0.0,1.0
18925,Low Down,54051,54051,0,2014.csv,2014,1.0,0.0
18926,Klip 2014 Re-release,54032,0,54032,2014.csv,2014,0.0,1.0
18927,A Beautiful Soul,54008,54008,0,2012.csv,2012,1.0,0.0
18928,In Turmoil,53999,0,53999,2012.csv,2012,0.0,1.0
18929,Surviving Progress,53953,53953,0,2012.csv,2012,1.0,0.0
18930,The Assassin's Code,53940,11218,42722,2018.csv,2018,0.20797182054134222,0.7920281794586578
18931,Harajuku,53901,0,53901,2018.csv,2018,0.0,1.0
18932,An Old Lady,53887,0,53887,2020.csv,2020,0.0,1.0
18933,The Last Man on the Moon,53881,52482,1399,2016.csv,2016,0.9740353742506634,0.0259646257493365
18934,National Theatre Live: The Habit of Art,53865,0,53865,2010.csv,2010,0.0,1.0
18935,Yugo,53860,0,53860,2016.csv,2016,0.0,1.0
18936,El mural 2011 Re-release,53860,0,53860,2011.csv,2011,0.0,1.0
18937,Stardust,53850,9087,44763,2020.csv,2020,0.1687465181058496,0.8312534818941504
18938,Wasted on the Young,53844,0,53844,2011.csv,2011,0.0,1.0
18939,The Summer of Sangaile,53843,4480,49363,2015.csv,2015,0.0832048734283008,0.9167951265716991
18940,At Middleton,53837,53837,0,2014.csv,2014,1.0,0.0
18941,I Will Wait for You,53835,0,53835,2017.csv,2017,0.0,1.0
18942,Baaz,53822,0,53822,2014.csv,2014,0.0,1.0
18943,Otzi and the Mystery of Time,53815,0,53815,2018.csv,2018,0.0,1.0
18944,Rising from Ashes,53804,38602,15202,2013.csv,2013,0.7174559512303917,0.2825440487696082
18945,The Heir Apparent: Largo Winch 2011 Re-release,53793,10352,43441,2011.csv,2011,0.1924413957206328,0.8075586042793672
18946,Down by Love,53780,675,53105,2016.csv,2016,0.012551134250650799,0.9874488657493492
18947,Pettersson und Findus 2 - Das schönste Weihnachten überhaupt 2018 Re-release,53779,0,53779,2018.csv,2018,0.0,1.0
18948,Blunt Force Trauma,53752,0,53752,2015.csv,2015,0.0,1.0
18949,Ya Ya,53747,0,53747,2013.csv,2013,0.0,1.0
18950,The Legend of Hallowaiian,53738,451,53287,2018.csv,2018,0.00839257136476981,0.9916074286352302
18951,Egoli: Afrikaners is Plesierig,53736,0,53736,2010.csv,2010,0.0,1.0
18952,El Candidato,53727,0,53727,2016.csv,2016,0.0,1.0
18953,The Other F Word,53714,53714,0,2011.csv,2011,1.0,0.0
18954,Lost Minds,53708,0,53708,2016.csv,2016,0.0,1.0
18955,Leonie 2013 Re-release,53692,53692,0,2013.csv,2013,1.0,0.0
18956,Che: Part One 2018 Re-release,53647,0,53647,2018.csv,2018,0.0,1.0
18957,Taxi Driver 2016 Re-release,53647,0,53647,2016.csv,2016,0.0,1.0
18958,Tik Tik Tik,53599,0,53599,2018.csv,2018,0.0,1.0
18959,Srinivasa Kalyanam,53583,0,53583,2018.csv,2018,0.0,1.0
18960,It's a Wonderful Life 2020 Re-release,53578,44000,9578,2020.csv,2020,0.8212325954682892,0.17876740453171078
18961,The Fear of Darkness,53569,0,53569,2016.csv,2016,0.0,1.0
18962,Everyday Rebellion,53532,0,53532,2014.csv,2014,0.0,1.0
18963,Grass,53503,8084,45419,2018.csv,2018,0.15109433115900042,0.8489056688409996
18964,The Man of the Crowd,53499,0,53499,2014.csv,2014,0.0,1.0
18965,One Night or Whole Life,53487,0,53487,2017.csv,2017,0.0,1.0
18966,Laplace's Witch 2019 Re-release,53463,0,53463,2019.csv,2019,0.0,1.0
18967,Sing 2021 Re-release,53462,53000,462,2021.csv,2021,0.9913583479854851,0.008641652014514983
18968,Im Bazar der Geschlechter,53451,0,53451,2010.csv,2010,0.0,1.0
18969,Parole,53446,0,53446,2018.csv,2018,0.0,1.0
18970,Hemathi Bethebini,53435,0,53435,2014.csv,2014,0.0,1.0
18971,Assandira,53378,0,53378,2020.csv,2020,0.0,1.0
18972,Por mis bigotes,53358,0,53358,2016.csv,2016,0.0,1.0
18973,God of Vampires,53345,53345,0,2010.csv,2010,1.0,0.0
18974,The Metropolitan Opera HD Live: Rossini: Le Comte Ory,53291,0,53291,2011.csv,2011,0.0,1.0
18975,"Mi újság, kuflik?",53259,0,53259,2019.csv,2019,0.0,1.0
18976,"Fermín, glorias del tango",53249,0,53249,2014.csv,2014,0.0,1.0
18977,Wild League,53226,0,53226,2019.csv,2019,0.0,1.0
18978,Slipknot: Day of the Gusano,53202,0,53202,2017.csv,2017,0.0,1.0
18979,Food Beware: The French Organic Revolution 2013 Re-release,53190,0,53190,2013.csv,2013,0.0,1.0
18980,Little World,53175,0,53175,2013.csv,2013,0.0,1.0
18981,"Socorro, Virei uma Garota!",53154,0,53154,2019.csv,2019,0.0,1.0
18982,Workers - Pronti a tutto,53120,0,53120,2012.csv,2012,0.0,1.0
18983,Fer Mamla Gadbad Gadbad,53106,0,53106,2013.csv,2013,0.0,1.0
18984,The Kids Are All Right 2012 Re-release,53101,0,53101,2012.csv,2012,0.0,1.0
18985,The Great Silence,53074,53074,0,2018.csv,2018,1.0,0.0
18986,Raju Gari Gadhi 2,53012,0,53012,2017.csv,2017,0.0,1.0
18987,Jeena Isi Ka Naam Hai,52982,0,52982,2017.csv,2017,0.0,1.0
18988,Beast of Burden,52976,0,52976,2018.csv,2018,0.0,1.0
18989,Devil's Gate,52966,0,52966,2018.csv,2018,0.0,1.0
18990,Bulb Fiction,52958,0,52958,2011.csv,2011,0.0,1.0
18991,Love Thy Nature,52947,41149,11798,2015.csv,2015,0.7771733998149093,0.22282660018509076
18992,Jonathan 2018 Re-release,52923,0,52923,2018.csv,2018,0.0,1.0
18993,Reverse 666,52923,0,52923,2015.csv,2015,0.0,1.0
18994,Ping Pong Summer,52909,52909,0,2014.csv,2014,1.0,0.0
18995,Mia and the Migoo 2010 Re-release,52873,17000,35873,2010.csv,2010,0.3215251640723999,0.6784748359276
18996,Hello World!,52871,0,52871,2019.csv,2019,0.0,1.0
18997,Der letzte Mentsch,52862,0,52862,2014.csv,2014,0.0,1.0
18998,The Troupe,52850,0,52850,2018.csv,2018,0.0,1.0
18999,Betroit,52849,0,52849,2013.csv,2013,0.0,1.0
19000,Ambivalence,52843,0,52843,2019.csv,2019,0.0,1.0
19001,Bolevoy porog,52840,0,52840,2019.csv,2019,0.0,1.0
19002,Sadhu Miranda 2013 Re-release,52825,0,52825,2013.csv,2013,0.0,1.0
19003,To Be Takei,52823,52823,0,2014.csv,2014,1.0,0.0
19004,Shivalinga,52787,0,52787,2017.csv,2017,0.0,1.0
19005,Dara of Jasenovac,52786,52786,0,2021.csv,2021,1.0,0.0
19006,Occupy Unmasked,52768,52768,0,2012.csv,2012,1.0,0.0
19007,The Hopes & Dreams of Gazza Snell,52759,0,52759,2011.csv,2011,0.0,1.0
19008,Asgar Cin Vadisi,52707,0,52707,2019.csv,2019,0.0,1.0
19009,Unbridled,52697,0,52697,2018.csv,2018,0.0,1.0
19010,!Women Art Revolution,52681,52681,0,2011.csv,2011,1.0,0.0
19011,My Life,52631,0,52631,2018.csv,2018,0.0,1.0
19012,We Roared Past Youth,52559,0,52559,2017.csv,2017,0.0,1.0
19013,Salvation Army,52511,3929,48582,2014.csv,2014,0.07482241816000457,0.9251775818399954
19014,Cropsey,52476,52476,0,2010.csv,2010,1.0,0.0
19015,It's Your Fault,52475,0,52475,2010.csv,2010,0.0,1.0
19016,Going Attractions: The Definitive Story of the American Drive-in Movie,52458,52458,0,2013.csv,2013,1.0,0.0
19017,A Tale of Winter,52431,23268,29163,2014.csv,2014,0.4437832579962236,0.5562167420037764
19018,For the Good of Others 2012 Re-release,52416,0,52416,2012.csv,2012,0.0,1.0
19019,The Skin of the Wolf,52408,0,52408,2018.csv,2018,0.0,1.0
19020,Anna,52393,0,52393,2016.csv,2016,0.0,1.0
19021,Breath Made Visible: Anna Halprin,52387,52387,0,2010.csv,2010,1.0,0.0
19022,Fake Orgasm,52386,0,52386,2010.csv,2010,0.0,1.0
19023,Kusatma Yedi Uyuyanlar,52371,0,52371,2019.csv,2019,0.0,1.0
19024,Birdboy: The Forgotten Children,52366,38786,13580,2017.csv,2017,0.7406714280258183,0.25932857197418174
19025,Finnish Blood Swedish Heart,52361,0,52361,2013.csv,2013,0.0,1.0
19026,The Little Mermaid 2020 Re-release,52344,0,52344,2020.csv,2020,0.0,1.0
19027,Novogodniy remont,52330,0,52330,2019.csv,2019,0.0,1.0
19028,Chudail Story,52325,0,52325,2016.csv,2016,0.0,1.0
19029,Here and There,52307,27156,25151,2010.csv,2010,0.5191656948400788,0.48083430515992126
19030,The Human Experience,52296,52296,0,2010.csv,2010,1.0,0.0
19031,The Human Cargo,52267,0,52267,2012.csv,2012,0.0,1.0
19032,Semur 2: Cinlerin Büyüsü,52262,0,52262,2020.csv,2020,0.0,1.0
19033,Legend Second of Tang Dynasty,52260,0,52260,2018.csv,2018,0.0,1.0
19034,Schilf,52243,0,52243,2012.csv,2012,0.0,1.0
19035,10 Days Before the Wedding,52238,0,52238,2019.csv,2019,0.0,1.0
19036,Jo's Boy 2012 Re-release,52236,0,52236,2012.csv,2012,0.0,1.0
19037,La Chana,52217,0,52217,2017.csv,2017,0.0,1.0
19038,Love in 7 Days,52168,0,52168,2018.csv,2018,0.0,1.0
19039,Oru Adaar Love,52156,0,52156,2019.csv,2019,0.0,1.0
19040,Sordo 2019 Re-release,52132,0,52132,2019.csv,2019,0.0,1.0
19041,Kind Hearts and Coronets 2011 Re-release,52119,0,52119,2011.csv,2011,0.0,1.0
19042,Lost in Vietnam,52113,0,52113,2016.csv,2016,0.0,1.0
19043,Ardab Mutiyaran,52112,0,52112,2019.csv,2019,0.0,1.0
19044,The Wall of Shadows,52104,0,52104,2021.csv,2021,0.0,1.0
19045,Saezuru Tori Wa Habatakanai: The Clouds Gather,52065,0,52065,2020.csv,2020,0.0,1.0
19046,The Nest of the Turtledove,52064,0,52064,2016.csv,2016,0.0,1.0
19047,Star,52044,0,52044,2014.csv,2014,0.0,1.0
19048,Wagner & Me,52037,0,52037,2011.csv,2011,0.0,1.0
19049,Armed Response,52036,0,52036,2018.csv,2018,0.0,1.0
19050,The Frost 2012 Re-release,52024,0,52024,2012.csv,2012,0.0,1.0
19051,Henri-Georges Clouzot's Inferno,52003,25489,26514,2010.csv,2010,0.4901447993384997,0.5098552006615003
19052,Malan Flower Blooms,51996,0,51996,2018.csv,2018,0.0,1.0
19053,Road Games,51985,0,51985,2016.csv,2016,0.0,1.0
19054,A Step Into Darkness,51955,0,51955,2010.csv,2010,0.0,1.0
19055,Emanet,51950,0,51950,2016.csv,2016,0.0,1.0
19056,Malice,51946,0,51946,2016.csv,2016,0.0,1.0
19057,Problemski Hotel,51940,0,51940,2016.csv,2016,0.0,1.0
19058,Disco Raja,51934,0,51934,2020.csv,2020,0.0,1.0
19059,MULT v kino. Vol 120,51895,0,51895,2020.csv,2020,0.0,1.0
19060,American Dharma,51891,51891,0,2019.csv,2019,1.0,0.0
19061,Russkie evrei. Film pervyy. Do revolutsii,51871,0,51871,2016.csv,2016,0.0,1.0
19062,Quay,51858,51858,0,2015.csv,2015,1.0,0.0
19063,Forever Young 2017 Re-release,51807,0,51807,2017.csv,2017,0.0,1.0
19064,Arrêtez-moi,51806,0,51806,2014.csv,2014,0.0,1.0
19065,Nene Raju Nene Mantri,51805,0,51805,2017.csv,2017,0.0,1.0
19066,Goroskop na udachu,51803,0,51803,2015.csv,2015,0.0,1.0
19067,Tiptoe Say I Love You,51799,0,51799,2019.csv,2019,0.0,1.0
19068,American Hero,51797,0,51797,2016.csv,2016,0.0,1.0
19069,About Rock,51747,0,51747,2017.csv,2017,0.0,1.0
19070,The Snowman Trek,51743,51743,0,2018.csv,2018,1.0,0.0
19071,Monkey,51719,0,51719,2016.csv,2016,0.0,1.0
19072,Wanda 2018 Re-release,51713,51713,0,2018.csv,2018,1.0,0.0
19073,Midnight Family,51712,42310,9402,2019.csv,2019,0.8181853341584159,0.18181466584158415
19074,Milyonluk Kus,51710,0,51710,2018.csv,2018,0.0,1.0
19075,Blue Busking,51671,0,51671,2017.csv,2017,0.0,1.0
19076,UFC 205: Alvarez vs. McGregor,51660,0,51660,2016.csv,2016,0.0,1.0
19077,Shark School,51646,0,51646,2020.csv,2020,0.0,1.0
19078,D@bbe 2 2013 Re-release,51613,0,51613,2013.csv,2013,0.0,1.0
19079,The Knot,51594,0,51594,2012.csv,2012,0.0,1.0
19080,The Italian Job 2019 Re-Release,51590,0,51590,2019.csv,2019,0.0,1.0
19081,Aate Di Chidi,51577,0,51577,2018.csv,2018,0.0,1.0
19082,Raja The Great,51568,0,51568,2017.csv,2017,0.0,1.0
19083,El clásico,51540,0,51540,2016.csv,2016,0.0,1.0
19084,The Debt,51534,0,51534,2015.csv,2015,0.0,1.0
19085,Ember,51505,0,51505,2016.csv,2016,0.0,1.0
19086,Messengers 2: The Scarecrow 2011 Re-release,51501,0,51501,2011.csv,2011,0.0,1.0
19087,Tickling Giants,51499,51499,0,2017.csv,2017,1.0,0.0
19088,Mr. Made,51485,0,51485,2017.csv,2017,0.0,1.0
19089,Ballad 2010 Re-release,51483,0,51483,2010.csv,2010,0.0,1.0
19090,The Metropolitan Opera HD Live: Wagner: Die Walküre,51472,0,51472,2011.csv,2011,0.0,1.0
19091,Do the Right Thing 2019 Re-release,51447,0,51447,2019.csv,2019,0.0,1.0
19092,Black Full Moon,51429,0,51429,2017.csv,2017,0.0,1.0
19093,Russkiy Reyd,51403,0,51403,2020.csv,2020,0.0,1.0
19094,Dark Love,51402,0,51402,2010.csv,2010,0.0,1.0
19095,Léon: The Professional 2020 Re-release,51401,0,51401,2020.csv,2020,0.0,1.0
19096,Versus: The Life and Films of Ken Loach,51339,0,51339,2016.csv,2016,0.0,1.0
19097,The Yes Men Are Revolting,51331,50190,1141,2015.csv,2015,0.9777717168962226,0.022228283103777443
19098,Piyasadan Büyük Alacagimiz Var,51322,0,51322,2015.csv,2015,0.0,1.0
19099,Amor a mares,51297,0,51297,2012.csv,2012,0.0,1.0
19100,Handy - La rivolta delle mani siciliane,51288,0,51288,2017.csv,2017,0.0,1.0
19101,Venus and Serena,51271,51271,0,2013.csv,2013,1.0,0.0
19102,Sevgili Komsum,51260,0,51260,2018.csv,2018,0.0,1.0
19103,Totem,51247,0,51247,2017.csv,2017,0.0,1.0
19104,This American Life Live!,51244,0,51244,2012.csv,2012,0.0,1.0
19105,God Loves Uganda,51229,51229,0,2013.csv,2013,1.0,0.0
19106,Bear Island,51211,0,51211,2014.csv,2014,0.0,1.0
19107,The Gruffalo & Room On The Broom,51202,0,51202,2019.csv,2019,0.0,1.0
19108,Psychopaths,51186,0,51186,2019.csv,2019,0.0,1.0
19109,Miss Fisher & the Crypt of Tears Special Screenings,51158,51032,126,2020.csv,2020,0.9975370421048516,0.002462957895148364
19110,An Invisible Sign,51138,1279,49859,2011.csv,2011,0.02501075521138879,0.9749892447886112
19111,The Border City 2,51136,0,51136,2010.csv,2010,0.0,1.0
19112,Discover Arts: Hitler vs Picasso,51132,0,51132,2018.csv,2018,0.0,1.0
19113,They Wait 2010 Re-release,51129,0,51129,2010.csv,2010,0.0,1.0
19114,Convert Four Cheap,51125,0,51125,2016.csv,2016,0.0,1.0
19115,Zieja,51101,0,51101,2020.csv,2020,0.0,1.0
19116,Los modernos,51088,0,51088,2016.csv,2016,0.0,1.0
19117,Thanga Magan,51079,0,51079,2015.csv,2015,0.0,1.0
19118,Twenty Again,51064,0,51064,2016.csv,2016,0.0,1.0
19119,Goreyan Nu Daffa Karo,51047,0,51047,2014.csv,2014,0.0,1.0
19120,The Unknowns,51035,51035,0,2016.csv,2016,1.0,0.0
19121,Gangor,51032,0,51032,2011.csv,2011,0.0,1.0
19122,Gekijouban Shimajirou no wao!: Shimajirou to ookina ki,51024,0,51024,2015.csv,2015,0.0,1.0
19123,Mad Max: Fury Road 2017 Re-release,51022,0,51022,2017.csv,2017,0.0,1.0
19124,Spitak,51018,0,51018,2018.csv,2018,0.0,1.0
19125,The Butterfly Effect 3: Revelations 2011 Re-release,51017,0,51017,2011.csv,2011,0.0,1.0
19126,The Good Doctor,51017,5206,45811,2012.csv,2012,0.10204441656702667,0.8979555834329733
19127,The Unbelievable 2,50998,0,50998,2012.csv,2012,0.0,1.0
19128,Crazy Arts,50995,0,50995,2017.csv,2017,0.0,1.0
19129,Tour De Force 2014 Re-release,50966,0,50966,2014.csv,2014,0.0,1.0
19130,Thrissur Pooram,50945,0,50945,2020.csv,2020,0.0,1.0
19131,The Scent of Carrots,50937,0,50937,2014.csv,2014,0.0,1.0
19132,Ginger: More Than a Game,50935,0,50935,2012.csv,2012,0.0,1.0
19133,Nothing's All Bad,50924,0,50924,2010.csv,2010,0.0,1.0
19134,You Can't Save Yourself Alone 2016 Re-release,50894,0,50894,2016.csv,2016,0.0,1.0
19135,East Side Sushi,50869,0,50869,2016.csv,2016,0.0,1.0
19136,Captain Masr,50866,0,50866,2015.csv,2015,0.0,1.0
19137,The River Used to Be a Man,50854,0,50854,2012.csv,2012,0.0,1.0
19138,Parking,50853,0,50853,2019.csv,2019,0.0,1.0
19139,Uspekh,50852,0,50852,2019.csv,2019,0.0,1.0
19140,My Zoe,50820,50820,0,2021.csv,2021,1.0,0.0
19141,Blog,50817,0,50817,2011.csv,2011,0.0,1.0
19142,The Last Tundra,50815,0,50815,2011.csv,2011,0.0,1.0
19143,The Dog Who Saved Summer,50806,0,50806,2015.csv,2015,0.0,1.0
19144,Live Virgin 2010 Re-release,50801,0,50801,2010.csv,2010,0.0,1.0
19145,Acoustic,50766,0,50766,2010.csv,2010,0.0,1.0
19146,Soundtrack of Passion,50752,0,50752,2010.csv,2010,0.0,1.0
19147,Ben 10 vs. the Universe: The Movie,50743,0,50743,2020.csv,2020,0.0,1.0
19148,As I Open My Eyes,50721,30989,19732,2016.csv,2016,0.6109698152638946,0.38903018473610534
19149,Ali and Nino,50721,0,50721,2017.csv,2017,0.0,1.0
19150,Dries,50679,0,50679,2017.csv,2017,0.0,1.0
19151,"The Metropolitan Opera HD Live: The Enchanted Island, a Baroque pastiche",50669,0,50669,2012.csv,2012,0.0,1.0
19152,"Wenn du wüsstest, wie schön es hier ist",50604,0,50604,2015.csv,2015,0.0,1.0
19153,Kidan Piece of Darkness,50545,0,50545,2016.csv,2016,0.0,1.0
19154,The Emperor's New Clothes,50539,0,50539,2015.csv,2015,0.0,1.0
19155,Yaman,50538,0,50538,2017.csv,2017,0.0,1.0
19156,Özgür Dünya,50537,0,50537,2019.csv,2019,0.0,1.0
19157,Engaño a primera vista,50530,0,50530,2016.csv,2016,0.0,1.0
19158,Harry Potter and the Sorcerer's Stone 2021 Re-release,50509,0,50509,2021.csv,2021,0.0,1.0
19159,The Rehearsal,50507,0,50507,2016.csv,2016,0.0,1.0
19160,Tu Mera 22 Main Tera 22,50474,0,50474,2013.csv,2013,0.0,1.0
19161,Stratos,50460,0,50460,2014.csv,2014,0.0,1.0
19162,Keep Quiet,50451,50451,0,2017.csv,2017,1.0,0.0
19163,Radiator,50447,0,50447,2015.csv,2015,0.0,1.0
19164,"Saudó, laberinto de almas",50447,0,50447,2016.csv,2016,0.0,1.0
19165,Alien Exorcism,50431,0,50431,2011.csv,2011,0.0,1.0
19166,Beauty,50425,0,50425,2011.csv,2011,0.0,1.0
19167,The Class of '92,50410,0,50410,2013.csv,2013,0.0,1.0
19168,Clinton Road,50400,50400,0,2019.csv,2019,1.0,0.0
19169,Wake in Fright 2012 Re-release,50394,50394,0,2012.csv,2012,1.0,0.0
19170,The Romantic Exiles,50389,0,50389,2015.csv,2015,0.0,1.0
19171,Atomic Ivan,50384,0,50384,2012.csv,2012,0.0,1.0
19172,El Silencio de los Fusiles,50375,0,50375,2017.csv,2017,0.0,1.0
19173,Eternity,50365,0,50365,2010.csv,2010,0.0,1.0
19174,Midnight Traveler,50336,41265,9071,2019.csv,2019,0.8197910044500953,0.18020899554990463
19175,Monster Island 2019 Re-release,50330,0,50330,2019.csv,2019,0.0,1.0
19176,Dzej Dzej,50325,0,50325,2014.csv,2014,0.0,1.0
19177,Seven Acts of Mercy,50323,0,50323,2012.csv,2012,0.0,1.0
19178,Wo de ying zi zai ben pao,50311,0,50311,2018.csv,2018,0.0,1.0
19179,The Fitzgerald Family Christmas,50292,50292,0,2012.csv,2012,1.0,0.0
19180,Buoyancy,50281,0,50281,2019.csv,2019,0.0,1.0
19181,The Royal Wedding: Prince Harry and Meghan Markle,50264,50264,0,2018.csv,2018,1.0,0.0
19182,The Retrieval,50257,50257,0,2014.csv,2014,1.0,0.0
19183,In Order of Disappearance 2016 Re-release,50251,50251,0,2016.csv,2016,1.0,0.0
19184,The Voices 2018 Re-release,50217,0,50217,2018.csv,2018,0.0,1.0
19185,The Opposite Sex,50206,0,50206,2016.csv,2016,0.0,1.0
19186,Slugi wojny,50204,0,50204,2019.csv,2019,0.0,1.0
19187,Willy and the Guardians of the Lake,50197,0,50197,2018.csv,2018,0.0,1.0
19188,Popieluszko. Wolnosc jest w nas 2012 Re-release,50172,0,50172,2012.csv,2012,0.0,1.0
19189,Darkhead,50138,0,50138,2011.csv,2011,0.0,1.0
19190,Ai De Xie Hou,50128,0,50128,2016.csv,2016,0.0,1.0
19191,Days of the Bagnold Summer,50118,0,50118,2021.csv,2021,0.0,1.0
19192,Twilight 2018 Re-release,50081,0,50081,2018.csv,2018,0.0,1.0
19193,Irreplaceable,50065,0,50065,2016.csv,2016,0.0,1.0
19194,A Film with Me in It 2011 Re-release,50051,0,50051,2011.csv,2011,0.0,1.0
19195,Quest,50022,47807,2215,2017.csv,2017,0.955719483427292,0.04428051657270801
19196,The Discoverers,50020,50020,0,2014.csv,2014,1.0,0.0
19197,Letto numero 6,50015,0,50015,2020.csv,2020,0.0,1.0
19198,Crossing Rachmaninoff,49999,0,49999,2015.csv,2015,0.0,1.0
19199,Mangalyam Thanthunanena,49998,0,49998,2018.csv,2018,0.0,1.0
19200,Bigger,49997,46382,3615,2018.csv,2018,0.9276956617397044,0.07230433826029561
19201,Il Postino 2018 Re-release,49988,0,49988,2018.csv,2018,0.0,1.0
19202,Spring,49970,49970,0,2015.csv,2015,1.0,0.0
19203,Baykalskiye kanikuly,49964,0,49964,2016.csv,2016,0.0,1.0
19204,Sex Doll,49957,0,49957,2017.csv,2017,0.0,1.0
19205,Der grosse Kater,49955,0,49955,2010.csv,2010,0.0,1.0
19206,Stardate Revisited: The Origin of Star Trek - The Next Generation,49945,0,49945,2012.csv,2012,0.0,1.0
19207,Daght A'Aly,49939,0,49939,2019.csv,2019,0.0,1.0
19208,Ang Panday,49935,0,49935,2017.csv,2017,0.0,1.0
19209,Home,49934,0,49934,2018.csv,2018,0.0,1.0
19210,Exhibition on Screen: Rembrandt,49931,0,49931,2014.csv,2014,0.0,1.0
19211,In viaggio con Adele,49924,0,49924,2018.csv,2018,0.0,1.0
19212,Joy of Second Child,49906,0,49906,2016.csv,2016,0.0,1.0
19213,Al Abyad Yewfet Amel,49896,0,49896,2016.csv,2016,0.0,1.0
19214,Battle Mountain: Graeme Obree's Story,49853,0,49853,2016.csv,2016,0.0,1.0
19215,Shadow of the Star,49831,0,49831,2020.csv,2020,0.0,1.0
19216,Battle for Sevastopol 2016 Re-release,49828,0,49828,2016.csv,2016,0.0,1.0
19217,Inside: A Chinese Horror Story,49822,0,49822,2017.csv,2017,0.0,1.0
19218,School Is Over,49802,0,49802,2010.csv,2010,0.0,1.0
19219,Marid,49773,0,49773,2019.csv,2019,0.0,1.0
19220,Bock for President,49771,0,49771,2010.csv,2010,0.0,1.0
19221,The Bobot,49756,0,49756,2018.csv,2018,0.0,1.0
19222,Banned Zone,49731,0,49731,2020.csv,2020,0.0,1.0
19223,Sinivalkoinen valhe,49727,0,49727,2012.csv,2012,0.0,1.0
19224,Marona's Fantastic Tale,49714,0,49714,2019.csv,2019,0.0,1.0
19225,Free Trip to Egypt,49693,49693,0,2019.csv,2019,1.0,0.0
19226,Curse of the Witch's Doll,49691,0,49691,2018.csv,2018,0.0,1.0
19227,Henchmen 2020 Re-release,49676,49676,0,2020.csv,2020,1.0,0.0
19228,Burning Ghost,49674,0,49674,2019.csv,2019,0.0,1.0
19229,Clair Obscur,49667,0,49667,2016.csv,2016,0.0,1.0
19230,Eksik,49621,0,49621,2015.csv,2015,0.0,1.0
19231,Adieu Paris,49593,0,49593,2013.csv,2013,0.0,1.0
19232,NOW: In the Wings on a World Stage,49591,49591,0,2014.csv,2014,1.0,0.0
19233,The Gift of Love,49590,0,49590,2019.csv,2019,0.0,1.0
19234,The Messengers 2010 Re-release,49553,0,49553,2010.csv,2010,0.0,1.0
19235,Queen Live in Bohemia,49540,0,49540,2016.csv,2016,0.0,1.0
19236,Sextape,49524,0,49524,2018.csv,2018,0.0,1.0
19237,Red Herring,49480,49480,0,2015.csv,2015,1.0,0.0
19238,Interrail,49478,0,49478,2018.csv,2018,0.0,1.0
19239,Hoffenheim - Das Leben ist kein Heimspiel,49476,0,49476,2011.csv,2011,0.0,1.0
19240,Captive 2015 Re-release,49450,0,49450,2015.csv,2015,0.0,1.0
19241,Lee & Cindy C.,49446,0,49446,2015.csv,2015,0.0,1.0
19242,Make Us Dream,49432,0,49432,2018.csv,2018,0.0,1.0
19243,Tula: The Revolt,49429,0,49429,2013.csv,2013,0.0,1.0
19244,Impressionisti segreti,49428,0,49428,2020.csv,2020,0.0,1.0
19245,GasLand,49428,30846,18582,2010.csv,2010,0.6240592376790484,0.3759407623209517
19246,My Perfect You,49382,0,49382,2018.csv,2018,0.0,1.0
19247,Jumanji/Jumanji: Welcome to the Jungle 2018 NCM Fathom Event,49381,49381,0,2018.csv,2018,1.0,0.0
19248,Secrets of State 2011 Re-release,49367,0,49367,2011.csv,2011,0.0,1.0
19249,The Invisible Woman 2018 Re-release,49336,0,49336,2018.csv,2018,0.0,1.0
19250,Love Actually... Sucks!,49314,0,49314,2012.csv,2012,0.0,1.0
19251,Cidade Cinza,49303,0,49303,2013.csv,2013,0.0,1.0
19252,Chain of Command,49286,0,49286,2016.csv,2016,0.0,1.0
19253,Shirin in Love,49254,49254,0,2014.csv,2014,1.0,0.0
19254,My Father's Wings,49241,0,49241,2016.csv,2016,0.0,1.0
19255,Fantasy Dream Trip,49227,0,49227,2018.csv,2018,0.0,1.0
19256,Call of the Undead,49219,0,49219,2013.csv,2013,0.0,1.0
19257,Heart of the Desert,49204,0,49204,2016.csv,2016,0.0,1.0
19258,Lucky and Zorba 2019 Re-release,49202,0,49202,2019.csv,2019,0.0,1.0
19259,Haunted Room: Who R U,49198,0,49198,2011.csv,2011,0.0,1.0
19260,Al Hafla,49197,0,49197,2013.csv,2013,0.0,1.0
19261,British Museum presents: Hokusai,49161,0,49161,2017.csv,2017,0.0,1.0
19262,A Minute More,49156,0,49156,2014.csv,2014,0.0,1.0
19263,Bonsai,49128,21267,27861,2012.csv,2012,0.4328895945285784,0.5671104054714216
19264,Disturbing the Peace,49104,0,49104,2020.csv,2020,0.0,1.0
19265,Sinbad: The Flying Princess and the Secret Island Part 1,49099,0,49099,2016.csv,2016,0.0,1.0
19266,Índice Médio de Felicidade,49072,0,49072,2017.csv,2017,0.0,1.0
19267,Hal,49045,48698,347,2018.csv,2018,0.9929248649199715,0.007075135080028545
19268,Vengeance is mine,49042,0,49042,2019.csv,2019,0.0,1.0
19269,Poeslief,49033,0,49033,2020.csv,2020,0.0,1.0
19270,The Way I See It,49030,49030,0,2020.csv,2020,1.0,0.0
19271,Torpedo,49028,0,49028,2012.csv,2012,0.0,1.0
19272,Sexual Chronicles of a French Family,49016,0,49016,2012.csv,2012,0.0,1.0
19273,Orgasm Inc.,49001,49001,0,2011.csv,2011,1.0,0.0
19274,Lucky Them,48995,48995,0,2014.csv,2014,1.0,0.0
19275,Open Road,48985,0,48985,2013.csv,2013,0.0,1.0
19276,Isac Elliot Dream Big: The Movie,48967,0,48967,2014.csv,2014,0.0,1.0
19277,#Jowable,48965,0,48965,2019.csv,2019,0.0,1.0
19278,Trick,48953,0,48953,2020.csv,2020,0.0,1.0
19279,Romantic Guide to Lost Places,48951,0,48951,2020.csv,2020,0.0,1.0
19280,Effetto Domino,48932,0,48932,2019.csv,2019,0.0,1.0
19281,The Transcend,48918,0,48918,2014.csv,2014,0.0,1.0
19282,The Internet's Own Boy: The Story of Aaron Swartz,48911,48911,0,2014.csv,2014,1.0,0.0
19283,The Pearl Pagoda,48900,0,48900,2016.csv,2016,0.0,1.0
19284,Assassins,48896,0,48896,2020.csv,2020,0.0,1.0
19285,Bergman: A Year in the Life,48884,0,48884,2018.csv,2018,0.0,1.0
19286,Snow White: Happily Ever After,48870,0,48870,2017.csv,2017,0.0,1.0
19287,Gora Samotsvetov-6,48869,0,48869,2011.csv,2011,0.0,1.0
19288,The Seven Five,48869,48869,0,2015.csv,2015,1.0,0.0
19289,Yozgat Blues,48867,0,48867,2013.csv,2013,0.0,1.0
19290,Kung Fu Dunk 2010 Re-release,48839,0,48839,2010.csv,2010,0.0,1.0
19291,Unknown Title,48822,0,48822,2016.csv,2016,0.0,1.0
19292,Dancing Ninja,48818,0,48818,2012.csv,2012,0.0,1.0
19293,The Bounty Killer,48815,48815,0,2019.csv,2019,1.0,0.0
19294,Dennis & Gnasher: Unleashed! On the Big Screen,48790,0,48790,2020.csv,2020,0.0,1.0
19295,"National Theatre Live: One Man, Two Guvnors 2012 Re-release",48789,0,48789,2012.csv,2012,0.0,1.0
19296,The Citizen,48767,24296,24471,2013.csv,2013,0.49820575389095084,0.5017942461090491
19297,A Birder's Guide to Everything,48713,48713,0,2014.csv,2014,1.0,0.0
19298,ABCD: American-Born Confused Desi,48711,0,48711,2013.csv,2013,0.0,1.0
19299,Homestay,48701,0,48701,2020.csv,2020,0.0,1.0
19300,American Mustang,48700,48700,0,2014.csv,2014,1.0,0.0
19301,The Shock Doctrine 2011 Re-release,48686,0,48686,2011.csv,2011,0.0,1.0
19302,Tales from Earthsea 2010 Re-release,48658,48658,0,2010.csv,2010,1.0,0.0
19303,The Color of the Chameleon,48652,0,48652,2013.csv,2013,0.0,1.0
19304,Four Minutes 2010 Re-release,48651,0,48651,2010.csv,2010,0.0,1.0
19305,The China Hustle,48650,48650,0,2018.csv,2018,1.0,0.0
19306,Eloise 2012 Re-release,48572,0,48572,2012.csv,2012,0.0,1.0
19307,Apocalypse,48569,0,48569,2015.csv,2015,0.0,1.0
19308,A Family,48559,0,48559,2017.csv,2017,0.0,1.0
19309,Schatzritter,48556,0,48556,2012.csv,2012,0.0,1.0
19310,That Time of Year,48537,0,48537,2018.csv,2018,0.0,1.0
19311,Faces in the Crowd 2014 Re-release,48510,0,48510,2014.csv,2014,0.0,1.0
19312,Arthur & Merlin: Knights of Camelot,48504,0,48504,2020.csv,2020,0.0,1.0
19313,The Last Supper,48502,0,48502,2013.csv,2013,0.0,1.0
19314,Person to Person,48499,48499,0,2017.csv,2017,1.0,0.0
19315,Dominguinhos,48499,0,48499,2014.csv,2014,0.0,1.0
19316,Jorge Mautner: O Filho do Holocausto,48497,0,48497,2013.csv,2013,0.0,1.0
19317,Cautivadas,48491,0,48491,2013.csv,2013,0.0,1.0
19318,La Huerta,48451,0,48451,2013.csv,2013,0.0,1.0
19319,Viral,48449,0,48449,2013.csv,2013,0.0,1.0
19320,The Hard Stop,48441,0,48441,2016.csv,2016,0.0,1.0
19321,Alleluia,48426,6334,42092,2014.csv,2014,0.13079750547226696,0.869202494527733
19322,Boogie Woogie,48411,2618,45793,2010.csv,2010,0.05407861849579641,0.9459213815042036
19323,Kill My Brother,48389,0,48389,2019.csv,2019,0.0,1.0
19324,"Lebanon, Pa.",48381,48381,0,2011.csv,2011,1.0,0.0
19325,Malesh Ehna Benetbahdel 2015 Re-release,48365,0,48365,2015.csv,2015,0.0,1.0
19326,Everlasting Moments 2010 Re-release,48354,0,48354,2010.csv,2010,0.0,1.0
19327,Elisa K,48340,0,48340,2010.csv,2010,0.0,1.0
19328,Vertigo 2013 Re-release,48319,0,48319,2013.csv,2013,0.0,1.0
19329,You're Ugly Too,48286,0,48286,2015.csv,2015,0.0,1.0
19330,Reel Rock 15,48272,0,48272,2021.csv,2021,0.0,1.0
19331,They Call Me Babu,48253,0,48253,2019.csv,2019,0.0,1.0
19332,Airaa,48234,0,48234,2019.csv,2019,0.0,1.0
19333,Paris 05:59: Théo & Hugo,48227,0,48227,2016.csv,2016,0.0,1.0
19334,Mes frères,48208,0,48208,2018.csv,2018,0.0,1.0
19335,Ceremony,48174,22270,25904,2011.csv,2011,0.4622825590567526,0.5377174409432474
19336,Five Years,48166,0,48166,2013.csv,2013,0.0,1.0
19337,Vita segreta di Maria Capasso,48156,0,48156,2019.csv,2019,0.0,1.0
19338,The Enemy Within,48152,0,48152,2013.csv,2013,0.0,1.0
19339,Pal Pal Dil Ke Paas,48147,0,48147,2019.csv,2019,0.0,1.0
19340,Last Call,48144,48144,0,2021.csv,2021,1.0,0.0
19341,Romeo and Juliet: Beyond Words,48125,0,48125,2019.csv,2019,0.0,1.0
19342,Ayanda,48118,0,48118,2015.csv,2015,0.0,1.0
19343,The Movie Drive Head Tomica Hyper Rescue,48114,0,48114,2018.csv,2018,0.0,1.0
19344,The Forbidden Room,48082,34404,13678,2015.csv,2015,0.7155276402811863,0.2844723597188137
19345,Walking to School,48082,0,48082,2016.csv,2016,0.0,1.0
19346,Life Happens,48041,30905,17136,2012.csv,2012,0.6433046772548449,0.3566953227451552
19347,A Cop,48040,48040,0,2013.csv,2013,1.0,0.0
19348,Trinta,48031,0,48031,2014.csv,2014,0.0,1.0
19349,Les hommes à lunettes,48015,0,48015,2012.csv,2012,0.0,1.0
19350,Wandering Streams,47968,0,47968,2010.csv,2010,0.0,1.0
19351,Toofan Singh,47967,0,47967,2017.csv,2017,0.0,1.0
19352,Saving Banksy,47965,47965,0,2017.csv,2017,1.0,0.0
19353,Skandal. Ewenement Molesty,47860,0,47860,2020.csv,2020,0.0,1.0
19354,Selfie 2019 Re-release,47859,0,47859,2019.csv,2019,0.0,1.0
19355,After the Waterfall,47856,0,47856,2010.csv,2010,0.0,1.0
19356,O Ano da Morte de Ricardo Reis,47841,0,47841,2020.csv,2020,0.0,1.0
19357,Intimacies,47829,0,47829,2014.csv,2014,0.0,1.0
19358,Souq Al Jumma,47827,0,47827,2018.csv,2018,0.0,1.0
19359,The Queen,47818,47818,0,2019.csv,2019,1.0,0.0
19360,The Late Night Ride,47803,0,47803,2020.csv,2020,0.0,1.0
19361,The Match 2017 Re-release,47794,0,47794,2017.csv,2017,0.0,1.0
19362,Cafe Noir,47784,0,47784,2010.csv,2010,0.0,1.0
19363,Invader 2014 Re-release,47774,0,47774,2014.csv,2014,0.0,1.0
19364,De Matthäus missie van Reinbert de Leeuw,47771,0,47771,2016.csv,2016,0.0,1.0
19365,iSmart Shankar,47747,0,47747,2019.csv,2019,0.0,1.0
19366,Urge,47740,0,47740,2016.csv,2016,0.0,1.0
19367,Gunned Down,47737,0,47737,2017.csv,2017,0.0,1.0
19368,Eu Não Faço a Menor Ideia do Que Eu Tô Fazendo Com a Minha Vida,47717,0,47717,2013.csv,2013,0.0,1.0
19369,Alphaville,47696,47696,0,2014.csv,2014,1.0,0.0
19370,Christine Cristina,47684,0,47684,2010.csv,2010,0.0,1.0
19371,Hideaways,47654,0,47654,2011.csv,2011,0.0,1.0
19372,Rounds,47652,0,47652,2019.csv,2019,0.0,1.0
19373,Night of Silence,47651,0,47651,2012.csv,2012,0.0,1.0
19374,So B. It,47627,47627,0,2017.csv,2017,1.0,0.0
19375,GMO OMG,47558,47558,0,2013.csv,2013,1.0,0.0
19376,Travel! Frog in the Shallow Well,47546,0,47546,2018.csv,2018,0.0,1.0
19377,Karimi Gördünüz Mü?,47529,0,47529,2018.csv,2018,0.0,1.0
19378,350 Days - Legends. Champions. Survivors,47526,47526,0,2018.csv,2018,1.0,0.0
19379,El man del porno,47513,0,47513,2018.csv,2018,0.0,1.0
19380,Öyle ya da Böyle,47501,0,47501,2015.csv,2015,0.0,1.0
19381,Wahed Saheh,47469,0,47469,2012.csv,2012,0.0,1.0
19382,Superstar,47448,0,47448,2019.csv,2019,0.0,1.0
19383,Entre les Bras,47439,47439,0,2012.csv,2012,1.0,0.0
19384,Border Politics,47417,0,47417,2018.csv,2018,0.0,1.0
19385,Looking for Eimish,47387,0,47387,2012.csv,2012,0.0,1.0
19386,Awe!,47386,0,47386,2018.csv,2018,0.0,1.0
19387,I Believe,47375,0,47375,2019.csv,2019,0.0,1.0
19388,Girl With a Scythe,47374,0,47374,2017.csv,2017,0.0,1.0
19389,Penumbra,47371,0,47371,2012.csv,2012,0.0,1.0
19390,Beyond the Clouds,47368,0,47368,2018.csv,2018,0.0,1.0
19391,The Forgotten Bag,47354,0,47354,2010.csv,2010,0.0,1.0
19392,Cheating Thieves,47325,0,47325,2010.csv,2010,0.0,1.0
19393,The Bra,47306,8314,38992,2019.csv,2019,0.1757493764004566,0.8242506235995434
19394,Alabama Moon,47305,47305,0,2011.csv,2011,1.0,0.0
19395,A Sort of Family,47292,0,47292,2017.csv,2017,0.0,1.0
19396,Wild Goose Lodge,47288,0,47288,2016.csv,2016,0.0,1.0
19397,Daughters of the Dust 2016 Re-release,47287,40986,6301,2016.csv,2016,0.8667498466809059,0.13325015331909404
19398,The Raft,47269,39678,7591,2019.csv,2019,0.8394084918233937,0.16059150817660622
19399,Every Man for Himself,47262,47262,0,2010.csv,2010,1.0,0.0
19400,The Metropolitan Opera HD Live: Thomas: Hamlet,47246,0,47246,2010.csv,2010,0.0,1.0
19401,Paisa Vasool,47245,0,47245,2017.csv,2017,0.0,1.0
19402,Olaylar Olaylar,47240,0,47240,2016.csv,2016,0.0,1.0
19403,Let There Be Light,47231,0,47231,2019.csv,2019,0.0,1.0
19404,Went the Day Well?,47214,47214,0,2011.csv,2011,1.0,0.0
19405,The Metropolitan Opera HD Live: Puccini: Tosca,47210,0,47210,2013.csv,2013,0.0,1.0
19406,Prebujanja,47207,0,47207,2017.csv,2017,0.0,1.0
19407,Il Trovatore,47203,0,47203,2011.csv,2011,0.0,1.0
19408,P.O.V,47199,0,47199,2012.csv,2012,0.0,1.0
19409,House of the Witch,47188,0,47188,2018.csv,2018,0.0,1.0
19410,Crossing Boundaries,47188,0,47188,2012.csv,2012,0.0,1.0
19411,Cenaze Isleri,47171,0,47171,2017.csv,2017,0.0,1.0
19412,Gwen,47140,0,47140,2019.csv,2019,0.0,1.0
19413,Jism 2,47109,0,47109,2012.csv,2012,0.0,1.0
19414,Le char et l'olivier - Une autre histoire de la Palestine,47101,0,47101,2019.csv,2019,0.0,1.0
19415,Ella Fitzgerald: Just One of Those Things,47091,0,47091,2019.csv,2019,0.0,1.0
19416,St. Giuseppe Moscati: Doctor to the Poor,47048,0,47048,2013.csv,2013,0.0,1.0
19417,The Metropolitan Opera HD Live: R. Strauss: Capriccio,47038,0,47038,2011.csv,2011,0.0,1.0
19418,VHYes,47037,47037,0,2020.csv,2020,1.0,0.0
19419,The Drone,47035,0,47035,2019.csv,2019,0.0,1.0
19420,Diary of a Country Priest,47000,47000,0,2011.csv,2011,1.0,0.0
19421,Suggs: My Life Story,46999,0,46999,2018.csv,2018,0.0,1.0
19422,The Metropolitan Opera HD Live: Donizetti: Anna Bolena,46999,0,46999,2011.csv,2011,0.0,1.0
19423,Ruben Blades Is Not My Name,46890,0,46890,2018.csv,2018,0.0,1.0
19424,Half of Oscar,46878,0,46878,2011.csv,2011,0.0,1.0
19425,A Master Builder,46874,46874,0,2014.csv,2014,1.0,0.0
19426,U Turn,46861,0,46861,2018.csv,2018,0.0,1.0
19427,Enter the Fat Dragon,46855,46855,0,2020.csv,2020,1.0,0.0
19428,Ascent,46850,0,46850,2017.csv,2017,0.0,1.0
19429,78/52: Hitchcock's Shower Scene,46838,37664,9174,2017.csv,2017,0.8041333959605449,0.19586660403945513
19430,Persecuted,46834,0,46834,2019.csv,2019,0.0,1.0
19431,Gassal,46809,0,46809,2015.csv,2015,0.0,1.0
19432,Please Remember Me,46805,0,46805,2017.csv,2017,0.0,1.0
19433,"Connected: An Autoblogography About Love, Death & Technology",46782,46782,0,2011.csv,2011,1.0,0.0
19434,Joel,46780,0,46780,2018.csv,2018,0.0,1.0
19435,A Luz do Tom,46773,0,46773,2013.csv,2013,0.0,1.0
19436,The Edge,46763,0,46763,2019.csv,2019,0.0,1.0
19437,Unlucky Plaza,46732,0,46732,2015.csv,2015,0.0,1.0
19438,Come Along,46664,0,46664,2016.csv,2016,0.0,1.0
19439,The Good Old Days,46662,0,46662,2018.csv,2018,0.0,1.0
19440,The Woodmans,46623,46623,0,2011.csv,2011,1.0,0.0
19441,The Pack,46610,0,46610,2020.csv,2020,0.0,1.0
19442,Bekiya,46609,0,46609,2018.csv,2018,0.0,1.0
19443,Hey Duggee At The Movies,46577,0,46577,2020.csv,2020,0.0,1.0
19444,VMayakovskiy,46521,0,46521,2019.csv,2019,0.0,1.0
19445,Mom and Other Loonies in the Family,46507,0,46507,2015.csv,2015,0.0,1.0
19446,Ca$h,46488,46488,0,2010.csv,2010,1.0,0.0
19447,My Santa,46485,0,46485,2019.csv,2019,0.0,1.0
19448,Death in Sarajevo,46475,0,46475,2016.csv,2016,0.0,1.0
19449,The Longest Week,46460,0,46460,2014.csv,2014,0.0,1.0
19450,Thattum Purath Achuthan,46438,0,46438,2019.csv,2019,0.0,1.0
19451,Our Time,46433,14777,31656,2019.csv,2019,0.31824349062089463,0.6817565093791054
19452,Flower Buds,46428,0,46428,2011.csv,2011,0.0,1.0
19453,Shanghai 2015 Re-release,46425,46425,0,2015.csv,2015,1.0,0.0
19454,Patience,46410,15941,30469,2012.csv,2012,0.34348200818789054,0.6565179918121095
19455,Jackpot,46403,0,46403,2019.csv,2019,0.0,1.0
19456,Maria and I,46394,0,46394,2010.csv,2010,0.0,1.0
19457,Mediterranea,46392,22076,24316,2015.csv,2015,0.4758579065356096,0.5241420934643904
19458,¿Dónde se nacionaliza la marea?,46388,0,46388,2010.csv,2010,0.0,1.0
19459,William S. Burroughs: A Man Within,46380,46380,0,2010.csv,2010,1.0,0.0
19460,The Red Shield Pioneer,46380,0,46380,2018.csv,2018,0.0,1.0
19461,Timer,46378,0,46378,2011.csv,2011,0.0,1.0
19462,Sunny,46376,0,46376,2018.csv,2018,0.0,1.0
19463,Domino Effect,46357,0,46357,2017.csv,2017,0.0,1.0
19464,A Planet in the Sea,46355,0,46355,2019.csv,2019,0.0,1.0
19465,Mama Illegal,46324,0,46324,2012.csv,2012,0.0,1.0
19466,Macondo,46300,0,46300,2014.csv,2014,0.0,1.0
19467,Tijuana Bible,46296,0,46296,2020.csv,2020,0.0,1.0
19468,I Skyggen Av Oljeeventyret,46294,0,46294,2017.csv,2017,0.0,1.0
19469,Hayde bre,46266,0,46266,2010.csv,2010,0.0,1.0
19470,Peruchazhi,46265,0,46265,2014.csv,2014,0.0,1.0
19471,Minions 2020 Re-release,46265,0,46265,2020.csv,2020,0.0,1.0
19472,Molecole,46252,0,46252,2020.csv,2020,0.0,1.0
19473,The Great Maiden's Blush,46213,0,46213,2016.csv,2016,0.0,1.0
19474,R.I.P.,46209,0,46209,2018.csv,2018,0.0,1.0
19475,Kizim ve Ben,46202,0,46202,2018.csv,2018,0.0,1.0
19476,Good Vibrations 2014 Re-release,46194,0,46194,2014.csv,2014,0.0,1.0
19477,Heartbeats,46180,0,46180,2017.csv,2017,0.0,1.0
19478,El jugador,46149,0,46149,2016.csv,2016,0.0,1.0
19479,"Pop, Lock 'n Roll",46147,0,46147,2017.csv,2017,0.0,1.0
19480,Greedy Lying Bastards,46121,45000,1121,2012.csv,2012,0.9756943691593851,0.024305630840614906
19481,Ballplayer: Pelotero,46109,46109,0,2012.csv,2012,1.0,0.0
19482,Brown Boys,46090,0,46090,2019.csv,2019,0.0,1.0
19483,Charlie,46083,0,46083,2016.csv,2016,0.0,1.0
19484,Deniz ve Günes,46081,0,46081,2018.csv,2018,0.0,1.0
19485,Dispossession: The Great Social Housing Swindle,46072,0,46072,2017.csv,2017,0.0,1.0
19486,Hero Hitler in Love,46064,0,46064,2011.csv,2011,0.0,1.0
19487,Panique,46041,46041,0,2017.csv,2017,1.0,0.0
19488,Easy Ball,46037,0,46037,2016.csv,2016,0.0,1.0
19489,Maledetto Modigliani,46035,0,46035,2021.csv,2021,0.0,1.0
19490,Every Day,46029,46029,0,2011.csv,2011,1.0,0.0
19491,The Recce,46024,0,46024,2018.csv,2018,0.0,1.0
19492,High Performance,45998,0,45998,2014.csv,2014,0.0,1.0
19493,You'll Never Walk Alone,45997,0,45997,2018.csv,2018,0.0,1.0
19494,70 80 90: A Shenzhen Love Story,45996,0,45996,2016.csv,2016,0.0,1.0
19495,Animals,45980,0,45980,2011.csv,2011,0.0,1.0
19496,Monk with a Camera,45938,45938,0,2014.csv,2014,1.0,0.0
19497,The Shamer's Daughter 2: The Serpent Gift,45937,0,45937,2019.csv,2019,0.0,1.0
19498,Stag Night,45927,0,45927,2010.csv,2010,0.0,1.0
19499,Maurice 2017 Re-release,45926,45926,0,2017.csv,2017,1.0,0.0
19500,Super Hero Taisen GP: Kamen Rider 3,45911,0,45911,2015.csv,2015,0.0,1.0
19501,Hawaa Hawaai,45911,0,45911,2014.csv,2014,0.0,1.0
19502,Desi Romeos,45909,0,45909,2012.csv,2012,0.0,1.0
19503,Raving riot,45899,0,45899,2019.csv,2019,0.0,1.0
19504,Tai ji 1: Cong ling kai shi 2014 Re-release,45855,0,45855,2014.csv,2014,0.0,1.0
19505,Haimen Depths,45804,0,45804,2019.csv,2019,0.0,1.0
19506,Downrange,45780,0,45780,2018.csv,2018,0.0,1.0
19507,Crossing the Border - Zhaoguan,45773,0,45773,2019.csv,2019,0.0,1.0
19508,Alien Outpost,45769,0,45769,2015.csv,2015,0.0,1.0
19509,3 Mile Limit,45729,0,45729,2014.csv,2014,0.0,1.0
19510,Captive 2012 Re-release,45721,0,45721,2012.csv,2012,0.0,1.0
19511,Smejdi,45719,0,45719,2013.csv,2013,0.0,1.0
19512,The House of Branching Love 2011 Re-release,45709,0,45709,2011.csv,2011,0.0,1.0
19513,The Secret Spitfires,45696,0,45696,2017.csv,2017,0.0,1.0
19514,High on the Hog,45696,45696,0,2019.csv,2019,1.0,0.0
19515,Summerland,45629,0,45629,2010.csv,2010,0.0,1.0
19516,Bel-Ghalat,45623,0,45623,2018.csv,2018,0.0,1.0
19517,Valeria descalza,45615,0,45615,2011.csv,2011,0.0,1.0
19518,Eddie: The Sleepwalking Cannibal,45604,1632,43972,2012.csv,2012,0.035786334532058595,0.9642136654679414
19519,El rei borni,45572,0,45572,2016.csv,2016,0.0,1.0
19520,Extremos,45567,0,45567,2010.csv,2010,0.0,1.0
19521,Russian Jews: Film 1918-1948,45545,0,45545,2017.csv,2017,0.0,1.0
19522,3 Weeks in Yerevan,45536,45536,0,2016.csv,2016,1.0,0.0
19523,An Eye for Beauty,45513,9395,36118,2015.csv,2015,0.20642453804407532,0.7935754619559247
19524,Let It Be Law,45502,0,45502,2019.csv,2019,0.0,1.0
19525,Dhilluku Dhuddu 2,45502,0,45502,2019.csv,2019,0.0,1.0
19526,Nosferatu. Uzhas nochi,45482,0,45482,2010.csv,2010,0.0,1.0
19527,Pommes essen,45456,0,45456,2012.csv,2012,0.0,1.0
19528,Kiki's Delivery Service 2018 Re-release,45446,0,45446,2018.csv,2018,0.0,1.0
19529,Mercury,45429,0,45429,2018.csv,2018,0.0,1.0
19530,The Leunig Fragments,45425,0,45425,2020.csv,2020,0.0,1.0
19531,Zduhac Means Adventure,45424,0,45424,2011.csv,2011,0.0,1.0
19532,Kuntilanak 2,45422,0,45422,2019.csv,2019,0.0,1.0
19533,Paradise,45417,0,45417,2020.csv,2020,0.0,1.0
19534,El Caso Watson,45414,0,45414,2017.csv,2017,0.0,1.0
19535,Skinwalkers,45405,0,45405,2014.csv,2014,0.0,1.0
19536,Return to the Hiding Place,45405,45405,0,2014.csv,2014,1.0,0.0
19537,What Just Happened 2011 Re-release,45402,0,45402,2011.csv,2011,0.0,1.0
19538,Matrimonio,45374,0,45374,2013.csv,2013,0.0,1.0
19539,Müsaadenizle Büyükler,45371,0,45371,2018.csv,2018,0.0,1.0
19540,Hatched: Chicks Gone Wild,45344,0,45344,2015.csv,2015,0.0,1.0
19541,Lost Birds,45317,0,45317,2016.csv,2016,0.0,1.0
19542,Something Useful,45304,0,45304,2017.csv,2017,0.0,1.0
19543,Farewell Paradise,45289,0,45289,2020.csv,2020,0.0,1.0
19544,Swimming Pool,45287,0,45287,2011.csv,2011,0.0,1.0
19545,No Rest for the Wicked 2012 Re-release,45280,0,45280,2012.csv,2012,0.0,1.0
19546,Pokémon: The Legend of XYZ!,45274,0,45274,2016.csv,2016,0.0,1.0
19547,Ai Weiwei: The Fake Case,45255,45255,0,2014.csv,2014,1.0,0.0
19548,Horn of Plenty 2010 Re-release,45255,0,45255,2010.csv,2010,0.0,1.0
19549,There's No Place Like Utopia,45254,45254,0,2014.csv,2014,1.0,0.0
19550,Faces in the Crowd,45249,0,45249,2011.csv,2011,0.0,1.0
19551,Las aventuras de Don Quijote,45236,0,45236,2010.csv,2010,0.0,1.0
19552,My Favorite Fabric,45223,0,45223,2018.csv,2018,0.0,1.0
19553,MLK/FBI,45200,45200,0,2021.csv,2021,1.0,0.0
19554,CornerStore,45176,45176,0,2011.csv,2011,1.0,0.0
19555,American Made Movie,45175,45175,0,2013.csv,2013,1.0,0.0
19556,Dil Bechara,45171,0,45171,2020.csv,2020,0.0,1.0
19557,A Flat for Three 2013 Re-release,45166,0,45166,2013.csv,2013,0.0,1.0
19558,Kodiveeran,45150,0,45150,2017.csv,2017,0.0,1.0
19559,The Proposal,45149,45149,0,2019.csv,2019,1.0,0.0
19560,The Girl with the Red Scarf,45123,0,45123,2010.csv,2010,0.0,1.0
19561,St George's Day,45075,0,45075,2012.csv,2012,0.0,1.0
19562,Tutto quello che vuoi 2018 Re-release,45011,0,45011,2018.csv,2018,0.0,1.0
19563,Curitiba Zero Grau,44986,0,44986,2012.csv,2012,0.0,1.0
19564,Goodachari,44969,0,44969,2018.csv,2018,0.0,1.0
19565,Op stap met Dirk Scheele de Film,44922,0,44922,2018.csv,2018,0.0,1.0
19566,The Farthest,44921,14773,30148,2017.csv,2017,0.32886623182921126,0.6711337681707887
19567,Remainder,44898,0,44898,2016.csv,2016,0.0,1.0
19568,Celebration,44898,22557,22341,2019.csv,2019,0.5024054523586797,0.49759454764132033
19569,Hamlat Feraizar,44886,0,44886,2016.csv,2016,0.0,1.0
19570,The Pruitt-Igoe Myth,44883,44883,0,2012.csv,2012,1.0,0.0
19571,Lucha: Playing the Impossible,44872,0,44872,2016.csv,2016,0.0,1.0
19572,River of Fundament,44840,44840,0,2015.csv,2015,1.0,0.0
19573,Union Square,44830,44830,0,2012.csv,2012,1.0,0.0
19574,Ebka Kabelny,44822,0,44822,2010.csv,2010,0.0,1.0
19575,Teraz i w godzine smierci,44815,0,44815,2017.csv,2017,0.0,1.0
19576,Pretty Woman 2020 Re-release,44796,0,44796,2020.csv,2020,0.0,1.0
19577,"Jung Il-woo, My Friend",44788,0,44788,2017.csv,2017,0.0,1.0
19578,Aramm,44787,0,44787,2017.csv,2017,0.0,1.0
19579,A Distant Place 2021 Re-release,44768,0,44768,2021.csv,2021,0.0,1.0
19580,Love Story,44755,0,44755,2019.csv,2019,0.0,1.0
19581,Lao Wedding,44753,0,44753,2011.csv,2011,0.0,1.0
19582,Flacas Vacas,44719,0,44719,2012.csv,2012,0.0,1.0
19583,Iris: A Space Opera by Justice,44702,0,44702,2019.csv,2019,0.0,1.0
19584,Van der Merwe,44697,0,44697,2017.csv,2017,0.0,1.0
19585,Blood Money,44695,0,44695,2010.csv,2010,0.0,1.0
19586,"0,03 Seconde",44683,0,44683,2017.csv,2017,0.0,1.0
19587,A Man and a Woman 2020 Re-release,44666,0,44666,2020.csv,2020,0.0,1.0
19588,That Summer,44659,34556,10103,2018.csv,2018,0.7737746031035178,0.22622539689648224
19589,Odödliga,44608,0,44608,2015.csv,2015,0.0,1.0
19590,Copposites,44596,0,44596,2012.csv,2012,0.0,1.0
19591,The Dog,44581,44581,0,2014.csv,2014,1.0,0.0
19592,The Bride Wore Black,44566,44566,0,2011.csv,2011,1.0,0.0
19593,Rincón de Darwin,44555,0,44555,2013.csv,2013,0.0,1.0
19594,Amor em Sampa,44555,0,44555,2016.csv,2016,0.0,1.0
19595,Concrete Night,44551,0,44551,2013.csv,2013,0.0,1.0
19596,What Is Democracy?,44536,44536,0,2019.csv,2019,1.0,0.0
19597,Double Date,44511,0,44511,2017.csv,2017,0.0,1.0
19598,"Léon Morin, Priest 2017 Re-release",44511,44511,0,2017.csv,2017,1.0,0.0
19599,Unnatural History,44485,0,44485,2015.csv,2015,0.0,1.0
19600,The Sacrifice 2019 Re-release,44466,0,44466,2019.csv,2019,0.0,1.0
19601,Defendor,44462,44462,0,2010.csv,2010,1.0,0.0
19602,Hot Tub Time Machine 2013 Re-release,44461,0,44461,2013.csv,2013,0.0,1.0
19603,Spud 2012 Re-release,44455,0,44455,2012.csv,2012,0.0,1.0
19604,Sashimi,44434,0,44434,2015.csv,2015,0.0,1.0
19605,Intimate Stories 2012 Re-release,44407,0,44407,2012.csv,2012,0.0,1.0
19606,Maze 2019 Re-release,44381,44381,0,2019.csv,2019,1.0,0.0
19607,Gondolj rám,44379,0,44379,2016.csv,2016,0.0,1.0
19608,Wild Tango,44376,0,44376,2014.csv,2014,0.0,1.0
19609,Wandering Girl,44376,0,44376,2019.csv,2019,0.0,1.0
19610,Fass Malh We Daak,44352,0,44352,2016.csv,2016,0.0,1.0
19611,Helen Kelly - Together,44332,0,44332,2020.csv,2020,0.0,1.0
19612,A Loner,44311,0,44311,2018.csv,2018,0.0,1.0
19613,The Room,44291,0,44291,2020.csv,2020,0.0,1.0
19614,What You Gonna Do When the World's on Fire?,44290,4672,39618,2019.csv,2019,0.10548656581621134,0.8945134341837887
19615,Sikander 2,44289,0,44289,2019.csv,2019,0.0,1.0
19616,Osthi,44286,0,44286,2011.csv,2011,0.0,1.0
19617,"Operación México, un pacto de amor",44267,0,44267,2016.csv,2016,0.0,1.0
19618,The Human Voice,44262,0,44262,2020.csv,2020,0.0,1.0
19619,Carmine Street Guitars,44253,44253,0,2019.csv,2019,1.0,0.0
19620,Ratchasaan,44242,0,44242,2018.csv,2018,0.0,1.0
19621,Harry Potter and the Deathly Hallows: Part 1 2021 Re-release,44240,0,44240,2021.csv,2021,0.0,1.0
19622,Slut in a Good Way,44240,40513,3727,2019.csv,2019,0.915754972875226,0.08424502712477396
19623,Nuts!,44230,44230,0,2016.csv,2016,1.0,0.0
19624,Amar Akbar Anthony,44225,0,44225,2018.csv,2018,0.0,1.0
19625,Danny Says,44213,44213,0,2016.csv,2016,1.0,0.0
19626,When I Saw You,44202,0,44202,2013.csv,2013,0.0,1.0
19627,Nar,44182,0,44182,2011.csv,2011,0.0,1.0
19628,Howard Lovecraft & the Undersea Kingdom,44162,0,44162,2018.csv,2018,0.0,1.0
19629,Life of a King,44161,6547,37614,2014.csv,2014,0.14825298340164397,0.851747016598356
19630,Vo Sinh Dai Chien,44157,0,44157,2020.csv,2020,0.0,1.0
19631,Hermia & Helena,44156,43152,1004,2017.csv,2017,0.9772624331914123,0.022737566808587736
19632,Las maestras de la República,44150,0,44150,2014.csv,2014,0.0,1.0
19633,Pihu,44145,0,44145,2018.csv,2018,0.0,1.0
19634,Breakaway,44128,0,44128,2013.csv,2013,0.0,1.0
19635,Saravanan Irukka Bayamaen,44125,0,44125,2017.csv,2017,0.0,1.0
19636,Plus One,44112,0,44112,2019.csv,2019,0.0,1.0
19637,The Music Never Stopped 2013 Re-release,44106,0,44106,2013.csv,2013,0.0,1.0
19638,S. Darko 2011 Re-release,44103,0,44103,2011.csv,2011,0.0,1.0
19639,El gènere femení,44083,0,44083,2011.csv,2011,0.0,1.0
19640,National Theatre Live: The Hard Problem,44076,0,44076,2015.csv,2015,0.0,1.0
19641,Submission,44069,39985,4084,2018.csv,2018,0.9073271460663959,0.09267285393360412
19642,Friend Zone 2010 Re-release,44061,0,44061,2010.csv,2010,0.0,1.0
19643,CarGo,44055,0,44055,2017.csv,2017,0.0,1.0
19644,Liyana,44045,44045,0,2018.csv,2018,1.0,0.0
19645,A Heartbeat Away,44044,0,44044,2011.csv,2011,0.0,1.0
19646,Júlia ist,44032,0,44032,2017.csv,2017,0.0,1.0
19647,Judge Zhongkui,44028,0,44028,2017.csv,2017,0.0,1.0
19648,Pailwaan,44019,0,44019,2019.csv,2019,0.0,1.0
19649,Jîn,44007,0,44007,2013.csv,2013,0.0,1.0
19650,Garry Winogrand: All Things are Photographable,44002,44002,0,2018.csv,2018,1.0,0.0
19651,The Foreigner 2020 Re-release,43971,0,43971,2020.csv,2020,0.0,1.0
19652,Ragini MMS 2,43957,0,43957,2014.csv,2014,0.0,1.0
19653,My Little Friends and I,43952,0,43952,2020.csv,2020,0.0,1.0
19654,Granito,43942,43942,0,2011.csv,2011,1.0,0.0
19655,The Cop,43932,0,43932,2013.csv,2013,0.0,1.0
19656,La Culpa del Cordero,43902,0,43902,2012.csv,2012,0.0,1.0
19657,Life in a Year,43862,0,43862,2020.csv,2020,0.0,1.0
19658,El juego de la silla 2012 Re-release,43843,0,43843,2012.csv,2012,0.0,1.0
19659,Spree,43840,28771,15069,2020.csv,2020,0.6562728102189781,0.3437271897810219
19660,Summer 2011 Re-release,43839,43839,0,2011.csv,2011,1.0,0.0
19661,Flesh Out,43830,0,43830,2019.csv,2019,0.0,1.0
19662,Strella,43818,0,43818,2010.csv,2010,0.0,1.0
19663,4Got10,43798,0,43798,2015.csv,2015,0.0,1.0
19664,Shihad: Beautiful Machine,43782,0,43782,2012.csv,2012,0.0,1.0
19665,Sunday's Illness,43777,0,43777,2018.csv,2018,0.0,1.0
19666,The Trip to Italy 2016 Re-release,43766,0,43766,2016.csv,2016,0.0,1.0
19667,Hitler's Hollywood,43766,43766,0,2018.csv,2018,1.0,0.0
19668,La bomba del Liceu,43764,0,43764,2010.csv,2010,0.0,1.0
19669,Contempt 2013 Re-release,43763,43763,0,2013.csv,2013,1.0,0.0
19670,Bad Blood 2013 Re-release,43758,35176,8582,2013.csv,2013,0.8038758626993922,0.19612413730060788
19671,Episode in the Life of an Iron Picker,43757,0,43757,2013.csv,2013,0.0,1.0
19672,The Land,43756,43756,0,2016.csv,2016,1.0,0.0
19673,The Life of Budori Gusuko 2014 Re-release,43724,0,43724,2014.csv,2014,0.0,1.0
19674,Together Forever,43719,0,43719,2011.csv,2011,0.0,1.0
19675,Bereavement,43712,43712,0,2011.csv,2011,1.0,0.0
19676,Woodshock,43682,42603,1079,2017.csv,2017,0.9752987500572318,0.024701249942768188
19677,The Cleaners,43670,0,43670,2018.csv,2018,0.0,1.0
19678,Maracaibo,43660,0,43660,2017.csv,2017,0.0,1.0
19679,Live Virgin 2011 Re-release,43639,0,43639,2011.csv,2011,0.0,1.0
19680,Deep End,43630,0,43630,2019.csv,2019,0.0,1.0
19681,Ella & Alex: A Surprise Birthday Party,43614,0,43614,2011.csv,2011,0.0,1.0
19682,Jesus of Nazareth,43598,0,43598,2019.csv,2019,0.0,1.0
19683,Love Etc.,43593,43593,0,2011.csv,2011,1.0,0.0
19684,Bhalwan Singh,43592,0,43592,2017.csv,2017,0.0,1.0
19685,Who Cares?,43585,0,43585,2012.csv,2012,0.0,1.0
19686,"OC87: The Obsessive Compulsive, Major Depression, Bipolar, Asperger's Movie",43583,43583,0,2012.csv,2012,1.0,0.0
19687,On Borrowed Time,43564,0,43564,2018.csv,2018,0.0,1.0
19688,Until Sbornia Takes Us Apart,43559,0,43559,2014.csv,2014,0.0,1.0
19689,"Not Spring, Love, or Cherry Blossoms (Da-si, Beot-kkot)",43548,0,43548,2017.csv,2017,0.0,1.0
19690,Araf 4: Meryem,43535,0,43535,2020.csv,2020,0.0,1.0
19691,Ayka,43523,0,43523,2019.csv,2019,0.0,1.0
19692,The Star 2019 Re-release,43510,43510,0,2019.csv,2019,1.0,0.0
19693,Some Kind of Heaven,43492,43492,0,2021.csv,2021,1.0,0.0
19694,After School,43469,0,43469,2017.csv,2017,0.0,1.0
19695,Kesif,43467,0,43467,2018.csv,2018,0.0,1.0
19696,The Graduate 45th Anniversary Reunion,43466,43466,0,2012.csv,2012,1.0,0.0
19697,Cerro Bayo,43458,0,43458,2011.csv,2011,0.0,1.0
19698,Astral 2019 Re-release,43448,0,43448,2019.csv,2019,0.0,1.0
19699,La película de Ana,43430,0,43430,2013.csv,2013,0.0,1.0
19700,GARAKOWA - Restore the World,43416,0,43416,2016.csv,2016,0.0,1.0
19701,Maternity Blues,43397,0,43397,2012.csv,2012,0.0,1.0
19702,If You Build It,43393,43393,0,2014.csv,2014,1.0,0.0
19703,Draupathi,43388,0,43388,2020.csv,2020,0.0,1.0
19704,The Shadow Effect,43368,0,43368,2017.csv,2017,0.0,1.0
19705,Paw Patrol Charged Up,43367,0,43367,2020.csv,2020,0.0,1.0
19706,Babalas,43355,0,43355,2013.csv,2013,0.0,1.0
19707,Morengen Bear vs Man,43328,0,43328,2016.csv,2016,0.0,1.0
19708,The Empire of Corpses,43320,0,43320,2016.csv,2016,0.0,1.0
19709,The Exorcism of Anna Ecklund,43300,0,43300,2017.csv,2017,0.0,1.0
19710,Russell Madness,43288,0,43288,2015.csv,2015,0.0,1.0
19711,When You No Longer Love Me,43270,0,43270,2018.csv,2018,0.0,1.0
19712,Nika,43259,0,43259,2016.csv,2016,0.0,1.0
19713,Michael Collins 2016 Re-release,43244,0,43244,2016.csv,2016,0.0,1.0
19714,Russian Spleen,43219,0,43219,2020.csv,2020,0.0,1.0
19715,Bol Sans,43214,0,43214,2016.csv,2016,0.0,1.0
19716,Tatli Seyler,43211,0,43211,2017.csv,2017,0.0,1.0
19717,Mezarci,43196,0,43196,2017.csv,2017,0.0,1.0
19718,Human Traces,43170,0,43170,2017.csv,2017,0.0,1.0
19719,Meus Dois Amores,43160,0,43160,2015.csv,2015,0.0,1.0
19720,The Mole Agent,43158,0,43158,2020.csv,2020,0.0,1.0
19721,Elfland,43142,0,43142,2019.csv,2019,0.0,1.0
19722,Hear Me Move,43096,0,43096,2015.csv,2015,0.0,1.0
19723,Next Goal Wins,43089,43089,0,2014.csv,2014,1.0,0.0
19724,Hoener met die Rooi Skoene,43088,0,43088,2017.csv,2017,0.0,1.0
19725,3 Backyards,43073,43073,0,2011.csv,2011,1.0,0.0
19726,Herd,43071,0,43071,2017.csv,2017,0.0,1.0
19727,Mysteries of Lisbon 2016 Re-release,43067,0,43067,2016.csv,2016,0.0,1.0
19728,Brothers in Heaven,43067,0,43067,2018.csv,2018,0.0,1.0
19729,In Blue,43057,0,43057,2017.csv,2017,0.0,1.0
19730,Trash Detective,43030,0,43030,2016.csv,2016,0.0,1.0
19731,O kul: Hayal bile etme,43018,0,43018,2010.csv,2010,0.0,1.0
19732,Uroki vyzhivaniya,42992,0,42992,2016.csv,2016,0.0,1.0
19733,Por un puñado de pelos,42992,0,42992,2014.csv,2014,0.0,1.0
19734,The Little Bedroom,42981,0,42981,2011.csv,2011,0.0,1.0
19735,Liewe Kersfeesvader,42975,0,42975,2017.csv,2017,0.0,1.0
19736,Naukar Vahuti Da,42955,0,42955,2019.csv,2019,0.0,1.0
19737,Lost Freedom,42943,0,42943,2011.csv,2011,0.0,1.0
19738,Jenny's Wedding,42927,4704,38223,2015.csv,2015,0.10958138234677475,0.8904186176532253
19739,The Reasons of the Heart,42918,0,42918,2011.csv,2011,0.0,1.0
19740,The Metropolitan Opera HD Live: Borodin: Prince Igor,42916,0,42916,2014.csv,2014,0.0,1.0
19741,"Brooks, Meadows and Lovely Faces",42913,0,42913,2016.csv,2016,0.0,1.0
19742,Attack on Titan: The Wings of Freedom,42910,0,42910,2015.csv,2015,0.0,1.0
19743,Attack on Titan: Chronicle,42908,0,42908,2020.csv,2020,0.0,1.0
19744,Andre Gregory: Before and After Dinner,42892,42892,0,2013.csv,2013,1.0,0.0
19745,They Are All Dead,42877,0,42877,2014.csv,2014,0.0,1.0
19746,Jaws 2019 Re-release,42864,0,42864,2019.csv,2019,0.0,1.0
19747,Mohema Fi Film Adeem,42863,0,42863,2013.csv,2013,0.0,1.0
19748,I Remember,42857,0,42857,2020.csv,2020,0.0,1.0
19749,Thick Lashes of Lauri Mäntyvaara,42832,0,42832,2017.csv,2017,0.0,1.0
19750,Vinaya Vidheya Rama,42832,0,42832,2019.csv,2019,0.0,1.0
19751,The Scapegoat,42815,0,42815,2019.csv,2019,0.0,1.0
19752,First We Take Brooklyn,42812,42812,0,2018.csv,2018,1.0,0.0
19753,Querida Mv£ezinha,42797,0,42797,2018.csv,2018,0.0,1.0
19754,Morran & Tobias - Som en skänk från ovan,42795,0,42795,2016.csv,2016,0.0,1.0
19755,Ayogya,42786,0,42786,2019.csv,2019,0.0,1.0
19756,Porno para principiantes,42759,0,42759,2018.csv,2018,0.0,1.0
19757,Vem?,42752,0,42752,2010.csv,2010,0.0,1.0
19758,Lucie: The Story of a Rock Band,42748,0,42748,2016.csv,2016,0.0,1.0
19759,The First Grader 2014 Re-release,42747,0,42747,2014.csv,2014,0.0,1.0
19760,El vagoneta en el mundo del cine,42736,0,42736,2012.csv,2012,0.0,1.0
19761,A Long Way Around,42715,0,42715,2019.csv,2019,0.0,1.0
19762,Bikeman 2,42710,0,42710,2020.csv,2020,0.0,1.0
19763,Rasputin,42673,0,42673,2011.csv,2011,0.0,1.0
19764,30 Days of 3iz,42670,0,42670,2017.csv,2017,0.0,1.0
19765,Primates of the Caribbean 2015 Re-release,42660,0,42660,2015.csv,2015,0.0,1.0
19766,The Nothing Factory,42657,0,42657,2017.csv,2017,0.0,1.0
19767,El Dictator,42653,0,42653,2010.csv,2010,0.0,1.0
19768,Dating Lanzelot,42652,0,42652,2012.csv,2012,0.0,1.0
19769,Uçan melekler,42617,0,42617,2010.csv,2010,0.0,1.0
19770,Mamonas Pra Sempre,42607,0,42607,2011.csv,2011,0.0,1.0
19771,Un giorno della vita,42575,0,42575,2011.csv,2011,0.0,1.0
19772,Antariksham 9000 kmph,42574,0,42574,2018.csv,2018,0.0,1.0
19773,One Breath,42573,0,42573,2016.csv,2016,0.0,1.0
19774,Interior. Leather Bar.,42534,42534,0,2014.csv,2014,1.0,0.0
19775,Kong Curling 2013 Re-release,42527,0,42527,2013.csv,2013,0.0,1.0
19776,A Long and Happy Life,42526,0,42526,2013.csv,2013,0.0,1.0
19777,Children of the Night,42516,0,42516,2017.csv,2017,0.0,1.0
19778,Yoga,42498,0,42498,2010.csv,2010,0.0,1.0
19779,The Postman's White Nights,42491,0,42491,2015.csv,2015,0.0,1.0
19780,Adulthood,42448,0,42448,2018.csv,2018,0.0,1.0
19781,In Search of Haydn,42445,0,42445,2012.csv,2012,0.0,1.0
19782,Invisible World,42424,0,42424,2013.csv,2013,0.0,1.0
19783,Last Call at the Oasis,42423,42423,0,2012.csv,2012,1.0,0.0
19784,Anguish 2017 Re-release,42423,0,42423,2017.csv,2017,0.0,1.0
19785,Raajakumara,42421,0,42421,2017.csv,2017,0.0,1.0
19786,Unknown Title,42405,0,42405,2019.csv,2019,0.0,1.0
19787,In the Beginning 2011 Re-release,42401,0,42401,2011.csv,2011,0.0,1.0
19788,Fixing the Future,42393,42393,0,2012.csv,2012,1.0,0.0
19789,My Godmother,42388,0,42388,2017.csv,2017,0.0,1.0
19790,Three Words to Forever,42374,0,42374,2018.csv,2018,0.0,1.0
19791,Føniks 2018 Re-release,42363,0,42363,2018.csv,2018,0.0,1.0
19792,Closet Monster,42360,42166,194,2016.csv,2016,0.9954202077431539,0.004579792256846081
19793,Amar-te à Meia-Noite,42351,0,42351,2018.csv,2018,0.0,1.0
19794,Alice: Boy from Wonderland,42318,0,42318,2015.csv,2015,0.0,1.0
19795,El tesoro del rey Midas,42310,0,42310,2010.csv,2010,0.0,1.0
19796,Pecados de mi padre,42295,0,42295,2010.csv,2010,0.0,1.0
19797,The Oath,42273,42273,0,2010.csv,2010,1.0,0.0
19798,Pickpockets,42271,0,42271,2018.csv,2018,0.0,1.0
19799,Dossiê Jango,42265,0,42265,2013.csv,2013,0.0,1.0
19800,The Second Woman,42252,0,42252,2012.csv,2012,0.0,1.0
19801,Ngôc Oi Tuôi 17,42238,0,42238,2019.csv,2019,0.0,1.0
19802,The Forgiven,42213,0,42213,2018.csv,2018,0.0,1.0
19803,Ang Dalawang Mrs. Reyes,42211,0,42211,2018.csv,2018,0.0,1.0
19804,Slender,42186,0,42186,2015.csv,2015,0.0,1.0
19805,Breathing Underwater,42177,0,42177,2016.csv,2016,0.0,1.0
19806,Mundialito,42172,0,42172,2010.csv,2010,0.0,1.0
19807,Overtime,42172,0,42172,2014.csv,2014,0.0,1.0
19808,McKellen: Playing the Part,42160,0,42160,2018.csv,2018,0.0,1.0
19809,Musiek vir die Agtergrond,42150,0,42150,2013.csv,2013,0.0,1.0
19810,Harry Potter and the Goblet of Fire 2021 Re-release,42124,0,42124,2021.csv,2021,0.0,1.0
19811,Over the Fence,42113,0,42113,2017.csv,2017,0.0,1.0
19812,Nalpathiyonnu,42104,0,42104,2019.csv,2019,0.0,1.0
19813,Nebo pod serdtsem,42096,0,42096,2012.csv,2012,0.0,1.0
19814,120 2012 Re-release,42092,0,42092,2012.csv,2012,0.0,1.0
19815,The Karate Kid 2020 Re-release,42043,0,42043,2020.csv,2020,0.0,1.0
19816,For Vagina's Sake,42031,0,42031,2018.csv,2018,0.0,1.0
19817,Summer of 84,42027,0,42027,2018.csv,2018,0.0,1.0
19818,A Tiger in Winter,42019,0,42019,2018.csv,2018,0.0,1.0
19819,In Search of Chopin,42014,0,42014,2014.csv,2014,0.0,1.0
19820,Van Gölü Canavari,42004,0,42004,2012.csv,2012,0.0,1.0
19821,Buying A Man,41982,0,41982,2017.csv,2017,0.0,1.0
19822,The Haunting in Connecticut 2012 Re-release,41961,0,41961,2012.csv,2012,0.0,1.0
19823,Forget About Nick,41943,0,41943,2017.csv,2017,0.0,1.0
19824,Good Night,41937,0,41937,2016.csv,2016,0.0,1.0
19825,Sperm Whale: Roya's Selection,41922,0,41922,2017.csv,2017,0.0,1.0
19826,Where's the Dragon? 2017 Re-release,41921,0,41921,2017.csv,2017,0.0,1.0
19827,Down for Life,41914,41914,0,2011.csv,2011,1.0,0.0
19828,The Chaser,41914,0,41914,2018.csv,2018,0.0,1.0
19829,In Pursuit of Silence,41913,29834,12079,2016.csv,2016,0.7118077923317347,0.2881922076682652
19830,Khalawees,41898,0,41898,2018.csv,2018,0.0,1.0
19831,Deda,41897,0,41897,2016.csv,2016,0.0,1.0
19832,Golden Exits,41888,41888,0,2018.csv,2018,1.0,0.0
19833,Kinshasa Kids,41873,0,41873,2013.csv,2013,0.0,1.0
19834,The Nightmare,41853,28281,13572,2015.csv,2015,0.675722170453731,0.3242778295462691
19835,El Estudiante 2014 Re-release,41846,0,41846,2014.csv,2014,0.0,1.0
19836,Helm Aziz,41841,0,41841,2012.csv,2012,0.0,1.0
19837,"Happy New Year, Colin Burstead",41834,0,41834,2019.csv,2019,0.0,1.0
19838,Uzly a pomerance,41827,0,41827,2019.csv,2019,0.0,1.0
19839,"Isoroku Yamamoto, the Commander-in-Chief of the Combined Fleet 2013 Re-release",41815,0,41815,2013.csv,2013,0.0,1.0
19840,The Legend of Longwood,41807,0,41807,2015.csv,2015,0.0,1.0
19841,"Piazzolla, the Years of the Shark",41804,0,41804,2018.csv,2018,0.0,1.0
19842,On the Bowery,41802,41802,0,2010.csv,2010,1.0,0.0
19843,Scheherazade's Diary,41797,0,41797,2014.csv,2014,0.0,1.0
19844,Wir die Wand,41795,0,41795,2013.csv,2013,0.0,1.0
19845,Yolsuzlar Çetesi,41774,0,41774,2016.csv,2016,0.0,1.0
19846,The Road Within,41760,0,41760,2015.csv,2015,0.0,1.0
19847,Two Idiots,41753,0,41753,2016.csv,2016,0.0,1.0
19848,Cigarettes et chocolat chaud 2018 Re-release,41748,0,41748,2018.csv,2018,0.0,1.0
19849,The Replacement,41715,0,41715,2010.csv,2010,0.0,1.0
19850,Kodi,41707,0,41707,2016.csv,2016,0.0,1.0
19851,Big Hero 6 2020 Re-release,41673,0,41673,2020.csv,2020,0.0,1.0
19852,The Double Steps,41661,0,41661,2011.csv,2011,0.0,1.0
19853,Union,41656,41656,0,2019.csv,2019,1.0,0.0
19854,Kalakalappu,41624,30949,10675,2012.csv,2012,0.7435373822794542,0.25646261772054585
19855,Jingren de Xiyangyang 7,41588,0,41588,2015.csv,2015,0.0,1.0
19856,Stable Unstable,41576,0,41576,2014.csv,2014,0.0,1.0
19857,Death of a Superhero,41575,607,40968,2012.csv,2012,0.014600120264582081,0.9853998797354179
19858,The Settlers,41562,41562,0,2017.csv,2017,1.0,0.0
19859,Jonathan,41558,0,41558,2018.csv,2018,0.0,1.0
19860,Holla II,41537,41537,0,2013.csv,2013,1.0,0.0
19861,Hello! How Are You?,41527,0,41527,2011.csv,2011,0.0,1.0
19862,Les gens du Monde,41511,0,41511,2014.csv,2014,0.0,1.0
19863,Unter Frauen,41473,0,41473,2012.csv,2012,0.0,1.0
19864,Vincent Wants to Sea 2011 Re-release,41469,0,41469,2011.csv,2011,0.0,1.0
19865,The Silver Cliff,41464,0,41464,2013.csv,2013,0.0,1.0
19866,Boarding Gate 2010 Re-release,41452,0,41452,2010.csv,2010,0.0,1.0
19867,Denizden gelen,41436,0,41436,2010.csv,2010,0.0,1.0
19868,28 Degrees North of Love,41413,0,41413,2017.csv,2017,0.0,1.0
19869,Brama,41411,0,41411,2018.csv,2018,0.0,1.0
19870,Bull Fighting 2018 Re-release,41381,0,41381,2018.csv,2018,0.0,1.0
19871,Possessed,41347,0,41347,2013.csv,2013,0.0,1.0
19872,All Cats Are Grey,41340,0,41340,2016.csv,2016,0.0,1.0
19873,"Una cita, una fiesta y un gato negro",41340,0,41340,2012.csv,2012,0.0,1.0
19874,El Verano Siguiente,41339,0,41339,2014.csv,2014,0.0,1.0
19875,Loot 2,41318,0,41318,2017.csv,2017,0.0,1.0
19876,Sons of the Clouds,41317,0,41317,2012.csv,2012,0.0,1.0
19877,Pechat tsarya Solomona,41294,0,41294,2013.csv,2013,0.0,1.0
19878,Retina,41280,0,41280,2019.csv,2019,0.0,1.0
19879,Censored Voices,41260,41260,0,2015.csv,2015,1.0,0.0
19880,The Dream of Nobody,41259,0,41259,2018.csv,2018,0.0,1.0
19881,Le mirage,41258,0,41258,2017.csv,2017,0.0,1.0
19882,Nails,41249,0,41249,2018.csv,2018,0.0,1.0
19883,A Dog Called Money,41220,0,41220,2019.csv,2019,0.0,1.0
19884,Pattathu Yaanai,41217,0,41217,2013.csv,2013,0.0,1.0
19885,Valley of the Gods,41213,0,41213,2020.csv,2020,0.0,1.0
19886,Captain America: Civil War 2020 Re-release,41203,0,41203,2020.csv,2020,0.0,1.0
19887,Steve McQueen: The Man & Le Mans,41203,6843,34360,2015.csv,2015,0.16608013979564595,0.833919860204354
19888,When a Man Falls 2017 Re-release,41195,0,41195,2017.csv,2017,0.0,1.0
19889,Mapa,41192,0,41192,2013.csv,2013,0.0,1.0
19890,In Between Seasons,41187,0,41187,2018.csv,2018,0.0,1.0
19891,Skemerson,41180,0,41180,2019.csv,2019,0.0,1.0
19892,The Wedding Weekend 2011 Re-release,41172,0,41172,2011.csv,2011,0.0,1.0
19893,The Smiling Lombana,41159,0,41159,2019.csv,2019,0.0,1.0
19894,Snekker Andersen og Julenissen 2018 Re-release,41159,0,41159,2018.csv,2018,0.0,1.0
19895,Cin: Ask Büyüsü,41158,0,41158,2019.csv,2019,0.0,1.0
19896,Molly Moon and the Incredible Book of Hypnotism,41158,0,41158,2015.csv,2015,0.0,1.0
19897,Diablo 2019 Re-release,41149,0,41149,2019.csv,2019,0.0,1.0
19898,Shadow,41139,0,41139,2016.csv,2016,0.0,1.0
19899,Deaf Child,41130,0,41130,2018.csv,2018,0.0,1.0
19900,Priboi,41126,0,41126,2018.csv,2018,0.0,1.0
19901,Min Dahar Ragel,41124,0,41124,2016.csv,2016,0.0,1.0
19902,The Comedy,41113,41113,0,2012.csv,2012,1.0,0.0
19903,Blue Note Records: Beyond the Notes,41079,0,41079,2019.csv,2019,0.0,1.0
19904,Karl Marx City,41072,41072,0,2017.csv,2017,1.0,0.0
19905,Sukeisti Kaledu Seneliai (Santa Swap),41069,0,41069,2018.csv,2018,0.0,1.0
19906,Blue Iguana,41050,0,41050,2018.csv,2018,0.0,1.0
19907,The Myth of the American Sleepover,41045,41045,0,2011.csv,2011,1.0,0.0
19908,Henchmen,41041,1469,39572,2018.csv,2018,0.03579347481786506,0.9642065251821349
19909,Arsenal,41037,0,41037,2017.csv,2017,0.0,1.0
19910,Ravenous,41026,0,41026,2018.csv,2018,0.0,1.0
19911,God of the Piano,41015,0,41015,2020.csv,2020,0.0,1.0
19912,Unfair World,41012,0,41012,2012.csv,2012,0.0,1.0
19913,Fat Kid Rules the World,41000,41000,0,2012.csv,2012,1.0,0.0
19914,Why Don't You Just Die!,40995,0,40995,2019.csv,2019,0.0,1.0
19915,La Cacería,40956,0,40956,2012.csv,2012,0.0,1.0
19916,Hell and Back Again,40949,40634,315,2011.csv,2011,0.9923075044567633,0.007692495543236709
19917,Love is Not Behind the Mountains,40948,0,40948,2016.csv,2016,0.0,1.0
19918,Don't Forget Me,40939,0,40939,2018.csv,2018,0.0,1.0
19919,Blades of Blood,40911,0,40911,2010.csv,2010,0.0,1.0
19920,No Money,40900,0,40900,2018.csv,2018,0.0,1.0
19921,Benzersiz,40900,0,40900,2017.csv,2017,0.0,1.0
19922,Klip,40896,0,40896,2012.csv,2012,0.0,1.0
19923,Under Electric Clouds,40896,0,40896,2015.csv,2015,0.0,1.0
19924,Pantani: The Accidental Death of a Cyclist,40882,0,40882,2014.csv,2014,0.0,1.0
19925,Hoje,40847,0,40847,2013.csv,2013,0.0,1.0
19926,Chantrapas,40837,0,40837,2011.csv,2011,0.0,1.0
19927,Yung Lean: In My Head,40834,0,40834,2020.csv,2020,0.0,1.0
19928,Enter the Dragon 2010 Re-release,40802,0,40802,2010.csv,2010,0.0,1.0
19929,The Fairest Encounter,40780,0,40780,2019.csv,2019,0.0,1.0
19930,Min pappa Marianne,40772,0,40772,2020.csv,2020,0.0,1.0
19931,My Man,40764,0,40764,2015.csv,2015,0.0,1.0
19932,Found Memories,40729,10575,30154,2012.csv,2012,0.25964300621179015,0.7403569937882098
19933,The Italian Key,40720,0,40720,2011.csv,2011,0.0,1.0
19934,Paraíso perdido 2018 Re-release,40685,0,40685,2018.csv,2018,0.0,1.0
19935,Olho Nu,40680,0,40680,2014.csv,2014,0.0,1.0
19936,Besa,40659,0,40659,2010.csv,2010,0.0,1.0
19937,Sameer & Shaheer & Baheer,40657,0,40657,2011.csv,2011,0.0,1.0
19938,Language of a Broken Heart,40645,40645,0,2013.csv,2013,1.0,0.0
19939,Mercedes Sosa: The Voice of Latin America,40643,2648,37995,2013.csv,2013,0.06515267081662279,0.9348473291833772
19940,News from Planet Mars 2016 Re-release,40625,0,40625,2016.csv,2016,0.0,1.0
19941,Inbetween Worlds,40618,0,40618,2014.csv,2014,0.0,1.0
19942,Crazy Teacher,40601,0,40601,2017.csv,2017,0.0,1.0
19943,Life and Nothing More,40581,24358,16223,2017.csv,2017,0.6002316354944432,0.3997683645055568
19944,Bajo un manto de estrellas,40579,0,40579,2014.csv,2014,0.0,1.0
19945,The FP,40557,40557,0,2012.csv,2012,1.0,0.0
19946,Little Mole,40547,0,40547,2011.csv,2011,0.0,1.0
19947,"Puppe, Icke & der Dicke",40536,0,40536,2012.csv,2012,0.0,1.0
19948,Romulo & Julita,40534,0,40534,2020.csv,2020,0.0,1.0
19949,Cin-Si Bozuk,40517,0,40517,2019.csv,2019,0.0,1.0
19950,Famous Five 2013 Re-release,40500,0,40500,2013.csv,2013,0.0,1.0
19951,La Dolce Vita,40484,0,40484,2020.csv,2020,0.0,1.0
19952,Vinyl Days 2014 Re-release,40457,0,40457,2014.csv,2014,0.0,1.0
19953,Sevdam Gözlerinde Kaldi,40447,0,40447,2016.csv,2016,0.0,1.0
19954,MindGamers,40447,0,40447,2017.csv,2017,0.0,1.0
19955,Eksik sayfalar,40420,0,40420,2013.csv,2013,0.0,1.0
19956,Three Spaces,40417,0,40417,2018.csv,2018,0.0,1.0
19957,A Horse with Hope,40416,0,40416,2016.csv,2016,0.0,1.0
19958,The Official Story 2016 Re-release,40406,0,40406,2016.csv,2016,0.0,1.0
19959,Tokyo Story,40405,0,40405,2013.csv,2013,0.0,1.0
19960,CBGB,40400,40400,0,2013.csv,2013,1.0,0.0
19961,The Mirror,40394,0,40394,2016.csv,2016,0.0,1.0
19962,Le monde nous appartient,40390,0,40390,2013.csv,2013,0.0,1.0
19963,The Trouble with Terkel 2010 Re-release,40385,40385,0,2010.csv,2010,1.0,0.0
19964,Belle de Jour 2017 Re-release,40382,26331,14051,2017.csv,2017,0.6520479421524441,0.34795205784755584
19965,El apóstata,40375,0,40375,2015.csv,2015,0.0,1.0
19966,The Odyssey 2020 Re-release,40346,0,40346,2020.csv,2020,0.0,1.0
19967,Zeus,40331,0,40331,2017.csv,2017,0.0,1.0
19968,Donkeyote,40331,0,40331,2017.csv,2017,0.0,1.0
19969,Of Mind and Music,40322,15073,25249,2016.csv,2016,0.37381578294727447,0.6261842170527255
19970,Paan Singh Tomar,40311,40311,0,2012.csv,2012,1.0,0.0
19971,Saekano: How to Raise a Boring Girlfriend Fine,40309,0,40309,2020.csv,2020,0.0,1.0
19972,The Last Prosecco 2019 Re-release,40296,0,40296,2019.csv,2019,0.0,1.0
19973,Return to the Hiding Place 2017 Re-release,40293,0,40293,2017.csv,2017,0.0,1.0
19974,Mihkel,40276,0,40276,2018.csv,2018,0.0,1.0
19975,Ali & Alia,40271,0,40271,2019.csv,2019,0.0,1.0
19976,Couple in a Hole,40256,0,40256,2016.csv,2016,0.0,1.0
19977,Psycho 2020 Re-release,40242,0,40242,2020.csv,2020,0.0,1.0
19978,The Red Baron 2010 Re-release,40239,37189,3050,2010.csv,2010,0.9242028877457193,0.07579711225428068
19979,Dolphin Man. The Story of Jacques Mayol,40227,0,40227,2018.csv,2018,0.0,1.0
19980,A Roar of Wolf Troops,40212,0,40212,2016.csv,2016,0.0,1.0
19981,Camarón: Flamenco y revolución,40210,0,40210,2018.csv,2018,0.0,1.0
19982,Pret Arbut,40187,0,40187,2017.csv,2017,0.0,1.0
19983,Teenage,40169,40169,0,2014.csv,2014,1.0,0.0
19984,Canned Dreams,40167,0,40167,2012.csv,2012,0.0,1.0
19985,Hibou,40159,0,40159,2016.csv,2016,0.0,1.0
19986,White Night Wedding 2010 Re-release,40153,0,40153,2010.csv,2010,0.0,1.0
19987,On Her Shoulders,40145,28288,11857,2018.csv,2018,0.7046456594843692,0.29535434051563086
19988,Aniara,40124,40124,0,2019.csv,2019,1.0,0.0
19989,Abendland,40120,0,40120,2011.csv,2011,0.0,1.0
19990,Extraterrestrial 2015 Re-release,40107,0,40107,2015.csv,2015,0.0,1.0
19991,Addiction Incorporated,40106,40106,0,2011.csv,2011,1.0,0.0
19992,Driven to Kill,40103,0,40103,2010.csv,2010,0.0,1.0
19993,Humor Me,40099,40099,0,2018.csv,2018,1.0,0.0
19994,Homeward,40093,0,40093,2019.csv,2019,0.0,1.0
19995,You're Ugly Too 2017 Re-release,40087,0,40087,2017.csv,2017,0.0,1.0
19996,Zelyonaya kareta,40086,0,40086,2015.csv,2015,0.0,1.0
19997,Unrest,40081,40081,0,2017.csv,2017,1.0,0.0
19998,Williams,40061,0,40061,2017.csv,2017,0.0,1.0
19999,Clownwise,40046,0,40046,2013.csv,2013,0.0,1.0
20000,The Light,40032,0,40032,2016.csv,2016,0.0,1.0
20001,Khido Khundi,40024,0,40024,2018.csv,2018,0.0,1.0
20002,Baba bi buçuk,40019,0,40019,2018.csv,2018,0.0,1.0
20003,Mr. Snow White,40002,0,40002,2016.csv,2016,0.0,1.0
20004,Louder Than a Bomb,40000,40000,0,2011.csv,2011,1.0,0.0
20005,The Shed,39992,0,39992,2019.csv,2019,0.0,1.0
20006,For My Father's Kingdom,39982,0,39982,2019.csv,2019,0.0,1.0
20007,Is That a Gun in Your Pocket?,39928,39928,0,2016.csv,2016,1.0,0.0
20008,Together,39921,0,39921,2012.csv,2012,0.0,1.0
20009,Divine Love,39920,0,39920,2019.csv,2019,0.0,1.0
20010,Soguk,39910,0,39910,2014.csv,2014,0.0,1.0
20011,Poslednee ispytanie,39891,0,39891,2019.csv,2019,0.0,1.0
20012,Sunrise/Sunset,39884,0,39884,2010.csv,2010,0.0,1.0
20013,The Music Never Stopped 2012 Re-release,39873,0,39873,2012.csv,2012,0.0,1.0
20014,Yom Eh Yom La2,39858,0,39858,2020.csv,2020,0.0,1.0
20015,Lovely Loneliness 2013 Re-release,39856,0,39856,2013.csv,2013,0.0,1.0
20016,Tabu: The Soul Is a Stranger on Earth,39848,0,39848,2012.csv,2012,0.0,1.0
20017,Nich Sviatogo Valentyna,39844,0,39844,2016.csv,2016,0.0,1.0
20018,The Short Game,39819,39819,0,2013.csv,2013,1.0,0.0
20019,Plot for Peace,39811,7051,32760,2013.csv,2013,0.17711185350782446,0.8228881464921756
20020,The Kiss of a Killer,39748,0,39748,2013.csv,2013,0.0,1.0
20021,I Am Belfast,39740,0,39740,2016.csv,2016,0.0,1.0
20022,Her Only Choice,39738,0,39738,2019.csv,2019,0.0,1.0
20023,Midsommar 2019 Re-release,39734,0,39734,2019.csv,2019,0.0,1.0
20024,Goutham Nanda,39711,0,39711,2017.csv,2017,0.0,1.0
20025,One War,39710,0,39710,2010.csv,2010,0.0,1.0
20026,The Whirl,39699,0,39699,2012.csv,2012,0.0,1.0
20027,Ping Pong 2013 Re-release,39681,0,39681,2013.csv,2013,0.0,1.0
20028,The Legend of Timm Thaler or The Boy Who Sold His Laughter,39670,0,39670,2019.csv,2019,0.0,1.0
20029,Im Knast: Der Zweiäugige unter den Blinden,39645,0,39645,2015.csv,2015,0.0,1.0
20030,Comedown,39624,0,39624,2013.csv,2013,0.0,1.0
20031,Port of Shadows,39623,27389,12234,2012.csv,2012,0.6912399364005755,0.3087600635994246
20032,Black Out,39606,0,39606,2010.csv,2010,0.0,1.0
20033,An Elephant Sitting Still,39599,32556,7043,2018.csv,2018,0.8221419732821535,0.17785802671784642
20034,Chal Mohan Ranga,39598,0,39598,2018.csv,2018,0.0,1.0
20035,Tosca: Live From La Scala 2019,39555,0,39555,2019.csv,2019,0.0,1.0
20036,The Race-ist,39523,0,39523,2010.csv,2010,0.0,1.0
20037,King Lear,39519,0,39519,2011.csv,2011,0.0,1.0
20038,The Homeless Billionaire,39493,39493,0,2016.csv,2016,1.0,0.0
20039,Juvenile Delinquents,39455,34292,5163,2020.csv,2020,0.869142060575339,0.130857939424661
20040,Blue Spring Ride,39453,0,39453,2015.csv,2015,0.0,1.0
20041,Napoleon,39448,0,39448,2016.csv,2016,0.0,1.0
20042,Women Who Passed My Way,39446,0,39446,2018.csv,2018,0.0,1.0
20043,Blind,39434,0,39434,2015.csv,2015,0.0,1.0
20044,Band of Outsiders 2018 Re-release,39414,0,39414,2018.csv,2018,0.0,1.0
20045,Of Love and Other Demons,39406,0,39406,2010.csv,2010,0.0,1.0
20046,Northless,39382,0,39382,2010.csv,2010,0.0,1.0
20047,Interstellar 2017 Re-release,39360,0,39360,2017.csv,2017,0.0,1.0
20048,Breaking Habits,39350,0,39350,2019.csv,2019,0.0,1.0
20049,Prophet's Prey,39347,39347,0,2015.csv,2015,1.0,0.0
20050,Breach,39328,0,39328,2020.csv,2020,0.0,1.0
20051,Child of God,39324,39324,0,2014.csv,2014,1.0,0.0
20052,Jellyfish,39315,0,39315,2019.csv,2019,0.0,1.0
20053,Nausicaä of the Valley of the Wind 2010 Re-release,39306,0,39306,2010.csv,2010,0.0,1.0
20054,Dinosaur Island,39296,0,39296,2017.csv,2017,0.0,1.0
20055,Counterespionage,39290,0,39290,2018.csv,2018,0.0,1.0
20056,October Baby 2013 Re-release,39290,0,39290,2013.csv,2013,0.0,1.0
20057,La cinquième saison,39268,0,39268,2013.csv,2013,0.0,1.0
20058,GujjuBhai - Most Wanted,39266,0,39266,2018.csv,2018,0.0,1.0
20059,Fortuna Lake,39266,0,39266,2019.csv,2019,0.0,1.0
20060,"3 1/2 Minutes, 10 Bullets",39263,30407,8856,2015.csv,2015,0.7744441331533505,0.22555586684664952
20061,Filth 2015 Re-release,39261,0,39261,2015.csv,2015,0.0,1.0
20062,The Academy of Magic,39237,0,39237,2020.csv,2020,0.0,1.0
20063,La Notte,39236,39236,0,2016.csv,2016,1.0,0.0
20064,What We Become,39234,0,39234,2016.csv,2016,0.0,1.0
20065,Ides? Idem!,39227,0,39227,2019.csv,2019,0.0,1.0
20066,The Child in Time,39221,0,39221,2020.csv,2020,0.0,1.0
20067,Where Soldiers Come From,39201,39201,0,2011.csv,2011,1.0,0.0
20068,Can,39198,0,39198,2012.csv,2012,0.0,1.0
20069,Personal Affairs,39195,0,39195,2017.csv,2017,0.0,1.0
20070,How to Make Money Selling Drugs,39192,39192,0,2013.csv,2013,1.0,0.0
20071,I Do Not Care If We Go Down in History as Barbarians,39171,11307,27864,2018.csv,2018,0.2886574251359424,0.7113425748640576
20072,Love of the Sea,39162,0,39162,2016.csv,2016,0.0,1.0
20073,Avengement,39153,0,39153,2019.csv,2019,0.0,1.0
20074,Ohne Dich,39118,0,39118,2014.csv,2014,0.0,1.0
20075,Folk ved fjorden,39116,0,39116,2012.csv,2012,0.0,1.0
20076,The Expedition to the End of the World,39115,39115,0,2014.csv,2014,1.0,0.0
20077,Usturoi,39090,0,39090,2015.csv,2015,0.0,1.0
20078,Framed,39071,0,39071,2019.csv,2019,0.0,1.0
20079,Alta infedeltà,39069,0,39069,2010.csv,2010,0.0,1.0
20080,Little Fish,39053,39053,0,2021.csv,2021,1.0,0.0
20081,Rage,39046,0,39046,2018.csv,2018,0.0,1.0
20082,Life on the Line,39027,0,39027,2016.csv,2016,0.0,1.0
20083,Not Engineer Hasan,39020,0,39020,2010.csv,2010,0.0,1.0
20084,Starfish,39012,0,39012,2016.csv,2016,0.0,1.0
20085,Zilla and Zoe,39003,39003,0,2019.csv,2019,1.0,0.0
20086,Liewe Lisa,38999,0,38999,2019.csv,2019,0.0,1.0
20087,I Used to Be Darker,38974,22214,16760,2013.csv,2013,0.5699697234053471,0.43003027659465287
20088,Terror 5,38972,0,38972,2017.csv,2017,0.0,1.0
20089,The Stuart Hall Project,38959,0,38959,2013.csv,2013,0.0,1.0
20090,Kung Fu Style,38936,0,38936,2016.csv,2016,0.0,1.0
20091,Herb & Dorothy 50X50,38933,38933,0,2013.csv,2013,1.0,0.0
20092,Polyxeni,38920,0,38920,2017.csv,2017,0.0,1.0
20093,Children of Sarajevo,38920,0,38920,2013.csv,2013,0.0,1.0
20094,Shed of the Dead,38901,38901,0,2019.csv,2019,1.0,0.0
20095,The Starry Sky Above Me,38891,0,38891,2018.csv,2018,0.0,1.0
20096,"Natacha, la pelicula",38871,0,38871,2018.csv,2018,0.0,1.0
20097,Sloboda pod nákladom,38852,0,38852,2016.csv,2016,0.0,1.0
20098,Troppo napoletano 2018 Re-release,38829,0,38829,2018.csv,2018,0.0,1.0
20099,Wilaya,38828,0,38828,2012.csv,2012,0.0,1.0
20100,The Bay of Silence,38806,1941,36865,2020.csv,2020,0.050018038447662734,0.9499819615523373
20101,The Hardest Thing,38801,0,38801,2020.csv,2020,0.0,1.0
20102,When China Wows the World: The 2019 Grand Military Parade,38796,0,38796,2019.csv,2019,0.0,1.0
20103,Maryan,38796,0,38796,2013.csv,2013,0.0,1.0
20104,Passi el que passi,38794,0,38794,2011.csv,2011,0.0,1.0
20105,Hunger 2016 Re-release,38788,0,38788,2016.csv,2016,0.0,1.0
20106,Avalon 2012 Re-release,38782,0,38782,2012.csv,2012,0.0,1.0
20107,Arcadia,38775,0,38775,2018.csv,2018,0.0,1.0
20108,The Son of Joseph,38774,30588,8186,2016.csv,2016,0.7888791458193635,0.2111208541806365
20109,Restored Me,38745,38745,0,2016.csv,2016,1.0,0.0
20110,Thambikku Indha Ooru,38739,0,38739,2010.csv,2010,0.0,1.0
20111,Bluebeard,38696,33490,5206,2010.csv,2010,0.8654641306594997,0.1345358693405003
20112,The Cold Front,38695,0,38695,2016.csv,2016,0.0,1.0
20113,Paul Williams Still Alive,38691,38691,0,2012.csv,2012,1.0,0.0
20114,The Dive,38688,0,38688,2019.csv,2019,0.0,1.0
20115,Hahaha 2012 Re-release,38661,0,38661,2012.csv,2012,0.0,1.0
20116,Kadal,38615,0,38615,2013.csv,2013,0.0,1.0
20117,Catching the Sun,38613,38613,0,2016.csv,2016,1.0,0.0
20118,"Jerico, the Infinite Flight of Days 2018 Re-release",38610,0,38610,2018.csv,2018,0.0,1.0
20119,Mavis!,38597,0,38597,2016.csv,2016,0.0,1.0
20120,PowerNation: Xtreme Off Road: Exo-Skeleton Cage,38593,0,38593,2014.csv,2014,0.0,1.0
20121,Spa Night,38578,38578,0,2016.csv,2016,1.0,0.0
20122,Fräulein: una fiaba d'inverno,38577,0,38577,2016.csv,2016,0.0,1.0
20123,Troublemakers: The Story of Land Art,38571,29462,9109,2016.csv,2016,0.7638381167198154,0.2361618832801846
20124,Habbet Caramel,38561,0,38561,2018.csv,2018,0.0,1.0
20125,Traveling Over the Sea,38558,0,38558,2017.csv,2017,0.0,1.0
20126,Yatra,38558,0,38558,2019.csv,2019,0.0,1.0
20127,Kazka staroho melnyka,38556,0,38556,2020.csv,2020,0.0,1.0
20128,Ondhu Mutteya Kathe,38553,0,38553,2017.csv,2017,0.0,1.0
20129,The Relative Worlds,38539,0,38539,2019.csv,2019,0.0,1.0
20130,The Audition,38523,0,38523,2020.csv,2020,0.0,1.0
20131,Divide and Conquer,38510,38510,0,2018.csv,2018,1.0,0.0
20132,Death by China,38492,38492,0,2012.csv,2012,1.0,0.0
20133,Iron Doors,38457,0,38457,2011.csv,2011,0.0,1.0
20134,La casa nel vento dei morti,38447,0,38447,2012.csv,2012,0.0,1.0
20135,Ceberrut,38444,0,38444,2016.csv,2016,0.0,1.0
20136,Ammen,38444,0,38444,2020.csv,2020,0.0,1.0
20137,My Man Is a Loser,38429,0,38429,2014.csv,2014,0.0,1.0
20138,Doll 2015 Re-release,38418,0,38418,2015.csv,2015,0.0,1.0
20139,Multiple Maniacs,38403,33036,5367,2016.csv,2016,0.860245293336458,0.13975470666354192
20140,Araby,38399,38399,0,2018.csv,2018,1.0,0.0
20141,The Future Ahead,38398,0,38398,2017.csv,2017,0.0,1.0
20142,Batman Forever 2019 Re-release,38387,38014,373,2019.csv,2019,0.9902831687810978,0.009716831218902232
20143,Nine Nation Animation,38382,38382,0,2010.csv,2010,1.0,0.0
20144,"Bonitinha, Mas Ordinária",38378,0,38378,2013.csv,2013,0.0,1.0
20145,The Foggy Mountain-Dinh Mu Suong,38376,0,38376,2020.csv,2020,0.0,1.0
20146,10 Things We Should Do Before We Break Up,38362,0,38362,2021.csv,2021,0.0,1.0
20147,Trapped,38349,0,38349,2017.csv,2017,0.0,1.0
20148,The Blackcoat's Daughter,38348,20435,17913,2017.csv,2017,0.5328830708250756,0.46711692917492437
20149,Madras Cafe,38333,0,38333,2013.csv,2013,0.0,1.0
20150,Smert v pensne ili Nash Chekhov,38326,0,38326,2010.csv,2010,0.0,1.0
20151,Caravaggio: The Soul and the Blood,38289,0,38289,2018.csv,2018,0.0,1.0
20152,Cabeça a Prêmio,38264,0,38264,2010.csv,2010,0.0,1.0
20153,Policeman,38263,11263,27000,2013.csv,2013,0.29435747327705614,0.7056425267229438
20154,Death Bell 2010 Re-release,38261,0,38261,2010.csv,2010,0.0,1.0
20155,Permission,38260,0,38260,2018.csv,2018,0.0,1.0
20156,Origin Unknown,38252,0,38252,2020.csv,2020,0.0,1.0
20157,Miracle: Devil Claus' Love and Magic,38248,0,38248,2015.csv,2015,0.0,1.0
20158,No Intenso Agora,38223,24955,13268,2018.csv,2018,0.6528791565287916,0.3471208434712084
20159,It's Alive 2012 Re-release,38219,0,38219,2012.csv,2012,0.0,1.0
20160,Dilwale Dulhania Le Jayenge 2020 Re-release,38180,0,38180,2020.csv,2020,0.0,1.0
20161,Swelter,38158,0,38158,2015.csv,2015,0.0,1.0
20162,Puella Magi Madoka Magica the Movie Part III: The Rebellion Story 2018 Re-release,38113,0,38113,2018.csv,2018,0.0,1.0
20163,Ruth,38110,0,38110,2018.csv,2018,0.0,1.0
20164,Germans & Jews,38100,38100,0,2016.csv,2016,1.0,0.0
20165,The Blood Lands,38086,0,38086,2015.csv,2015,0.0,1.0
20166,The Legend of Pale Male,38083,38083,0,2010.csv,2010,1.0,0.0
20167,Water Boyy,38058,0,38058,2015.csv,2015,0.0,1.0
20168,Hebbuli,38052,0,38052,2017.csv,2017,0.0,1.0
20169,Brainious,38051,0,38051,2018.csv,2018,0.0,1.0
20170,Gray Matter,38034,38034,0,2018.csv,2018,1.0,0.0
20171,Bagnoli Jungle,38027,0,38027,2016.csv,2016,0.0,1.0
20172,Band of Outsiders 2016 Re-release,38004,38004,0,2016.csv,2016,1.0,0.0
20173,Sexfish,38004,0,38004,2020.csv,2020,0.0,1.0
20174,Moscow Never Sleeps,38004,25306,12698,2016.csv,2016,0.6658772760762025,0.3341227239237975
20175,The Crime of Monsieur Lange,38002,36438,1564,2017.csv,2017,0.9588442713541393,0.04115572864586074
20176,Native,37997,0,37997,2012.csv,2012,0.0,1.0
20177,Russian Ark 2013 Re-release,37984,37984,0,2013.csv,2013,1.0,0.0
20178,The Great White Silence,37983,0,37983,2011.csv,2011,0.0,1.0
20179,Little Harbour,37972,0,37972,2017.csv,2017,0.0,1.0
20180,Behind the Walls,37971,0,37971,2020.csv,2020,0.0,1.0
20181,The Wanderers: The Quest of the Demon Hunter,37955,0,37955,2018.csv,2018,0.0,1.0
20182,Sangathamizhan,37946,0,37946,2019.csv,2019,0.0,1.0
20183,Vampire Strawberry,37928,0,37928,2011.csv,2011,0.0,1.0
20184,Dora's Peace,37919,0,37919,2016.csv,2016,0.0,1.0
20185,Ee Nagaraniki Emaindi,37906,0,37906,2018.csv,2018,0.0,1.0
20186,Velikiy severnyy put,37894,0,37894,2019.csv,2019,0.0,1.0
20187,Adult World,37887,25368,12519,2014.csv,2014,0.6695700372159316,0.3304299627840684
20188,Kaledeki Yalnizlik,37863,0,37863,2011.csv,2011,0.0,1.0
20189,El Laiba El Americany,37859,0,37859,2019.csv,2019,0.0,1.0
20190,Love of God,37853,0,37853,2018.csv,2018,0.0,1.0
20191,Evangeline 2017 Re-release,37850,0,37850,2017.csv,2017,0.0,1.0
20192,I Am the Blues,37849,37849,0,2017.csv,2017,1.0,0.0
20193,Sorokin Trip,37846,0,37846,2019.csv,2019,0.0,1.0
20194,Adi ask bu eziyetin,37817,0,37817,2010.csv,2010,0.0,1.0
20195,The First Lap,37810,0,37810,2017.csv,2017,0.0,1.0
20196,The Witch in the Window,37802,0,37802,2019.csv,2019,0.0,1.0
20197,The Heart of Nuba,37788,37788,0,2018.csv,2018,1.0,0.0
20198,The Death War,37778,0,37778,2016.csv,2016,0.0,1.0
20199,Vou Rifar meu Coração,37770,0,37770,2012.csv,2012,0.0,1.0
20200,14 Days with Victor,37769,0,37769,2010.csv,2010,0.0,1.0
20201,Tetarti 04:45,37767,0,37767,2015.csv,2015,0.0,1.0
20202,Cartels,37766,0,37766,2016.csv,2016,0.0,1.0
20203,Wùlu,37765,0,37765,2017.csv,2017,0.0,1.0
20204,The Trial,37757,0,37757,2011.csv,2011,0.0,1.0
20205,Out 1,37743,31539,6204,2015.csv,2015,0.835625149034258,0.164374850965742
20206,Mumia: Long Distance Revolutionary,37731,37731,0,2013.csv,2013,1.0,0.0
20207,The Descent: Part 2 2013 Re-release,37727,0,37727,2013.csv,2013,0.0,1.0
20208,Les P'tits explorateurs,37723,0,37723,2017.csv,2017,0.0,1.0
20209,Postcard,37696,0,37696,2012.csv,2012,0.0,1.0
20210,Atlantis,37690,0,37690,2020.csv,2020,0.0,1.0
20211,"Daniel Darc, Pieces of My Life",37683,0,37683,2019.csv,2019,0.0,1.0
20212,Frost,37673,0,37673,2017.csv,2017,0.0,1.0
20213,Vikruthi,37659,0,37659,2019.csv,2019,0.0,1.0
20214,Longing,37646,0,37646,2018.csv,2018,0.0,1.0
20215,Le Caravage,37637,0,37637,2015.csv,2015,0.0,1.0
20216,Step bay step,37634,0,37634,2011.csv,2011,0.0,1.0
20217,Vakantna zhizn shef-povara,37628,0,37628,2016.csv,2016,0.0,1.0
20218,Love's Whirlpool,37622,0,37622,2014.csv,2014,0.0,1.0
20219,Power to Change: Die EnergieRebellion,37615,0,37615,2016.csv,2016,0.0,1.0
20220,Monster Busters,37610,0,37610,2018.csv,2018,0.0,1.0
20221,Honeymoons,37542,0,37542,2010.csv,2010,0.0,1.0
20222,That Person and Those Things,37538,0,37538,2020.csv,2020,0.0,1.0
20223,Krystal,37516,37516,0,2018.csv,2018,1.0,0.0
20224,News from Planet Mars,37507,310,37197,2016.csv,2016,0.008265123843549204,0.9917348761564508
20225,Transference,37483,0,37483,2020.csv,2020,0.0,1.0
20226,Stories from the Chestnut Woods,37479,0,37479,2019.csv,2019,0.0,1.0
20227,Blue Eyes,37470,0,37470,2010.csv,2010,0.0,1.0
20228,The Baytown Outlaws,37470,0,37470,2013.csv,2013,0.0,1.0
20229,Big Sur,37466,37466,0,2013.csv,2013,1.0,0.0
20230,Bwakaw,37460,0,37460,2012.csv,2012,0.0,1.0
20231,Simindis kundzuli,37445,0,37445,2015.csv,2015,0.0,1.0
20232,Children's Park,37444,0,37444,2019.csv,2019,0.0,1.0
20233,Die Rebellie van Lafras Verwey,37439,0,37439,2017.csv,2017,0.0,1.0
20234,Asmaa,37428,0,37428,2012.csv,2012,0.0,1.0
20235,Paper Flower,37426,0,37426,2020.csv,2020,0.0,1.0
20236,Nur eta herensugearen tenplua,37419,0,37419,2017.csv,2017,0.0,1.0
20237,Overman,37409,0,37409,2016.csv,2016,0.0,1.0
20238,Die schwarzen Brüder,37338,0,37338,2014.csv,2014,0.0,1.0
20239,Leblebi Tozu,37330,0,37330,2016.csv,2016,0.0,1.0
20240,The Land of Hope,37323,0,37323,2013.csv,2013,0.0,1.0
20241,You're Not Alone,37297,0,37297,2020.csv,2020,0.0,1.0
20242,Una gita a Roma,37287,0,37287,2018.csv,2018,0.0,1.0
20243,Match 2015 Re-release,37285,37285,0,2015.csv,2015,1.0,0.0
20244,Mortadelo and Filemon: Mission - Save the Planet 2016 Re-release,37278,0,37278,2016.csv,2016,0.0,1.0
20245,The Littlest Angel,37273,0,37273,2013.csv,2013,0.0,1.0
20246,Memory: The Origins of Alien,37272,31378,5894,2019.csv,2019,0.8418652071259927,0.1581347928740073
20247,Staff Only,37248,0,37248,2019.csv,2019,0.0,1.0
20248,Savannah,37240,37240,0,2013.csv,2013,1.0,0.0
20249,Naked Soldier 2014 Re-release,37187,0,37187,2014.csv,2014,0.0,1.0
20250,Catch Hell,37166,0,37166,2014.csv,2014,0.0,1.0
20251,Loveless Zoritsa,37160,0,37160,2012.csv,2012,0.0,1.0
20252,Querida voy a comprar cigarrillos y vuelvo,37138,0,37138,2011.csv,2011,0.0,1.0
20253,Outsourced,37136,0,37136,2011.csv,2011,0.0,1.0
20254,Magic,37122,0,37122,2010.csv,2010,0.0,1.0
20255,Soul Boys of the Western World,37104,0,37104,2015.csv,2015,0.0,1.0
20256,Where You're Meant to Be,37100,0,37100,2016.csv,2016,0.0,1.0
20257,Borderland 2016 Re-release,37080,0,37080,2016.csv,2016,0.0,1.0
20258,Oma & Bella,37074,0,37074,2012.csv,2012,0.0,1.0
20259,Ecumenopolis: City Without Limits,37070,0,37070,2012.csv,2012,0.0,1.0
20260,Trolling,37069,0,37069,2013.csv,2013,0.0,1.0
20261,Small Group,37058,37058,0,2018.csv,2018,1.0,0.0
20262,Nora's Will 2012 Re-release,37048,0,37048,2012.csv,2012,0.0,1.0
20263,24 Frames,37045,34482,2563,2018.csv,2018,0.9308138750168714,0.06918612498312862
20264,Love Me Tomorrow,37038,0,37038,2016.csv,2016,0.0,1.0
20265,The Quiet One,37010,37010,0,2019.csv,2019,1.0,0.0
20266,Children of Paradise 2012 Re-release,36986,36986,0,2012.csv,2012,1.0,0.0
20267,Local God,36982,0,36982,2015.csv,2015,0.0,1.0
20268,Narusitel,36954,0,36954,2019.csv,2019,0.0,1.0
20269,The City of Violence 2014 Re-release,36943,0,36943,2014.csv,2014,0.0,1.0
20270,Grey Gardens,36923,36923,0,2015.csv,2015,1.0,0.0
20271,Mushkil,36919,0,36919,2019.csv,2019,0.0,1.0
20272,(Q)üfür,36919,0,36919,2013.csv,2013,0.0,1.0
20273,Guns of Banaras,36914,0,36914,2020.csv,2020,0.0,1.0
20274,Trust Fund,36885,36885,0,2016.csv,2016,1.0,0.0
20275,The Two of Us,36866,0,36866,2015.csv,2015,0.0,1.0
20276,Accidents Happen,36857,0,36857,2010.csv,2010,0.0,1.0
20277,The Death of Dick Long,36856,36856,0,2019.csv,2019,1.0,0.0
20278,Sex Ed,36842,0,36842,2015.csv,2015,0.0,1.0
20279,Toriko 3D: Kaimaku! Gurume adobenchâ! 2012 Re-release,36819,0,36819,2012.csv,2012,0.0,1.0
20280,Moot yat paai dui,36818,0,36818,2013.csv,2013,0.0,1.0
20281,The Graduate 2017 Re-release,36813,0,36813,2017.csv,2017,0.0,1.0
20282,Christmas Survival,36809,0,36809,2018.csv,2018,0.0,1.0
20283,Jacinto Convit,36801,0,36801,2014.csv,2014,0.0,1.0
20284,Wedding in Bessarabia,36800,0,36800,2010.csv,2010,0.0,1.0
20285,Dilwale Dulhania Le Jayenge,36785,0,36785,2013.csv,2013,0.0,1.0
20286,Infestation,36756,0,36756,2010.csv,2010,0.0,1.0
20287,The Banished,36727,0,36727,2019.csv,2019,0.0,1.0
20288,Bloodline,36725,0,36725,2019.csv,2019,0.0,1.0
20289,Three Christs,36723,36723,0,2020.csv,2020,1.0,0.0
20290,High End Yaariyaan,36721,0,36721,2019.csv,2019,0.0,1.0
20291,The Double Plus Fifteen,36702,0,36702,2020.csv,2020,0.0,1.0
20292,Sister Code,36676,36676,0,2015.csv,2015,1.0,0.0
20293,Good Posture,36647,0,36647,2019.csv,2019,0.0,1.0
20294,Hidden Away,36647,0,36647,2014.csv,2014,0.0,1.0
20295,Camera Obscura 2012 Re-release,36642,0,36642,2012.csv,2012,0.0,1.0
20296,Mind Game,36613,36613,0,2018.csv,2018,1.0,0.0
20297,King of the Travellers,36590,0,36590,2013.csv,2013,0.0,1.0
20298,Bending the Arc,36586,21907,14679,2017.csv,2017,0.5987809544634559,0.40121904553654403
20299,EXHIBITION: Manet: Portraying Life,36585,0,36585,2013.csv,2013,0.0,1.0
20300,Yoga Hosers,36585,0,36585,2016.csv,2016,0.0,1.0
20301,Dancing with Jikji,36582,0,36582,2017.csv,2017,0.0,1.0
20302,Hit So Hard,36576,34025,2551,2012.csv,2012,0.9302548118985127,0.06974518810148732
20303,Seventeen Year Old Rainy Season,36568,0,36568,2017.csv,2017,0.0,1.0
20304,Loro,36567,35613,954,2019.csv,2019,0.9739109032734433,0.02608909672655673
20305,Robo-Dog: Airborne,36542,0,36542,2017.csv,2017,0.0,1.0
20306,Love Afterlife,36540,0,36540,2018.csv,2018,0.0,1.0
20307,The Boys Who Cried Wolf,36539,0,36539,2016.csv,2016,0.0,1.0
20308,El ratón Pérez 2 2011 Re-release,36533,0,36533,2011.csv,2011,0.0,1.0
20309,Tread,36527,36527,0,2020.csv,2020,1.0,0.0
20310,For Better for Worse,36520,0,36520,2010.csv,2010,0.0,1.0
20311,Listen To Your Heart. The Beautiful Mind,36518,0,36518,2019.csv,2019,0.0,1.0
20312,For Those Who Don't Read Me,36506,36506,0,2018.csv,2018,1.0,0.0
20313,Sound! Euphonium: The Movie - Welcome to the Kitauji High School Concert Band,36476,0,36476,2016.csv,2016,0.0,1.0
20314,Cherry,36465,11362,25103,2010.csv,2010,0.31158645276292335,0.6884135472370766
20315,The Servant,36463,36463,0,2013.csv,2013,1.0,0.0
20316,Afraid of the Dark (Bruises),36438,0,36438,2011.csv,2011,0.0,1.0
20317,Waiting for Anya,36404,0,36404,2020.csv,2020,0.0,1.0
20318,Unexpected,36402,23986,12416,2015.csv,2015,0.6589198395692545,0.34108016043074557
20319,Thirst,36389,0,36389,2019.csv,2019,0.0,1.0
20320,How to Let Go of the World: and Love All the Things Climate Can't Change,36386,36386,0,2016.csv,2016,1.0,0.0
20321,Cop Mortem,36384,0,36384,2016.csv,2016,0.0,1.0
20322,Welcome to Leith,36380,36010,370,2015.csv,2015,0.9898295766904893,0.01017042330951072
20323,Doomed,36375,0,36375,2019.csv,2019,0.0,1.0
20324,Four Corners,36374,0,36374,2014.csv,2014,0.0,1.0
20325,Land of Sorrow,36373,0,36373,2018.csv,2018,0.0,1.0
20326,The Enchanted Soulmates of Art,36355,0,36355,2017.csv,2017,0.0,1.0
20327,Shadows 2011 Re-release,36350,0,36350,2011.csv,2011,0.0,1.0
20328,Balkan Bazaar,36335,0,36335,2011.csv,2011,0.0,1.0
20329,Cara ou Coroa,36325,0,36325,2012.csv,2012,0.0,1.0
20330,Highway to Hellas 2017 Re-release,36319,0,36319,2017.csv,2017,0.0,1.0
20331,Girl Gets Girl,36316,0,36316,2015.csv,2015,0.0,1.0
20332,Papa Hemingway in Cuba 2018 Re-release,36291,0,36291,2018.csv,2018,0.0,1.0
20333,Mansome,36280,36280,0,2012.csv,2012,1.0,0.0
20334,Trolled,36272,0,36272,2018.csv,2018,0.0,1.0
20335,IMT Smile and Lucnica: Made in Slovakia,36257,0,36257,2016.csv,2016,0.0,1.0
20336,Womb,36257,0,36257,2011.csv,2011,0.0,1.0
20337,Mukoku,36243,0,36243,2018.csv,2018,0.0,1.0
20338,No Place to Go 2011 Re-release,36227,0,36227,2011.csv,2011,0.0,1.0
20339,Baba Mirasi,36149,0,36149,2016.csv,2016,0.0,1.0
20340,Loosies,36145,3519,32626,2012.csv,2012,0.09735786415825148,0.9026421358417485
20341,Touchy Feely,36128,36128,0,2013.csv,2013,1.0,0.0
20342,Bouget Faqarah,36121,0,36121,2016.csv,2016,0.0,1.0
20343,"Paws, Bones & Rock'n'roll 2017 Re-release",36100,0,36100,2017.csv,2017,0.0,1.0
20344,Le Corbeau,36089,36089,0,2018.csv,2018,1.0,0.0
20345,Pepe & Rubianes,36068,0,36068,2011.csv,2011,0.0,1.0
20346,Guardians 2018 Re-release,36065,0,36065,2018.csv,2018,0.0,1.0
20347,A Day & A Night,36063,0,36063,2020.csv,2020,0.0,1.0
20348,Montmartre de Papa,36059,0,36059,2016.csv,2016,0.0,1.0
20349,Just Like My Son,36059,0,36059,2018.csv,2018,0.0,1.0
20350,Initials SG,36053,0,36053,2019.csv,2019,0.0,1.0
20351,Dare to Be Wild,36048,0,36048,2016.csv,2016,0.0,1.0
20352,Caída del Cielo,36041,0,36041,2016.csv,2016,0.0,1.0
20353,Brimstone & Glory,36036,32059,3977,2017.csv,2017,0.8896381396381396,0.11036186036186037
20354,"Kill Me, Deadly",36027,36027,0,2016.csv,2016,1.0,0.0
20355,A Break Alone,36027,0,36027,2016.csv,2016,0.0,1.0
20356,Not Cool,36026,36026,0,2014.csv,2014,1.0,0.0
20357,Oru Kuttanadan Blog,36018,0,36018,2018.csv,2018,0.0,1.0
20358,Tandoori Love 2010 Re-release,36013,0,36013,2010.csv,2010,0.0,1.0
20359,Parasite,36005,0,36005,2020.csv,2020,0.0,1.0
20360,Road to the Moon,35996,0,35996,2018.csv,2018,0.0,1.0
20361,Fastest,35963,0,35963,2011.csv,2011,0.0,1.0
20362,Ablations,35957,0,35957,2014.csv,2014,0.0,1.0
20363,Kuyu,35937,0,35937,2017.csv,2017,0.0,1.0
20364,Pinky Moge Wali,35933,0,35933,2012.csv,2012,0.0,1.0
20365,The Kid,35930,0,35930,2013.csv,2013,0.0,1.0
20366,Paintball 2011 Re-release,35929,0,35929,2011.csv,2011,0.0,1.0
20367,Mr. Zhu's Summer,35929,0,35929,2017.csv,2017,0.0,1.0
20368,The 12th Suspect,35914,0,35914,2019.csv,2019,0.0,1.0
20369,Together Is Too Much 2012 Re-release,35911,0,35911,2012.csv,2012,0.0,1.0
20370,Drawers,35910,0,35910,2015.csv,2015,0.0,1.0
20371,Truyên Thuyêt Vê Quán Tiên,35898,0,35898,2020.csv,2020,0.0,1.0
20372,Polar Adventure,35887,0,35887,2016.csv,2016,0.0,1.0
20373,Zlo,35875,0,35875,2012.csv,2012,0.0,1.0
20374,Azraille Dans,35862,0,35862,2018.csv,2018,0.0,1.0
20375,Doby & Disy's Dreamy Town,35852,0,35852,2017.csv,2017,0.0,1.0
20376,Almost Friends,35842,1481,34361,2017.csv,2017,0.04132023882595837,0.9586797611740416
20377,Before I Die,35841,0,35841,2017.csv,2017,0.0,1.0
20378,Children of the 90th,35834,0,35834,2015.csv,2015,0.0,1.0
20379,The House of Tomorrow,35821,35821,0,2018.csv,2018,1.0,0.0
20380,Intangible Asset No. 82,35801,0,35801,2010.csv,2010,0.0,1.0
20381,'n Saak van Geloof,35790,0,35790,2011.csv,2011,0.0,1.0
20382,Unforgettable,35788,0,35788,2019.csv,2019,0.0,1.0
20383,Bangkok Revenge,35784,35784,0,2012.csv,2012,1.0,0.0
20384,Algeil Ar Rabea,35782,0,35782,2015.csv,2015,0.0,1.0
20385,Chastnoe pionerskoe 2,35781,0,35781,2017.csv,2017,0.0,1.0
20386,The Road Movie,35757,35757,0,2018.csv,2018,1.0,0.0
20387,Mi prima la sexóloga,35749,0,35749,2016.csv,2016,0.0,1.0
20388,Wader Wecker Father Land,35739,0,35739,2011.csv,2011,0.0,1.0
20389,Antes Que Eu Me Esqueça,35726,0,35726,2018.csv,2018,0.0,1.0
20390,Good Manners,35714,31177,4537,2018.csv,2018,0.8729629837038696,0.12703701629613037
20391,Empeliculados,35709,0,35709,2017.csv,2017,0.0,1.0
20392,Cat Run 2012 Re-release,35708,0,35708,2012.csv,2012,0.0,1.0
20393,Hooray! Vacation!,35705,0,35705,2016.csv,2016,0.0,1.0
20394,Beyond the Known World,35690,0,35690,2017.csv,2017,0.0,1.0
20395,Paul Goodman Changed My Life,35671,35671,0,2011.csv,2011,1.0,0.0
20396,Oh My Kadavule,35668,0,35668,2020.csv,2020,0.0,1.0
20397,Far Out Isn't Far Enough: The Tomi Ungerer Story,35647,35647,0,2013.csv,2013,1.0,0.0
20398,Zhengzheng's World,35630,0,35630,2018.csv,2018,0.0,1.0
20399,Sea Guard,35625,0,35625,2017.csv,2017,0.0,1.0
20400,Ates,35620,0,35620,2016.csv,2016,0.0,1.0
20401,The Anderssons in Greece 2014 Re-release,35619,0,35619,2014.csv,2014,0.0,1.0
20402,Triumphantly Join Forces,35611,0,35611,2016.csv,2016,0.0,1.0
20403,Ogres,35600,0,35600,2016.csv,2016,0.0,1.0
20404,One Floor Below,35595,0,35595,2015.csv,2015,0.0,1.0
20405,"Tombatossals, la leyenda",35592,0,35592,2013.csv,2013,0.0,1.0
20406,Mezeci Ciragi,35582,0,35582,2017.csv,2017,0.0,1.0
20407,M 2013 Re-release,35566,35566,0,2013.csv,2013,1.0,0.0
20408,Adrenaline Khonduadsad,35561,0,35561,2010.csv,2010,0.0,1.0
20409,The Delinquent Season,35559,0,35559,2018.csv,2018,0.0,1.0
20410,Guy and Madeline on a Park Bench,35556,35556,0,2010.csv,2010,1.0,0.0
20411,Finders Keepers,35555,35555,0,2015.csv,2015,1.0,0.0
20412,Filmové pøehlídky 2010,35543,0,35543,2010.csv,2010,0.0,1.0
20413,A Stranger in Paradise,35535,0,35535,2013.csv,2013,0.0,1.0
20414,A Night in Bodrum,35526,0,35526,2017.csv,2017,0.0,1.0
20415,Gora samotsvetov 2010 Re-release,35505,0,35505,2010.csv,2010,0.0,1.0
20416,Beautiful Days,35504,0,35504,2018.csv,2018,0.0,1.0
20417,Los Fierros,35482,0,35482,2019.csv,2019,0.0,1.0
20418,Speed of Glory,35479,0,35479,2010.csv,2010,0.0,1.0
20419,Le frise ignoranti,35465,0,35465,2015.csv,2015,0.0,1.0
20420,Dassehra,35464,0,35464,2018.csv,2018,0.0,1.0
20421,Notes to Eternity,35463,0,35463,2016.csv,2016,0.0,1.0
20422,Song to Song 2019 Re-release,35432,0,35432,2019.csv,2019,0.0,1.0
20423,PGS: Intuition Is Your Personal Guidance System,35423,35423,0,2018.csv,2018,1.0,0.0
20424,Welcome to New York 2018 Re-release,35416,0,35416,2018.csv,2018,0.0,1.0
20425,Kinyarwanda,35412,35412,0,2011.csv,2011,1.0,0.0
20426,Max and the Junkmen,35387,35387,0,2012.csv,2012,1.0,0.0
20427,Verskietende Ster,35384,0,35384,2016.csv,2016,0.0,1.0
20428,Brotherhood of Tears 2015 Re-release,35352,0,35352,2015.csv,2015,0.0,1.0
20429,My Geeky Nerdy Buddies,35334,0,35334,2014.csv,2014,0.0,1.0
20430,Le Jour Se Leve,35321,35321,0,2014.csv,2014,1.0,0.0
20431,Growing Up Smith,35312,35312,0,2017.csv,2017,1.0,0.0
20432,Non c'è più religione 2018 Re-release,35310,0,35310,2018.csv,2018,0.0,1.0
20433,Family United 2014 Re-release,35291,0,35291,2014.csv,2014,0.0,1.0
20434,The Decent One,35282,21327,13955,2014.csv,2014,0.6044725355705459,0.39552746442945413
20435,Body Language 2013 Re-release,35272,0,35272,2013.csv,2013,0.0,1.0
20436,Underdogs,35271,35271,0,2013.csv,2013,1.0,0.0
20437,Let the Wind Carry Me,35269,0,35269,2011.csv,2011,0.0,1.0
20438,I Served the King of England 2010 Re-release,35268,0,35268,2010.csv,2010,0.0,1.0
20439,24 Weeks,35266,0,35266,2016.csv,2016,0.0,1.0
20440,Departure along the Sea,35259,0,35259,2018.csv,2018,0.0,1.0
20441,Missione di pace,35255,0,35255,2011.csv,2011,0.0,1.0
20442,Là-bas: A Criminal Education,35251,0,35251,2012.csv,2012,0.0,1.0
20443,Kali,35247,0,35247,2016.csv,2016,0.0,1.0
20444,Town of Runners,35242,0,35242,2012.csv,2012,0.0,1.0
20445,Blood Money 2013 Re-release,35219,0,35219,2013.csv,2013,0.0,1.0
20446,Brawl,35216,0,35216,2012.csv,2012,0.0,1.0
20447,You and I,35211,0,35211,2019.csv,2019,0.0,1.0
20448,National Theatre Live: The Cherry Orchard,35210,0,35210,2011.csv,2011,0.0,1.0
20449,A Complicated Story,35203,0,35203,2014.csv,2014,0.0,1.0
20450,Rat Film,35195,35195,0,2017.csv,2017,1.0,0.0
20451,God's Forgotten Town,35192,0,35192,2010.csv,2010,0.0,1.0
20452,Grandma's Home,35189,0,35189,2018.csv,2018,0.0,1.0
20453,Ága,35178,35178,0,2019.csv,2019,1.0,0.0
20454,The Great Debaters 2011 Re-release,35149,0,35149,2011.csv,2011,0.0,1.0
20455,That Man from Rio,35144,35144,0,2014.csv,2014,1.0,0.0
20456,Heartstone 2019 Re-release,35142,0,35142,2019.csv,2019,0.0,1.0
20457,The Metropolitan Opera HD Live: Offenbach: Les contes d'Hoffmann,35139,0,35139,2015.csv,2015,0.0,1.0
20458,Paco de Lucía: A Journey,35139,0,35139,2014.csv,2014,0.0,1.0
20459,#Bornagain,35137,0,35137,2018.csv,2018,0.0,1.0
20460,Whispers of Gold,35121,0,35121,2020.csv,2020,0.0,1.0
20461,Dora,35119,0,35119,2017.csv,2017,0.0,1.0
20462,When Harry Tries to Marry,35100,35100,0,2011.csv,2011,1.0,0.0
20463,Bhai's Cafe,35089,0,35089,2020.csv,2020,0.0,1.0
20464,Madre amadísima,35068,0,35068,2010.csv,2010,0.0,1.0
20465,Amateur,35068,0,35068,2016.csv,2016,0.0,1.0
20466,The Girl,35048,35048,0,2013.csv,2013,1.0,0.0
20467,A Christmas Story 2020 Re-release,35000,35000,0,2020.csv,2020,1.0,0.0
20468,Sennentuntschi: Curse of the Alps,34991,0,34991,2011.csv,2011,0.0,1.0
20469,A Stitch of Life,34966,0,34966,2016.csv,2016,0.0,1.0
20470,SAS: Red Notice,34949,0,34949,2021.csv,2021,0.0,1.0
20471,Jora: The Second Chapter,34944,0,34944,2020.csv,2020,0.0,1.0
20472,Moon-young,34928,0,34928,2017.csv,2017,0.0,1.0
20473,Ming Hun Qi Shi,34926,0,34926,2014.csv,2014,0.0,1.0
20474,Kieu @,34914,0,34914,2021.csv,2021,0.0,1.0
20475,Screwed,34904,0,34904,2011.csv,2011,0.0,1.0
20476,Polleros del sur: La venganza 2017 Re-release,34896,0,34896,2017.csv,2017,0.0,1.0
20477,The Metropolitan Opera HD Live: Wagner: Siegfried,34879,0,34879,2011.csv,2011,0.0,1.0
20478,Aman Ya Shabi,34837,0,34837,2017.csv,2017,0.0,1.0
20479,Full of Grace,34830,0,34830,2016.csv,2016,0.0,1.0
20480,Miracle on Jongno Street,34829,0,34829,2011.csv,2011,0.0,1.0
20481,The Solitude of Prime Numbers 2013 Re-release,34819,0,34819,2013.csv,2013,0.0,1.0
20482,Café. Waiting. Love 2017 Re-release,34800,0,34800,2017.csv,2017,0.0,1.0
20483,Free State,34785,0,34785,2016.csv,2016,0.0,1.0
20484,Beneath the Harvest Sky,34768,34768,0,2014.csv,2014,1.0,0.0
20485,Vikramadithyan,34767,0,34767,2014.csv,2014,0.0,1.0
20486,E Riam Sing,34761,0,34761,2020.csv,2020,0.0,1.0
20487,The Sky Eye,34759,0,34759,2019.csv,2019,0.0,1.0
20488,Unforgivable Sin,34755,0,34755,2019.csv,2019,0.0,1.0
20489,This Ain't No Mouse Music,34754,34754,0,2014.csv,2014,1.0,0.0
20490,The Stakelander,34752,0,34752,2017.csv,2017,0.0,1.0
20491,BBC Proms: Last Night of the Proms,34737,0,34737,2010.csv,2010,0.0,1.0
20492,The Asian Connection,34735,0,34735,2016.csv,2016,0.0,1.0
20493,The Signal 2011 Re-release,34731,0,34731,2011.csv,2011,0.0,1.0
20494,Vals,34723,0,34723,2014.csv,2014,0.0,1.0
20495,Blank 13,34721,0,34721,2019.csv,2019,0.0,1.0
20496,The Hollow Child 2019 Re-release,34719,0,34719,2019.csv,2019,0.0,1.0
20497,France,34714,0,34714,2010.csv,2010,0.0,1.0
20498,King of Boys,34711,0,34711,2019.csv,2019,0.0,1.0
20499,Tanec medzi crepinami,34710,0,34710,2012.csv,2012,0.0,1.0
20500,Kadamban,34697,0,34697,2017.csv,2017,0.0,1.0
20501,Graves & Bones,34690,0,34690,2014.csv,2014,0.0,1.0
20502,Regresa 2012 Re-release,34686,0,34686,2012.csv,2012,0.0,1.0
20503,Seotaiji Moai: The Film,34683,0,34683,2011.csv,2011,0.0,1.0
20504,She Is the Ocean,34680,20211,14469,2020.csv,2020,0.5827854671280277,0.4172145328719723
20505,Comic-Con Episode IV: A Fan's Hope,34665,34665,0,2012.csv,2012,1.0,0.0
20506,The Old Dark House,34649,25678,8971,2017.csv,2017,0.7410892089237785,0.25891079107622156
20507,Make a Wish,34641,0,34641,2016.csv,2016,0.0,1.0
20508,Sophie and the Rising Sun,34630,34630,0,2017.csv,2017,1.0,0.0
20509,The Reconquest,34595,0,34595,2016.csv,2016,0.0,1.0
20510,Le Trou,34588,34588,0,2017.csv,2017,1.0,0.0
20511,Orchestra of Exiles,34577,34577,0,2012.csv,2012,1.0,0.0
20512,Daytime Shooting Star 2018 Re-release,34553,0,34553,2018.csv,2018,0.0,1.0
20513,Una noche sin luna,34536,0,34536,2015.csv,2015,0.0,1.0
20514,The Sinister,34533,0,34533,2011.csv,2011,0.0,1.0
20515,All Night Long,34522,0,34522,2011.csv,2011,0.0,1.0
20516,The Tattoist,34521,0,34521,2017.csv,2017,0.0,1.0
20517,Rakuen Tsuiho: Expelled from Paradise,34510,34510,0,2014.csv,2014,1.0,0.0
20518,The Nightingale 2015 Re-release,34489,0,34489,2015.csv,2015,0.0,1.0
20519,Beyond the Steppes,34485,0,34485,2010.csv,2010,0.0,1.0
20520,Ji xing gao zhao,34459,0,34459,2015.csv,2015,0.0,1.0
20521,The Daughter,34440,0,34440,2012.csv,2012,0.0,1.0
20522,Away Bus,34439,0,34439,2019.csv,2019,0.0,1.0
20523,Swoon,34434,0,34434,2019.csv,2019,0.0,1.0
20524,Mind My Mind,34429,0,34429,2020.csv,2020,0.0,1.0
20525,Sint 2012 Re-release,34428,0,34428,2012.csv,2012,0.0,1.0
20526,Kasting dlya zlodeya,34427,0,34427,2012.csv,2012,0.0,1.0
20527,Zifir-i Azap,34424,0,34424,2018.csv,2018,0.0,1.0
20528,Çat Kapi Ask,34417,0,34417,2019.csv,2019,0.0,1.0
20529,Reign of Assassins 2012 Re-release,34413,0,34413,2012.csv,2012,0.0,1.0
20530,Tigre og tatoveringer,34411,0,34411,2012.csv,2012,0.0,1.0
20531,Moy papa Baryshnikov,34404,0,34404,2011.csv,2011,0.0,1.0
20532,Pokhozhdeniya bravogo soldata Shveyka,34402,0,34402,2012.csv,2012,0.0,1.0
20533,Kuru Kuru and Friends: The Rainbow Tree Forest,34393,0,34393,2015.csv,2015,0.0,1.0
20534,Cosmos,34393,25856,8537,2015.csv,2015,0.7517808856453349,0.2482191143546652
20535,Vodyanaya,34392,0,34392,2019.csv,2019,0.0,1.0
20536,Tevye's Daughters,34383,0,34383,2017.csv,2017,0.0,1.0
20537,Marighella,34374,0,34374,2012.csv,2012,0.0,1.0
20538,Pierrot le Fou 2015 Re-release,34371,34371,0,2015.csv,2015,1.0,0.0
20539,Holy Hell,34366,34366,0,2018.csv,2018,1.0,0.0
20540,Alles Wat Mal Is,34323,0,34323,2014.csv,2014,0.0,1.0
20541,Inception 2017 Re-release,34302,0,34302,2017.csv,2017,0.0,1.0
20542,Eva 2012 Re-release,34286,0,34286,2012.csv,2012,0.0,1.0
20543,Spanien,34284,0,34284,2012.csv,2012,0.0,1.0
20544,Zombillénium 2019 Re-release,34256,0,34256,2019.csv,2019,0.0,1.0
20545,Off the Rails,34249,34249,0,2016.csv,2016,1.0,0.0
20546,Rocks in My Pockets,34236,34236,0,2014.csv,2014,1.0,0.0
20547,Victor Young Perez,34210,0,34210,2017.csv,2017,0.0,1.0
20548,Just Like a Woman,34206,11403,22803,2013.csv,2013,0.3333625679705315,0.6666374320294686
20549,Tatli Bela,34194,0,34194,2018.csv,2018,0.0,1.0
20550,The Face of an Angel,34194,0,34194,2015.csv,2015,0.0,1.0
20551,Icimdeki Hazine,34194,0,34194,2018.csv,2018,0.0,1.0
20552,Vision 2011 Re-release,34182,0,34182,2011.csv,2011,0.0,1.0
20553,Kung Fu Town,34178,0,34178,2019.csv,2019,0.0,1.0
20554,Altitude,34174,0,34174,2017.csv,2017,0.0,1.0
20555,Nota,34142,0,34142,2018.csv,2018,0.0,1.0
20556,Yuki and Nina,34128,0,34128,2010.csv,2010,0.0,1.0
20557,Bezm-i Ezel,34125,0,34125,2017.csv,2017,0.0,1.0
20558,HipHop Express,34118,0,34118,2011.csv,2011,0.0,1.0
20559,Dave Made a Maze,34117,34117,0,2017.csv,2017,1.0,0.0
20560,The Unbearable Lightness Of Ingeborg Bachmann,34099,0,34099,2013.csv,2013,0.0,1.0
20561,Beautiful Darling,34096,34096,0,2011.csv,2011,1.0,0.0
20562,Cuando los hombres quedan solos,34053,0,34053,2019.csv,2019,0.0,1.0
20563,El Revenge,34048,0,34048,2017.csv,2017,0.0,1.0
20564,Alta Cumbia,34037,0,34037,2017.csv,2017,0.0,1.0
20565,Well,34033,0,34033,2016.csv,2016,0.0,1.0
20566,Song from the Forest,34031,0,34031,2014.csv,2014,0.0,1.0
20567,Next Station I Love You,34026,0,34026,2015.csv,2015,0.0,1.0
20568,Kilo Two Bravo,34017,7891,26126,2015.csv,2015,0.23197224916953288,0.7680277508304671
20569,The Metropolitan Opera HD Live: Puccini: La Fanciulla del West,34013,0,34013,2011.csv,2011,0.0,1.0
20570,Et in terra pax,34007,0,34007,2011.csv,2011,0.0,1.0
20571,Bert Stern: Original Madman,34005,34005,0,2013.csv,2013,1.0,0.0
20572,RBG 2020 Re-release,34000,34000,0,2020.csv,2020,1.0,0.0
20573,King Skate,33995,0,33995,2018.csv,2018,0.0,1.0
20574,Maui,33953,33953,0,2018.csv,2018,1.0,0.0
20575,A Clockwork Orange 2013 Re-release,33943,0,33943,2013.csv,2013,0.0,1.0
20576,Mc Dandik,33935,0,33935,2013.csv,2013,0.0,1.0
20577,Nightmare Cinema,33925,0,33925,2019.csv,2019,0.0,1.0
20578,Jawbone,33919,0,33919,2017.csv,2017,0.0,1.0
20579,Hrúturinn Hreinn,33914,0,33914,2015.csv,2015,0.0,1.0
20580,Majnon Amira,33914,0,33914,2010.csv,2010,0.0,1.0
20581,Killer Unicorn,33901,33901,0,2019.csv,2019,1.0,0.0
20582,One Car Four Servants,33897,0,33897,2019.csv,2019,0.0,1.0
20583,The Whale 2013 Re-release,33889,0,33889,2013.csv,2013,0.0,1.0
20584,Organik Ask Hikayeleri,33888,0,33888,2017.csv,2017,0.0,1.0
20585,Shooting the Mafia,33884,10881,23003,2019.csv,2019,0.3211250147562271,0.6788749852437729
20586,Better Angels,33862,0,33862,2019.csv,2019,0.0,1.0
20587,Oh Les Filles!,33861,0,33861,2019.csv,2019,0.0,1.0
20588,Moonlight Sonata: Deafness in Three Movements,33823,33823,0,2019.csv,2019,1.0,0.0
20589,It Felt Like Love,33817,33817,0,2014.csv,2014,1.0,0.0
20590,Love is All,33782,0,33782,2018.csv,2018,0.0,1.0
20591,Russkie evrei. Film tretiy. Posle 1948 goda,33780,0,33780,2017.csv,2017,0.0,1.0
20592,Pocoyo in cinemas: Your First Movie,33775,0,33775,2018.csv,2018,0.0,1.0
20593,Drama,33774,0,33774,2010.csv,2010,0.0,1.0
20594,The Sea,33735,0,33735,2014.csv,2014,0.0,1.0
20595,Closed Curtain,33735,28098,5637,2014.csv,2014,0.8329035126722988,0.1670964873277012
20596,Zanahoria,33732,0,33732,2014.csv,2014,0.0,1.0
20597,Seventh,33731,0,33731,2014.csv,2014,0.0,1.0
20598,WebSiteStory,33729,0,33729,2010.csv,2010,0.0,1.0
20599,Heart of Lightness,33720,0,33720,2014.csv,2014,0.0,1.0
20600,Ingrid,33711,0,33711,2010.csv,2010,0.0,1.0
20601,Johnny is nie dood nie,33703,0,33703,2017.csv,2017,0.0,1.0
20602,The Moment,33701,0,33701,2017.csv,2017,0.0,1.0
20603,Passing the Baton,33699,0,33699,2011.csv,2011,0.0,1.0
20604,Kohlhaas oder die Verhältnismäßigkeit der Mittel,33691,0,33691,2013.csv,2013,0.0,1.0
20605,Goodfellas 2017 Re-release,33683,0,33683,2017.csv,2017,0.0,1.0
20606,Below Her Mouth,33673,0,33673,2017.csv,2017,0.0,1.0
20607,Crime Busters,33642,0,33642,2016.csv,2016,0.0,1.0
20608,Bheja Fry 2,33642,0,33642,2011.csv,2011,0.0,1.0
20609,Devil's Pie: D'Angelo,33639,0,33639,2019.csv,2019,0.0,1.0
20610,Get the Weed,33630,0,33630,2017.csv,2017,0.0,1.0
20611,Mavi Gece,33623,0,33623,2015.csv,2015,0.0,1.0
20612,Nagore,33620,0,33620,2010.csv,2010,0.0,1.0
20613,Messi,33607,0,33607,2015.csv,2015,0.0,1.0
20614,Ispanets,33605,0,33605,2012.csv,2012,0.0,1.0
20615,Iki Iyi Cocuk,33602,0,33602,2018.csv,2018,0.0,1.0
20616,Chronicle of the After-School Wars,33583,0,33583,2019.csv,2019,0.0,1.0
20617,Al Laila Al kabeera,33548,0,33548,2015.csv,2015,0.0,1.0
20618,Vicky the Viking 2013 Re-release,33542,0,33542,2013.csv,2013,0.0,1.0
20619,Wild Kids,33523,0,33523,2018.csv,2018,0.0,1.0
20620,El Hekaya Fiha Mena,33522,0,33522,2010.csv,2010,0.0,1.0
20621,Sicarivs: La noche y el silencio,33522,0,33522,2015.csv,2015,0.0,1.0
20622,Beloved Berlin Wall 2011 Re-release,33507,0,33507,2011.csv,2011,0.0,1.0
20623,"The good, the evil and the playful",33497,0,33497,2019.csv,2019,0.0,1.0
20624,Teper ya budu lyubyty tebe,33492,0,33492,2015.csv,2015,0.0,1.0
20625,The Curse of Downers Grove,33462,0,33462,2015.csv,2015,0.0,1.0
20626,Courtesy to the Nation,33455,0,33455,2018.csv,2018,0.0,1.0
20627,Making the Boys,33443,33443,0,2011.csv,2011,1.0,0.0
20628,Baba,33433,0,33433,2012.csv,2012,0.0,1.0
20629,The Winding Stream,33420,33420,0,2015.csv,2015,1.0,0.0
20630,Final Girl,33411,0,33411,2015.csv,2015,0.0,1.0
20631,The People Upstairs,33404,0,33404,2021.csv,2021,0.0,1.0
20632,My Last Year as a Loser,33397,0,33397,2019.csv,2019,0.0,1.0
20633,L'era legale,33389,0,33389,2012.csv,2012,0.0,1.0
20634,Motherland,33381,0,33381,2019.csv,2019,0.0,1.0
20635,Bobby Robson: More Than a Manager,33374,0,33374,2018.csv,2018,0.0,1.0
20636,"Ali, the Goat and Ibrahim",33370,0,33370,2017.csv,2017,0.0,1.0
20637,Channa Mereya,33365,0,33365,2017.csv,2017,0.0,1.0
20638,Freaks 2020 Re-release,33360,0,33360,2020.csv,2020,0.0,1.0
20639,National Theatre Live: Othello,33356,0,33356,2013.csv,2013,0.0,1.0
20640,Amori elementari,33333,0,33333,2014.csv,2014,0.0,1.0
20641,T.i.M,33321,0,33321,2018.csv,2018,0.0,1.0
20642,Shlyakhetni volotsyuhi,33316,0,33316,2018.csv,2018,0.0,1.0
20643,Original Bliss,33314,0,33314,2017.csv,2017,0.0,1.0
20644,Não Olhes,33302,0,33302,2018.csv,2018,0.0,1.0
20645,"Distant Voices, Still Lives 2018 Re-release",33301,5234,28067,2018.csv,2018,0.15717245728356505,0.8428275427164349
20646,Running from Crazy,33300,33300,0,2013.csv,2013,1.0,0.0
20647,Billionaire Ransom,33289,0,33289,2016.csv,2016,0.0,1.0
20648,Lal,33279,0,33279,2014.csv,2014,0.0,1.0
20649,I'll Be Around,33250,0,33250,2012.csv,2012,0.0,1.0
20650,Vaya,33246,0,33246,2017.csv,2017,0.0,1.0
20651,Put Ruzama Posut,33242,0,33242,2013.csv,2013,0.0,1.0
20652,The Veteran,33229,0,33229,2011.csv,2011,0.0,1.0
20653,Possum,33225,0,33225,2018.csv,2018,0.0,1.0
20654,Daddy Longlegs,33217,21766,11451,2010.csv,2010,0.6552668814161423,0.3447331185838577
20655,Ik Kudi Punjab Di,33211,0,33211,2010.csv,2010,0.0,1.0
20656,Wasted! The Story of Food Waste,33211,33211,0,2017.csv,2017,1.0,0.0
20657,Dangerous Vacation,33208,0,33208,2016.csv,2016,0.0,1.0
20658,Burning Heads,33206,0,33206,2011.csv,2011,0.0,1.0
20659,Miraç,33201,0,33201,2017.csv,2017,0.0,1.0
20660,Mapplethorpe: Look at the Pictures,33196,0,33196,2016.csv,2016,0.0,1.0
20661,Il pezzo mancante,33181,0,33181,2011.csv,2011,0.0,1.0
20662,Naomi,33179,0,33179,2011.csv,2011,0.0,1.0
20663,Repulsion,33174,0,33174,2013.csv,2013,0.0,1.0
20664,Portugal Não Está à Venda,33163,0,33163,2019.csv,2019,0.0,1.0
20665,Redoubt,33155,33155,0,2019.csv,2019,1.0,0.0
20666,Love & Taxes,33150,33150,0,2017.csv,2017,1.0,0.0
20667,Bambieffekten,33144,0,33144,2011.csv,2011,0.0,1.0
20668,American Teacher,33144,33144,0,2011.csv,2011,1.0,0.0
20669,Super Dark Times,33109,33109,0,2017.csv,2017,1.0,0.0
20670,I Never Cry,33099,0,33099,2020.csv,2020,0.0,1.0
20671,Meteler,33088,0,33088,2019.csv,2019,0.0,1.0
20672,Hanalei Bay,33076,0,33076,2019.csv,2019,0.0,1.0
20673,Mò Vi Mento - Lira di Achille,33074,0,33074,2019.csv,2019,0.0,1.0
20674,Dislecksia: The Movie,33066,33066,0,2013.csv,2013,1.0,0.0
20675,Priklyucheniya v tridesyatom tsarstve,33064,0,33064,2010.csv,2010,0.0,1.0
20676,Somebody Up There Likes Me,33056,0,33056,2019.csv,2019,0.0,1.0
20677,Madraza,33048,0,33048,2017.csv,2017,0.0,1.0
20678,Meet Monica Velour,33042,33042,0,2011.csv,2011,1.0,0.0
20679,Ahead of Time: The Extraordinary Journey of Ruth Gruber,33024,33024,0,2010.csv,2010,1.0,0.0
20680,Iskupleniye,33009,0,33009,2012.csv,2012,0.0,1.0
20681,Monument to Michael Jackson,32997,0,32997,2014.csv,2014,0.0,1.0
20682,Albatross,32992,0,32992,2011.csv,2011,0.0,1.0
20683,Tékasztorik,32988,0,32988,2017.csv,2017,0.0,1.0
20684,Like There's No Tomorrow,32969,0,32969,2019.csv,2019,0.0,1.0
20685,Being Charlie,32964,30400,2564,2016.csv,2016,0.9222181774056547,0.07778182259434535
20686,Cuando yo te vuelva a ver,32961,0,32961,2013.csv,2013,0.0,1.0
20687,Spoken Word,32961,32961,0,2010.csv,2010,1.0,0.0
20688,Youtopia,32955,0,32955,2018.csv,2018,0.0,1.0
20689,Singin' in the Rain 2019 Re-release,32925,0,32925,2019.csv,2019,0.0,1.0
20690,Ifrit'in Diyeti: Cinnia,32922,0,32922,2016.csv,2016,0.0,1.0
20691,The Intervention,32919,32919,0,2016.csv,2016,1.0,0.0
20692,Honeydew,32890,32890,0,2021.csv,2021,1.0,0.0
20693,Memories of Murder 2017 Re-release,32877,0,32877,2017.csv,2017,0.0,1.0
20694,June,32872,0,32872,2015.csv,2015,0.0,1.0
20695,Everything or Nothing,32863,0,32863,2012.csv,2012,0.0,1.0
20696,When I Was Alive,32857,0,32857,2014.csv,2014,0.0,1.0
20697,Superpower Dogs,32853,0,32853,2019.csv,2019,0.0,1.0
20698,Mega Monster Battle: Ultra Galaxy Legends - The Movie 2016 Re-release,32851,0,32851,2016.csv,2016,0.0,1.0
20699,Chitralahari,32849,0,32849,2019.csv,2019,0.0,1.0
20700,Yami no kodomo-tachi,32848,0,32848,2010.csv,2010,0.0,1.0
20701,Fighter,32838,0,32838,2021.csv,2021,0.0,1.0
20702,Abulele,32838,0,32838,2017.csv,2017,0.0,1.0
20703,One,32817,0,32817,2021.csv,2021,0.0,1.0
20704,Two Little Italians,32811,0,32811,2018.csv,2018,0.0,1.0
20705,Suurlemoen!,32805,0,32805,2014.csv,2014,0.0,1.0
20706,Hoffmaniada,32804,0,32804,2018.csv,2018,0.0,1.0
20707,Yej3alo Amer,32799,0,32799,2017.csv,2017,0.0,1.0
20708,Stitches,32784,0,32784,2019.csv,2019,0.0,1.0
20709,Cloud,32778,0,32778,2011.csv,2011,0.0,1.0
20710,Viditelny svet,32769,0,32769,2011.csv,2011,0.0,1.0
20711,The Enemy,32764,0,32764,2011.csv,2011,0.0,1.0
20712,"Kamal Joumblatt, Witness and Martyr",32762,0,32762,2015.csv,2015,0.0,1.0
20713,No Home Movie,32757,32757,0,2016.csv,2016,1.0,0.0
20714,First Night,32729,0,32729,2011.csv,2011,0.0,1.0
20715,My Geeky Girlfriend,32727,0,32727,2010.csv,2010,0.0,1.0
20716,Scotch: A Golden Dream,32707,0,32707,2019.csv,2019,0.0,1.0
20717,Hunter Hunter,32705,32705,0,2020.csv,2020,1.0,0.0
20718,Blindsided 2014 Re-release,32684,0,32684,2014.csv,2014,0.0,1.0
20719,The Nun,32659,30245,2414,2018.csv,2018,0.9260846933463976,0.07391530665360238
20720,El Candidato Obsoleta,32659,0,32659,2017.csv,2017,0.0,1.0
20721,Actually Quite a Lot,32659,0,32659,2016.csv,2016,0.0,1.0
20722,Evropa-Aziya,32658,0,32658,2010.csv,2010,0.0,1.0
20723,Giallo,32655,0,32655,2010.csv,2010,0.0,1.0
20724,The Birds 2019 Re-release,32655,0,32655,2019.csv,2019,0.0,1.0
20725,The Invisible Eye 2012 Re-release,32651,0,32651,2012.csv,2012,0.0,1.0
20726,Bloodlust Beauty,32649,0,32649,2020.csv,2020,0.0,1.0
20727,Footnotes,32626,0,32626,2016.csv,2016,0.0,1.0
20728,Sollers Point,32608,32608,0,2018.csv,2018,1.0,0.0
20729,Love Crime 2012 Re-release,32604,0,32604,2012.csv,2012,0.0,1.0
20730,Sangre blanca,32595,0,32595,2018.csv,2018,0.0,1.0
20731,The Cry of the Owl,32572,0,32572,2010.csv,2010,0.0,1.0
20732,The Day I Saw Your Heart 2012 Re-release,32567,3546,29021,2012.csv,2012,0.10888322535081524,0.8911167746491847
20733,The Tango Singer,32531,0,32531,2010.csv,2010,0.0,1.0
20734,The Atticus Institute,32521,0,32521,2015.csv,2015,0.0,1.0
20735,What If...? 2010 Re-release,32510,0,32510,2010.csv,2010,0.0,1.0
20736,Spettacolo,32494,32494,0,2017.csv,2017,1.0,0.0
20737,The Norseman,32487,0,32487,2015.csv,2015,0.0,1.0
20738,Boxing Gym,32476,32476,0,2010.csv,2010,1.0,0.0
20739,Banksy and the Rise of Outlaw Art,32471,0,32471,2020.csv,2020,0.0,1.0
20740,Atvirame kosmose (Vremya pervich),32455,0,32455,2017.csv,2017,0.0,1.0
20741,Rurouni Kenshin Part I: Origins 2016 Re-release,32445,32445,0,2016.csv,2016,1.0,0.0
20742,An Acceptable Loss,32427,32427,0,2019.csv,2019,1.0,0.0
20743,Brotherhood,32416,19722,12694,2010.csv,2010,0.6084032576505429,0.39159674234945707
20744,Landes,32415,0,32415,2013.csv,2013,0.0,1.0
20745,10E,32413,32413,0,2019.csv,2019,1.0,0.0
20746,Mr. Cheongsam,32405,0,32405,2018.csv,2018,0.0,1.0
20747,Geriye Kalan,32359,0,32359,2012.csv,2012,0.0,1.0
20748,El Fantasma de mi Novia,32352,0,32352,2018.csv,2018,0.0,1.0
20749,The Crawler,32346,0,32346,2020.csv,2020,0.0,1.0
20750,Strength and Honour 2010 Re-release,32342,0,32342,2010.csv,2010,0.0,1.0
20751,Tu me manques,32334,0,32334,2019.csv,2019,0.0,1.0
20752,Revolting Rhymes,32313,0,32313,2020.csv,2020,0.0,1.0
20753,Beetle Queen Conquers Tokyo,32308,32308,0,2010.csv,2010,1.0,0.0
20754,Seven Days,32308,0,32308,2016.csv,2016,0.0,1.0
20755,Return,32279,0,32279,2018.csv,2018,0.0,1.0
20756,Ash Flower,32275,0,32275,2017.csv,2017,0.0,1.0
20757,Embattled,32259,32259,0,2020.csv,2020,1.0,0.0
20758,Beauty and the Bestie,32245,0,32245,2016.csv,2016,0.0,1.0
20759,Ajab Gazabb Love,32242,0,32242,2012.csv,2012,0.0,1.0
20760,Solan og Ludvig - Jul i Flåklypa 2014 Re-release,32242,0,32242,2014.csv,2014,0.0,1.0
20761,Make Up,32229,0,32229,2020.csv,2020,0.0,1.0
20762,Traceless 2012 Re-release,32221,0,32221,2012.csv,2012,0.0,1.0
20763,Living in Emergency,32208,32208,0,2010.csv,2010,1.0,0.0
20764,Yellow Is Forbidden,32198,0,32198,2018.csv,2018,0.0,1.0
20765,Felix,32194,0,32194,2013.csv,2013,0.0,1.0
20766,Der Imker,32194,0,32194,2014.csv,2014,0.0,1.0
20767,The Hero of Color City,32188,32188,0,2014.csv,2014,1.0,0.0
20768,Hunting the Phantom,32182,0,32182,2015.csv,2015,0.0,1.0
20769,The Dead Man and Being Happy,32181,0,32181,2013.csv,2013,0.0,1.0
20770,The Metropolitan Opera HD Live: Bizet: Carmen,32160,0,32160,2019.csv,2019,0.0,1.0
20771,Mandy 2020 Re-release,32151,19169,12982,2020.csv,2020,0.5962178470343069,0.40378215296569314
20772,Goodland,32140,32140,0,2018.csv,2018,1.0,0.0
20773,Alien 2015 Re-release,32133,0,32133,2015.csv,2015,0.0,1.0
20774,Mel-Un,32098,0,32098,2016.csv,2016,0.0,1.0
20775,Maligno 2017 Re-release,32092,0,32092,2017.csv,2017,0.0,1.0
20776,Don't Open the Door,32060,0,32060,2016.csv,2016,0.0,1.0
20777,Sweet Valentine,32050,0,32050,2010.csv,2010,0.0,1.0
20778,Initial D: Final Stage,32040,0,32040,2014.csv,2014,0.0,1.0
20779,Max Richter's Sleep,32027,0,32027,2020.csv,2020,0.0,1.0
20780,Tharangam,32020,0,32020,2017.csv,2017,0.0,1.0
20781,Desolation Center,32016,32016,0,2019.csv,2019,1.0,0.0
20782,Fantastica,32011,0,32011,2019.csv,2019,0.0,1.0
20783,Reign of Assassins 2014 Re-release,31998,0,31998,2014.csv,2014,0.0,1.0
20784,"Rio, I Love You 2016 Re-release",31982,31982,0,2016.csv,2016,1.0,0.0
20785,Pettson & Findus - Katten och gubbens år 2015 Re-release,31974,0,31974,2015.csv,2015,0.0,1.0
20786,Moynihan,31970,31970,0,2018.csv,2018,1.0,0.0
20787,Autumn Gold,31966,0,31966,2010.csv,2010,0.0,1.0
20788,It Feels So Good,31965,0,31965,2020.csv,2020,0.0,1.0
20789,Zak Storm,31963,0,31963,2018.csv,2018,0.0,1.0
20790,Haus Tugendhat,31961,0,31961,2013.csv,2013,0.0,1.0
20791,District of Corruption,31954,31954,0,2012.csv,2012,1.0,0.0
20792,Mr. & Ms. Rowdy,31945,0,31945,2019.csv,2019,0.0,1.0
20793,Take Off 2011 Re-release,31941,0,31941,2011.csv,2011,0.0,1.0
20794,5 Centimeters Per Second 2019 Re-release,31941,0,31941,2019.csv,2019,0.0,1.0
20795,Shantet Hamza,31932,0,31932,2017.csv,2017,0.0,1.0
20796,Durak,31907,0,31907,2017.csv,2017,0.0,1.0
20797,Die Männer der Emden,31904,0,31904,2013.csv,2013,0.0,1.0
20798,The Nutcracker: The Untold Story 2015 Re-release,31901,0,31901,2015.csv,2015,0.0,1.0
20799,Melody,31889,0,31889,2015.csv,2015,0.0,1.0
20800,Shadows of Time 2012 Re-release,31881,0,31881,2012.csv,2012,0.0,1.0
20801,Websterovci 2: Zo Zivota Pavukov,31876,0,31876,2019.csv,2019,0.0,1.0
20802,Thelma,31869,0,31869,2011.csv,2011,0.0,1.0
20803,Pond Life,31858,0,31858,2019.csv,2019,0.0,1.0
20804,Amira & Sam,31849,31849,0,2015.csv,2015,1.0,0.0
20805,Global Shopping Village,31835,0,31835,2014.csv,2014,0.0,1.0
20806,Cantinflas 2016 Re-release,31830,0,31830,2016.csv,2016,0.0,1.0
20807,Dream of Shaoxing Opera,31822,0,31822,2019.csv,2019,0.0,1.0
20808,Centigrade,31808,16263,15545,2020.csv,2020,0.5112864688128773,0.48871353118712274
20809,Maximum Impact,31806,0,31806,2017.csv,2017,0.0,1.0
20810,Tsukiji Wonderland,31801,0,31801,2016.csv,2016,0.0,1.0
20811,Bug 2012 Re-release,31797,0,31797,2012.csv,2012,0.0,1.0
20812,Welcome to London,31794,0,31794,2012.csv,2012,0.0,1.0
20813,Akte Grüninger,31793,0,31793,2014.csv,2014,0.0,1.0
20814,Paths of the Soul,31747,31747,0,2016.csv,2016,1.0,0.0
20815,180° South,31745,31745,0,2010.csv,2010,1.0,0.0
20816,Master and Tatyana,31745,0,31745,2015.csv,2015,0.0,1.0
20817,The Hush 2010 Re-release,31743,0,31743,2010.csv,2010,0.0,1.0
20818,War Horse Nt Live,31737,0,31737,2020.csv,2020,0.0,1.0
20819,At Berkeley,31736,31736,0,2013.csv,2013,1.0,0.0
20820,The Gospel of Us,31721,0,31721,2012.csv,2012,0.0,1.0
20821,Yana+Yanko,31721,0,31721,2017.csv,2017,0.0,1.0
20822,Aurora,31720,5677,26043,2011.csv,2011,0.1789722572509458,0.8210277427490542
20823,The Coffin 2012 Re-release,31716,0,31716,2012.csv,2012,0.0,1.0
20824,Peixonauta: Agente Secreto Da O.s.t.r.a.,31708,0,31708,2012.csv,2012,0.0,1.0
20825,5 Dakkada Degisir Bütün Isler,31704,0,31704,2016.csv,2016,0.0,1.0
20826,Amerika Square,31703,0,31703,2017.csv,2017,0.0,1.0
20827,Peaceful Times,31703,0,31703,2010.csv,2010,0.0,1.0
20828,Yola Geldik,31698,0,31698,2016.csv,2016,0.0,1.0
20829,Bartok,31690,0,31690,2017.csv,2017,0.0,1.0
20830,Knuckle City,31683,0,31683,2020.csv,2020,0.0,1.0
20831,The Weight of Elephants,31679,0,31679,2013.csv,2013,0.0,1.0
20832,Reynir Sterki: Beyond Strength,31666,0,31666,2017.csv,2017,0.0,1.0
20833,Italian Movies,31658,0,31658,2013.csv,2013,0.0,1.0
20834,Mean Dreams,31657,0,31657,2017.csv,2017,0.0,1.0
20835,Keep My Words Forever,31653,0,31653,2015.csv,2015,0.0,1.0
20836,Doktor Martin: Záhada v Beskydech,31652,0,31652,2018.csv,2018,0.0,1.0
20837,"Botticelli, Florence And The Medici",31645,0,31645,2021.csv,2021,0.0,1.0
20838,The Institute,31634,0,31634,2017.csv,2017,0.0,1.0
20839,Hanni & Nanni 2011 Re-release,31600,0,31600,2011.csv,2011,0.0,1.0
20840,Gift,31588,31588,0,2019.csv,2019,1.0,0.0
20841,Operation Avalanche,31585,0,31585,2016.csv,2016,0.0,1.0
20842,Signature Move,31551,31551,0,2017.csv,2017,1.0,0.0
20843,The Cat Rescuers,31540,31540,0,2019.csv,2019,1.0,0.0
20844,The Passionate Thief,31539,31539,0,2014.csv,2014,1.0,0.0
20845,Adanga Maru,31533,0,31533,2018.csv,2018,0.0,1.0
20846,Painting the Modern Garden: Monet to Matisse,31516,0,31516,2016.csv,2016,0.0,1.0
20847,Últimos días en La Habana,31506,0,31506,2017.csv,2017,0.0,1.0
20848,On Happiness Road,31505,0,31505,2018.csv,2018,0.0,1.0
20849,Teraz i w godzine smierci 2019 Re-release,31494,0,31494,2019.csv,2019,0.0,1.0
20850,Váòa,31480,0,31480,2012.csv,2012,0.0,1.0
20851,Musical Chairs,31478,31478,0,2012.csv,2012,1.0,0.0
20852,Celine and Julie Go Boating,31452,31452,0,2012.csv,2012,1.0,0.0
20853,Noise 2010 Re-release,31444,0,31444,2010.csv,2010,0.0,1.0
20854,Bethany,31442,0,31442,2017.csv,2017,0.0,1.0
20855,Wol-Seong,31435,0,31435,2019.csv,2019,0.0,1.0
20856,Beyond the Farthest Star,31433,31433,0,2013.csv,2013,1.0,0.0
20857,Here,31428,26743,4685,2012.csv,2012,0.8509291078019601,0.14907089219803996
20858,Dominika,31428,0,31428,2018.csv,2018,0.0,1.0
20859,Sidemen: Long Road to Glory,31399,31399,0,2017.csv,2017,1.0,0.0
20860,Mules,31384,0,31384,2018.csv,2018,0.0,1.0
20861,Outreach Connection: HUGS (Hearts United in God's Service),31384,0,31384,2016.csv,2016,0.0,1.0
20862,Lur eta Amets,31344,0,31344,2020.csv,2020,0.0,1.0
20863,"Hello, My Cat",31342,0,31342,2019.csv,2019,0.0,1.0
20864,New Oriental God Doll,31326,0,31326,2016.csv,2016,0.0,1.0
20865,Bright Flight,31323,0,31323,2012.csv,2012,0.0,1.0
20866,Downhill,31314,0,31314,2014.csv,2014,0.0,1.0
20867,Don Verdean,31309,31309,0,2015.csv,2015,1.0,0.0
20868,Rigodon,31307,0,31307,2012.csv,2012,0.0,1.0
20869,Ikona sezona,31301,0,31301,2013.csv,2013,0.0,1.0
20870,Un giorno all'improvviso,31298,0,31298,2018.csv,2018,0.0,1.0
20871,June and Arrow,31290,0,31290,2017.csv,2017,0.0,1.0
20872,Deep Rivers,31285,0,31285,2018.csv,2018,0.0,1.0
20873,"Giselle Roh, London",31283,0,31283,2020.csv,2020,0.0,1.0
20874,Tofu 2019 Re-release,31280,0,31280,2019.csv,2019,0.0,1.0
20875,The Unseen 2019 Re-release,31279,0,31279,2019.csv,2019,0.0,1.0
20876,Motorhead - Clean Your Clock,31277,0,31277,2018.csv,2018,0.0,1.0
20877,Bahtiyar Bahtikara,31275,0,31275,2017.csv,2017,0.0,1.0
20878,Gonchi la película,31261,0,31261,2015.csv,2015,0.0,1.0
20879,Jogo de Damas,31259,0,31259,2016.csv,2016,0.0,1.0
20880,Channo Kamli Yaar Di 2016 Re-release,31217,0,31217,2016.csv,2016,0.0,1.0
20881,Buddy,31203,31203,0,2019.csv,2019,1.0,0.0
20882,How to Change the World,31191,0,31191,2015.csv,2015,0.0,1.0
20883,Radha,31172,0,31172,2017.csv,2017,0.0,1.0
20884,Wolf,31154,0,31154,2019.csv,2019,0.0,1.0
20885,I WeirDO,31137,0,31137,2020.csv,2020,0.0,1.0
20886,"Hey, Boo: Harper Lee and 'To Kill a Mockingbird'",31135,31135,0,2011.csv,2011,1.0,0.0
20887,Small Town Murder Songs,31133,31133,0,2011.csv,2011,1.0,0.0
20888,Dunderland,31122,0,31122,2012.csv,2012,0.0,1.0
20889,The Super Parental Guardians,31108,0,31108,2016.csv,2016,0.0,1.0
20890,Virus Tropical,31100,0,31100,2018.csv,2018,0.0,1.0
20891,7 Witches,31100,31100,0,2017.csv,2017,1.0,0.0
20892,Dogman's Rabies,31086,0,31086,2018.csv,2018,0.0,1.0
20893,Lajka,31081,0,31081,2017.csv,2017,0.0,1.0
20894,Pasaje de vida,31080,0,31080,2015.csv,2015,0.0,1.0
20895,The Silence Before Bach 2010 Re-release,31071,0,31071,2010.csv,2010,0.0,1.0
20896,White Irish Drinkers,31056,31056,0,2011.csv,2011,1.0,0.0
20897,Atlit 2016 Re-release,31053,0,31053,2016.csv,2016,0.0,1.0
20898,Rent-A-Pal,31053,30901,152,2020.csv,2020,0.9951051428203395,0.0048948571796605805
20899,Hamlet 2010 Re-release,31033,0,31033,2010.csv,2010,0.0,1.0
20900,Poor Boy,31031,31031,0,2018.csv,2018,1.0,0.0
20901,Shiva Baby,31014,31014,0,2021.csv,2021,1.0,0.0
20902,Gremlins 2017 Re-release,31011,0,31011,2017.csv,2017,0.0,1.0
20903,¿Quién mató a Mariano Ferreyra?,30998,0,30998,2013.csv,2013,0.0,1.0
20904,Defying Chase,30994,0,30994,2018.csv,2018,0.0,1.0
20905,"2 Autumns, 3 Winters",30985,5819,25166,2014.csv,2014,0.18780054865257384,0.8121994513474262
20906,Harry Potter and the Sorcerer's Stone 2016 Re-release,30980,0,30980,2016.csv,2016,0.0,1.0
20907,The Seventh Fire,30977,30112,865,2016.csv,2016,0.9720760564289634,0.027923943571036575
20908,Who Is Harry Nilsson (And Why Is Everybody Talkin' About Him?),30975,30975,0,2010.csv,2010,1.0,0.0
20909,Veleno,30968,0,30968,2017.csv,2017,0.0,1.0
20910,The Treasure 2,30961,0,30961,2019.csv,2019,0.0,1.0
20911,Goodbye Summer,30949,0,30949,2019.csv,2019,0.0,1.0
20912,The Glorias,30940,0,30940,2020.csv,2020,0.0,1.0
20913,The Hammer,30929,0,30929,2013.csv,2013,0.0,1.0
20914,Makate Must Sell,30927,0,30927,2019.csv,2019,0.0,1.0
20915,Vindaloo Empire,30906,0,30906,2011.csv,2011,0.0,1.0
20916,Return to Montauk 2019 Re-release,30892,0,30892,2019.csv,2019,0.0,1.0
20917,Ara Malikian: una vida entre las cuerdas,30877,0,30877,2019.csv,2019,0.0,1.0
20918,Sem Pena,30874,0,30874,2014.csv,2014,0.0,1.0
20919,Irandam Ulagam,30868,0,30868,2013.csv,2013,0.0,1.0
20920,All Roads Lead to Rome 2017 Re-release,30861,0,30861,2017.csv,2017,0.0,1.0
20921,With Love,30851,0,30851,2010.csv,2010,0.0,1.0
20922,Lamb,30844,14547,16297,2016.csv,2016,0.47163143561146414,0.5283685643885359
20923,Gnarr,30830,0,30830,2010.csv,2010,0.0,1.0
20924,La Belle Indifference,30816,0,30816,2019.csv,2019,0.0,1.0
20925,Meet the Fokkens,30810,30810,0,2012.csv,2012,1.0,0.0
20926,Hayatta Olmaz,30791,0,30791,2019.csv,2019,0.0,1.0
20927,Don't Look Back,30780,0,30780,2020.csv,2020,0.0,1.0
20928,The Woods Are Still Green,30759,0,30759,2014.csv,2014,0.0,1.0
20929,Pasolini 2019 Re-release,30757,30757,0,2019.csv,2019,1.0,0.0
20930,Let's Make Money 2011 Re-release,30746,0,30746,2011.csv,2011,0.0,1.0
20931,Source of Dreams,30744,0,30744,2018.csv,2018,0.0,1.0
20932,The 13th Friday,30711,0,30711,2019.csv,2019,0.0,1.0
20933,Intimissimi on Ice,30691,0,30691,2018.csv,2018,0.0,1.0
20934,Two Tails 2020 Re-release,30689,0,30689,2020.csv,2020,0.0,1.0
20935,Sapi,30688,0,30688,2013.csv,2013,0.0,1.0
20936,4 Models for the Devil,30680,0,30680,2012.csv,2012,0.0,1.0
20937,Princess Mononoke 2017 Re-release,30667,0,30667,2017.csv,2017,0.0,1.0
20938,Documented,30662,30662,0,2014.csv,2014,1.0,0.0
20939,Hide Away,30655,30655,0,2012.csv,2012,1.0,0.0
20940,Red Army Primary School,30652,0,30652,2017.csv,2017,0.0,1.0
20941,The Factory,30640,0,30640,2014.csv,2014,0.0,1.0
20942,Love on a Wkend,30615,0,30615,2010.csv,2010,0.0,1.0
20943,10 Endrathukulla,30598,0,30598,2015.csv,2015,0.0,1.0
20944,Leviano,30592,0,30592,2018.csv,2018,0.0,1.0
20945,L'affare Bonnard,30573,0,30573,2011.csv,2011,0.0,1.0
20946,Mara and the Firebringer,30549,0,30549,2015.csv,2015,0.0,1.0
20947,Cabaret Maxime,30541,0,30541,2018.csv,2018,0.0,1.0
20948,The Chaperone,30514,0,30514,2011.csv,2011,0.0,1.0
20949,Ganges,30496,0,30496,2019.csv,2019,0.0,1.0
20950,Adam's Village,30496,0,30496,2010.csv,2010,0.0,1.0
20951,Guaraní,30487,0,30487,2016.csv,2016,0.0,1.0
20952,Il colpo del cane,30473,0,30473,2019.csv,2019,0.0,1.0
20953,After Parkland,30444,30444,0,2020.csv,2020,1.0,0.0
20954,Gauguin a Tahiti. Il paradiso perduto,30439,0,30439,2020.csv,2020,0.0,1.0
20955,Vanity,30432,0,30432,2016.csv,2016,0.0,1.0
20956,Solo 2017 Re-release,30428,0,30428,2017.csv,2017,0.0,1.0
20957,London Assurance,30427,0,30427,2010.csv,2010,0.0,1.0
20958,Los Reyes,30418,30418,0,2019.csv,2019,1.0,0.0
20959,Dealt,30414,30414,0,2017.csv,2017,1.0,0.0
20960,These Birds Walk,30408,30408,0,2013.csv,2013,1.0,0.0
20961,Thirty,30389,0,30389,2020.csv,2020,0.0,1.0
20962,"Defend, Conserve, Protect",30384,0,30384,2019.csv,2019,0.0,1.0
20963,Avé,30380,0,30380,2012.csv,2012,0.0,1.0
20964,"Hare Krishna! The Mantra, the Movement and the Swami Who Started It 2017 Re-release",30380,19278,11102,2017.csv,2017,0.6345622119815668,0.3654377880184332
20965,Shanghai Red 2010 Re-release,30353,30353,0,2010.csv,2010,1.0,0.0
20966,Heavy Trip,30351,10153,20198,2018.csv,2018,0.33451945570162434,0.6654805442983757
20967,Secrets in the Hot Spring,30337,0,30337,2018.csv,2018,0.0,1.0
20968,Happy Christmas,30312,30312,0,2014.csv,2014,1.0,0.0
20969,Sol Serit,30309,0,30309,2016.csv,2016,0.0,1.0
20970,Delhi Dance,30292,0,30292,2012.csv,2012,0.0,1.0
20971,Broken Horses,30288,0,30288,2015.csv,2015,0.0,1.0
20972,Feast 2010 Re-release,30281,0,30281,2010.csv,2010,0.0,1.0
20973,Amavas,30271,0,30271,2019.csv,2019,0.0,1.0
20974,No Greater Love,30247,30247,0,2017.csv,2017,1.0,0.0
20975,Far Cry 2014 Re-release,30237,0,30237,2014.csv,2014,0.0,1.0
20976,Underage,30236,0,30236,2014.csv,2014,0.0,1.0
20977,Cin Tepesi,30217,0,30217,2018.csv,2018,0.0,1.0
20978,Black and White Stripes: The Juventus Story,30213,0,30213,2017.csv,2017,0.0,1.0
20979,Cold Water,30209,30209,0,2018.csv,2018,1.0,0.0
20980,Army of Shadows 2015 Re-release,30190,30190,0,2015.csv,2015,1.0,0.0
20981,Runoff,30186,30186,0,2015.csv,2015,1.0,0.0
20982,Letters from Antarctica,30177,0,30177,2019.csv,2019,0.0,1.0
20983,Paul Taylor: Creative Domain,30168,30168,0,2015.csv,2015,1.0,0.0
20984,The Red Shoes 2010 Re-release,30165,0,30165,2010.csv,2010,0.0,1.0
20985,A puerta fría,30163,0,30163,2013.csv,2013,0.0,1.0
20986,Southern Baptist Sissies,30160,30160,0,2014.csv,2014,1.0,0.0
20987,In My Sleep,30158,30158,0,2010.csv,2010,1.0,0.0
20988,Egy kupac kufli,30150,0,30150,2017.csv,2017,0.0,1.0
20989,Adithya Varma,30148,0,30148,2019.csv,2019,0.0,1.0
20990,Cherrybomb,30143,0,30143,2011.csv,2011,0.0,1.0
20991,Assassination Classroom: The Graduation 2017 Re-release,30129,0,30129,2017.csv,2017,0.0,1.0
20992,North Sea Texas,30129,0,30129,2011.csv,2011,0.0,1.0
20993,The Life and Death of Colonel Blimp,30129,0,30129,2012.csv,2012,0.0,1.0
20994,Iki,30125,0,30125,2017.csv,2017,0.0,1.0
20995,2001: A Space Odyssey 2019 Re-release,30124,0,30124,2019.csv,2019,0.0,1.0
20996,Lionel Richie at Glastonbury,30123,30123,0,2019.csv,2019,1.0,0.0
20997,Therapy for a Vampire 2016 Re-release,30115,30115,0,2016.csv,2016,1.0,0.0
20998,Ultra,30111,0,30111,2017.csv,2017,0.0,1.0
20999,A Long Way Off,30104,30104,0,2014.csv,2014,1.0,0.0
21000,Accident 2017 Re-release,30096,0,30096,2017.csv,2017,0.0,1.0
21001,Living Universe,30038,0,30038,2018.csv,2018,0.0,1.0
21002,Manakamana,30029,30029,0,2014.csv,2014,1.0,0.0
21003,Armen and Me: Armeniya,30027,0,30027,2019.csv,2019,0.0,1.0
21004,Dark Floors 2012 Re-release,30024,0,30024,2012.csv,2012,0.0,1.0
21005,Keeper,30010,0,30010,2016.csv,2016,0.0,1.0
21006,La llegenda de l'innombrable,30006,0,30006,2010.csv,2010,0.0,1.0
21007,Cat Run,30000,30000,0,2011.csv,2011,1.0,0.0
21008,Between Land and Sea,29997,0,29997,2018.csv,2018,0.0,1.0
21009,Svideteli,29990,0,29990,2018.csv,2018,0.0,1.0
21010,What Isn't There,29977,0,29977,2012.csv,2012,0.0,1.0
21011,The Journey of Karma,29973,0,29973,2018.csv,2018,0.0,1.0
21012,Pulp Fiction 2020 Re-release,29961,0,29961,2020.csv,2020,0.0,1.0
21013,Sher Dil,29961,0,29961,2019.csv,2019,0.0,1.0
21014,The Conformist 2016 Re-release,29953,0,29953,2016.csv,2016,0.0,1.0
21015,Rocco,29950,0,29950,2017.csv,2017,0.0,1.0
21016,Where in the World Is Osama Bin Laden? 2010 Re-release,29947,0,29947,2010.csv,2010,0.0,1.0
21017,Sarikamis Cocuklari,29945,0,29945,2017.csv,2017,0.0,1.0
21018,Arth,29938,0,29938,2017.csv,2017,0.0,1.0
21019,Made in Italy 2019 Re-release,29930,0,29930,2019.csv,2019,0.0,1.0
21020,Hassal Khier,29926,0,29926,2012.csv,2012,0.0,1.0
21021,Margarita,29908,0,29908,2016.csv,2016,0.0,1.0
21022,Evidence of a Haunting,29904,29904,0,2011.csv,2011,1.0,0.0
21023,Kilian Jornet: Path to Everest,29898,0,29898,2019.csv,2019,0.0,1.0
21024,Saint Misbehavin': The Wavy Gravy Movie,29893,29893,0,2010.csv,2010,1.0,0.0
21025,Drib,29882,0,29882,2017.csv,2017,0.0,1.0
21026,Lbs.,29866,29866,0,2010.csv,2010,1.0,0.0
21027,Brother 2012 Re-release,29864,29864,0,2012.csv,2012,1.0,0.0
21028,Long Shot: The Kevin Laue Story 2013 Re-release,29863,29863,0,2013.csv,2013,1.0,0.0
21029,The Buried Secret,29847,0,29847,2015.csv,2015,0.0,1.0
21030,Pulsar,29825,0,29825,2011.csv,2011,0.0,1.0
21031,A Fierce Green Fire: The Battle for A Living Planet,29817,29817,0,2013.csv,2013,1.0,0.0
21032,Tehlikeyle Flört,29795,0,29795,2015.csv,2015,0.0,1.0
21033,Tokyo Taxi,29776,0,29776,2010.csv,2010,0.0,1.0
21034,The Curse of Sleeping Beauty 2017 Re-release,29764,0,29764,2017.csv,2017,0.0,1.0
21035,Elefant,29759,0,29759,2019.csv,2019,0.0,1.0
21036,Tampoco Tan Grandes,29747,0,29747,2019.csv,2019,0.0,1.0
21037,Uncertain,29736,29736,0,2017.csv,2017,1.0,0.0
21038,Multiple Sarcasms,29731,29731,0,2010.csv,2010,1.0,0.0
21039,Sseon-ki-seu Pae-mil-li,29725,0,29725,2019.csv,2019,0.0,1.0
21040,Thondan,29715,0,29715,2017.csv,2017,0.0,1.0
21041,SMTown: The Stage,29713,0,29713,2015.csv,2015,0.0,1.0
21042,Yellow Day,29656,29656,0,2014.csv,2014,1.0,0.0
21043,Memories of Underdevelopment 2018 Re-release,29647,29647,0,2018.csv,2018,1.0,0.0
21044,Formentera Lady,29647,0,29647,2018.csv,2018,0.0,1.0
21045,The Perfect Race,29644,29644,0,2019.csv,2019,1.0,0.0
21046,A Good Man 2014 Re-release,29640,0,29640,2014.csv,2014,0.0,1.0
21047,Rural Summer Vacation,29637,0,29637,2019.csv,2019,0.0,1.0
21048,Dead Man's Burden,29634,29634,0,2013.csv,2013,1.0,0.0
21049,Rev,29633,0,29633,2020.csv,2020,0.0,1.0
21050,The Hunting Party 2012 Re-release,29624,0,29624,2012.csv,2012,0.0,1.0
21051,A1,29620,0,29620,2019.csv,2019,0.0,1.0
21052,22nd Catch,29614,0,29614,2016.csv,2016,0.0,1.0
21053,Elvis: That's the Way It Is 2020 Re-release,29603,0,29603,2020.csv,2020,0.0,1.0
21054,Bravo! Jazz Life,29603,0,29603,2010.csv,2010,0.0,1.0
21055,Concerto: A Beethoven Journey,29598,0,29598,2016.csv,2016,0.0,1.0
21056,Black & White Episode 1: The Dawn of Assault,29592,0,29592,2012.csv,2012,0.0,1.0
21057,Countdown,29574,0,29574,2017.csv,2017,0.0,1.0
21058,Namatjira Project,29572,0,29572,2017.csv,2017,0.0,1.0
21059,La Vigilia,29562,0,29562,2010.csv,2010,0.0,1.0
21060,Dünya Hali,29558,0,29558,2018.csv,2018,0.0,1.0
21061,Counters,29554,0,29554,2018.csv,2018,0.0,1.0
21062,Yabanci 2015 Re-release,29550,0,29550,2015.csv,2015,0.0,1.0
21063,Veeram,29541,0,29541,2017.csv,2017,0.0,1.0
21064,The Eyes of My Mother,29539,27099,2440,2016.csv,2016,0.9173973391110057,0.0826026608889942
21065,Dragon Force,29539,0,29539,2016.csv,2016,0.0,1.0
21066,Oltre il mare,29525,0,29525,2011.csv,2011,0.0,1.0
21067,One More Dream,29524,0,29524,2012.csv,2012,0.0,1.0
21068,Little Fugitive 2013 Re-release,29505,29505,0,2013.csv,2013,1.0,0.0
21069,Wide Open Sky,29504,0,29504,2016.csv,2016,0.0,1.0
21070,The Best Democracy Money Can Buy,29500,29500,0,2016.csv,2016,1.0,0.0
21071,The Dog Wedding,29495,29495,0,2016.csv,2016,1.0,0.0
21072,Slava's Snowshow,29493,0,29493,2012.csv,2012,0.0,1.0
21073,Four Lovers 2012 Re-release,29482,0,29482,2012.csv,2012,0.0,1.0
21074,Marriage Palace,29478,0,29478,2018.csv,2018,0.0,1.0
21075,The Wonders 2018 Re-release,29466,0,29466,2018.csv,2018,0.0,1.0
21076,Emicem Hospital,29454,0,29454,2016.csv,2016,0.0,1.0
21077,Cholitas,29451,0,29451,2020.csv,2020,0.0,1.0
21078,Olympic Dreams,29450,29450,0,2020.csv,2020,1.0,0.0
21079,Master Returns,29445,0,29445,2018.csv,2018,0.0,1.0
21080,Here Comes the Rain,29432,0,29432,2011.csv,2011,0.0,1.0
21081,Obsessive Rhythms,29422,0,29422,2014.csv,2014,0.0,1.0
21082,Bunch of Kunst,29420,0,29420,2017.csv,2017,0.0,1.0
21083,Our Body,29420,0,29420,2019.csv,2019,0.0,1.0
21084,On the Quiet,29395,0,29395,2019.csv,2019,0.0,1.0
21085,Mapplethorpe: Look at the Pictures 2018 Re-release,29391,0,29391,2018.csv,2018,0.0,1.0
21086,Redemption Road,29384,29384,0,2011.csv,2011,1.0,0.0
21087,Let Us Prey,29383,0,29383,2015.csv,2015,0.0,1.0
21088,Dracula 3D 2015 Re-release,29354,0,29354,2015.csv,2015,0.0,1.0
21089,The Godfather 2014 Re-release,29349,0,29349,2014.csv,2014,0.0,1.0
21090,Snowing Indicate Harvest,29343,0,29343,2019.csv,2019,0.0,1.0
21091,Cousin Jules,29337,29337,0,2013.csv,2013,1.0,0.0
21092,Charm City,29335,29335,0,2018.csv,2018,1.0,0.0
21093,Happy Sardar,29319,0,29319,2019.csv,2019,0.0,1.0
21094,Forse è solo mal di mare,29319,0,29319,2019.csv,2019,0.0,1.0
21095,Last Breath,29319,0,29319,2019.csv,2019,0.0,1.0
21096,The Topp Twins: Untouchable Girls 2011 Re-release,29316,29316,0,2011.csv,2011,1.0,0.0
21097,Tut Sözünü,29301,0,29301,2015.csv,2015,0.0,1.0
21098,El pequeño mago,29298,0,29298,2013.csv,2013,0.0,1.0
21099,Stúlkurnar frá Kleppjárnsreykjum,29283,0,29283,2015.csv,2015,0.0,1.0
21100,Out of Innocence,29267,0,29267,2019.csv,2019,0.0,1.0
21101,Victim,29266,0,29266,2012.csv,2012,0.0,1.0
21102,Lullaby Ride,29265,0,29265,2012.csv,2012,0.0,1.0
21103,Lemon,29258,29258,0,2017.csv,2017,1.0,0.0
21104,Back to Your Arms,29258,0,29258,2010.csv,2010,0.0,1.0
21105,The Ground Beneath My Feet,29251,29251,0,2019.csv,2019,1.0,0.0
21106,Rag Union,29242,0,29242,2016.csv,2016,0.0,1.0
21107,Pax,29240,0,29240,2011.csv,2011,0.0,1.0
21108,Living and Knowing You're Alive,29233,0,29233,2019.csv,2019,0.0,1.0
21109,Time to Choose,29233,29233,0,2016.csv,2016,1.0,0.0
21110,The Invader,29232,0,29232,2011.csv,2011,0.0,1.0
21111,My Fair Lady 2016 Re-release,29223,0,29223,2016.csv,2016,0.0,1.0
21112,The Sanctuary 2010 Re-release,29203,0,29203,2010.csv,2010,0.0,1.0
21113,Dartmoor Killing,29198,0,29198,2015.csv,2015,0.0,1.0
21114,Morir,29189,0,29189,2017.csv,2017,0.0,1.0
21115,Fukuoka,29170,0,29170,2020.csv,2020,0.0,1.0
21116,Plastic 2015 Re-release,29159,0,29159,2015.csv,2015,0.0,1.0
21117,At Middleton 2015 Re-release,29156,0,29156,2015.csv,2015,0.0,1.0
21118,Annadurai,29144,0,29144,2017.csv,2017,0.0,1.0
21119,Kusursuzlar,29139,0,29139,2014.csv,2014,0.0,1.0
21120,Son Of Manjeet Singh,29134,0,29134,2018.csv,2018,0.0,1.0
21121,Yen's Life,29125,0,29125,2016.csv,2016,0.0,1.0
21122,Buffaloed,29118,29118,0,2020.csv,2020,1.0,0.0
21123,Everyone Is Psychic!: The Movie,29117,0,29117,2015.csv,2015,0.0,1.0
21124,Dilsiz,29105,0,29105,2019.csv,2019,0.0,1.0
21125,Three Day Two Night,29095,0,29095,2012.csv,2012,0.0,1.0
21126,Chucks,29090,0,29090,2015.csv,2015,0.0,1.0
21127,Melody for a Street Organ,29087,0,29087,2010.csv,2010,0.0,1.0
21128,Go Go Tales 2012 Re-release,29086,0,29086,2012.csv,2012,0.0,1.0
21129,Magický hlas rebelky,29081,0,29081,2014.csv,2014,0.0,1.0
21130,I Need a Man,29080,0,29080,2013.csv,2013,0.0,1.0
21131,Spice Boyz,29068,0,29068,2020.csv,2020,0.0,1.0
21132,The Strayed,29037,0,29037,2017.csv,2017,0.0,1.0
21133,Jumbo,29001,0,29001,2020.csv,2020,0.0,1.0
21134,Vincent Van Gogh: A New Way of Seeing,29001,0,29001,2017.csv,2017,0.0,1.0
21135,Norwegian Wood 2013 Re-release,28998,0,28998,2013.csv,2013,0.0,1.0
21136,Khaidi No. 150,28995,0,28995,2017.csv,2017,0.0,1.0
21137,Fire in the Blood,28994,28994,0,2013.csv,2013,1.0,0.0
21138,Othello,28980,28980,0,2014.csv,2014,1.0,0.0
21139,Gang Preed Ja Read Jai Thoe,28978,0,28978,2014.csv,2014,0.0,1.0
21140,Katherine Jenkins Christmas Spectacular,28975,0,28975,2020.csv,2020,0.0,1.0
21141,Martha: A Picture Story,28971,0,28971,2019.csv,2019,0.0,1.0
21142,Magic,28968,0,28968,2010.csv,2010,0.0,1.0
21143,Days of Heaven 2011 Re-release,28953,0,28953,2011.csv,2011,0.0,1.0
21144,Distorted,28951,0,28951,2018.csv,2018,0.0,1.0
21145,Freaky Ali,28940,0,28940,2016.csv,2016,0.0,1.0
21146,"Faith, Love + Whiskey",28928,0,28928,2013.csv,2013,0.0,1.0
21147,"Fontanarrosa, a Real Idol",28905,0,28905,2017.csv,2017,0.0,1.0
21148,The Secret of Happiness,28893,0,28893,2018.csv,2018,0.0,1.0
21149,Strange Birds,28874,0,28874,2017.csv,2017,0.0,1.0
21150,Las Ineses,28873,0,28873,2016.csv,2016,0.0,1.0
21151,Being 14,28870,0,28870,2015.csv,2015,0.0,1.0
21152,Plush,28864,3080,25784,2013.csv,2013,0.10670731707317073,0.8932926829268293
21153,Planning of be in Love,28855,0,28855,2017.csv,2017,0.0,1.0
21154,Omega,28845,0,28845,2016.csv,2016,0.0,1.0
21155,The Woman Who Dreamed of a Man 2011 Re-release,28842,0,28842,2011.csv,2011,0.0,1.0
21156,Stuk!,28839,0,28839,2014.csv,2014,0.0,1.0
21157,"Tulipani: Liefde, eer en een fiets 2019 Re-release",28822,0,28822,2019.csv,2019,0.0,1.0
21158,Two in the Wave,28808,28808,0,2010.csv,2010,1.0,0.0
21159,Zarafa 2015 Re-release,28805,0,28805,2015.csv,2015,0.0,1.0
21160,Batman & Robin 2019 Re-release,28793,28597,196,2019.csv,2019,0.9931927899142152,0.00680721008578474
21161,Rebels of the Neon God,28791,28791,0,2015.csv,2015,1.0,0.0
21162,Americons,28782,28782,0,2015.csv,2015,1.0,0.0
21163,Frantisek je devkar 2010 Re-release,28776,0,28776,2010.csv,2010,0.0,1.0
21164,Viski s molokom,28772,0,28772,2011.csv,2011,0.0,1.0
21165,Even When I Fall,28771,0,28771,2018.csv,2018,0.0,1.0
21166,Rise Up! And Dance,28728,0,28728,2014.csv,2014,0.0,1.0
21167,The Snowman and the Snowdog,28727,0,28727,2018.csv,2018,0.0,1.0
21168,Iblis: Esir-i Beden,28714,0,28714,2019.csv,2019,0.0,1.0
21169,Rewrite: The Promise I Made with You,28713,0,28713,2016.csv,2016,0.0,1.0
21170,Jefe,28701,0,28701,2018.csv,2018,0.0,1.0
21171,Nénette,28699,18009,10690,2010.csv,2010,0.627513153768424,0.372486846231576
21172,Hitler's Children,28663,28663,0,2012.csv,2012,1.0,0.0
21173,Uncle,28662,0,28662,2020.csv,2020,0.0,1.0
21174,Abe,28657,0,28657,2020.csv,2020,0.0,1.0
21175,The Debt Collector,28645,0,28645,2019.csv,2019,0.0,1.0
21176,Sex.Violence.FamilyValues.,28640,0,28640,2013.csv,2013,0.0,1.0
21177,Slon (Elephant),28637,0,28637,2012.csv,2012,0.0,1.0
21178,The Transfiguration,28631,22091,6540,2017.csv,2017,0.771576263490622,0.22842373650937794
21179,El Pampero,28621,0,28621,2017.csv,2017,0.0,1.0
21180,1938 - Diversi,28611,0,28611,2018.csv,2018,0.0,1.0
21181,The Hunter,28608,0,28608,2011.csv,2011,0.0,1.0
21182,Dva bileta domoy,28580,0,28580,2018.csv,2018,0.0,1.0
21183,Garbo: El espía 2011 Re-release,28563,28563,0,2011.csv,2011,1.0,0.0
21184,The Ballymurphy Precedent,28563,0,28563,2018.csv,2018,0.0,1.0
21185,My Hero Academia,28557,0,28557,2020.csv,2020,0.0,1.0
21186,Restoring Tomorrow,28556,28556,0,2018.csv,2018,1.0,0.0
21187,A Tale of Shadows,28551,0,28551,2017.csv,2017,0.0,1.0
21188,An Autumn Afternoon,28538,0,28538,2013.csv,2013,0.0,1.0
21189,Goddess Times,28535,0,28535,2016.csv,2016,0.0,1.0
21190,Check In Shock,28528,0,28528,2020.csv,2020,0.0,1.0
21191,Anatakan,28521,0,28521,2015.csv,2015,0.0,1.0
21192,Stations of the Elevated,28516,28516,0,2014.csv,2014,1.0,0.0
21193,The Final,28491,0,28491,2013.csv,2013,0.0,1.0
21194,Estomago: A Gastronomic Story 2010 Re-release,28466,0,28466,2010.csv,2010,0.0,1.0
21195,Lisa,28436,0,28436,2017.csv,2017,0.0,1.0
21196,The Metropolitan Opera HD Live: Puccini: Turandot 2013 Re-release,28436,0,28436,2013.csv,2013,0.0,1.0
21197,Carrie Pilby,28430,18957,9473,2017.csv,2017,0.6667956384101301,0.3332043615898699
21198,When Day Breaks,28419,0,28419,2012.csv,2012,0.0,1.0
21199,Doctor Who: The Husbands of River Song,28418,0,28418,2015.csv,2015,0.0,1.0
21200,"Rabin, the Last Day",28411,28411,0,2016.csv,2016,1.0,0.0
21201,The Load,28410,28410,0,2019.csv,2019,1.0,0.0
21202,La Tropa de Trapo en la selva del arcoiris,28399,0,28399,2014.csv,2014,0.0,1.0
21203,Struck by Lightning,28378,28378,0,2013.csv,2013,1.0,0.0
21204,The Strange Ones,28374,0,28374,2017.csv,2017,0.0,1.0
21205,Manam,28369,0,28369,2014.csv,2014,0.0,1.0
21206,Lost Highway 2017 Re-release,28347,0,28347,2017.csv,2017,0.0,1.0
21207,Willkommen bei Habib,28345,0,28345,2014.csv,2014,0.0,1.0
21208,Terra Bruciata! - Scorched Earth!,28334,0,28334,2018.csv,2018,0.0,1.0
21209,North Sea Texas 2012 Re-release,28307,28307,0,2012.csv,2012,1.0,0.0
21210,Rum 213,28291,0,28291,2017.csv,2017,0.0,1.0
21211,A Field Day,28277,0,28277,2018.csv,2018,0.0,1.0
21212,Dessine-toi...,28270,0,28270,2011.csv,2011,0.0,1.0
21213,From the Ashes,28269,0,28269,2011.csv,2011,0.0,1.0
21214,Che: Part Two 2018 Re-release,28268,0,28268,2018.csv,2018,0.0,1.0
21215,The Garden of Numbers,28250,0,28250,2017.csv,2017,0.0,1.0
21216,Arabian Nights: Volume 1 - The Restless One,28245,12260,15985,2015.csv,2015,0.43405912550893966,0.5659408744910603
21217,Off Karadeniz,28241,0,28241,2010.csv,2010,0.0,1.0
21218,Chamak,28235,0,28235,2018.csv,2018,0.0,1.0
21219,Amy,28232,0,28232,2014.csv,2014,0.0,1.0
21220,Growing Up,28222,0,28222,2018.csv,2018,0.0,1.0
21221,Date and Switch,28222,0,28222,2014.csv,2014,0.0,1.0
21222,Innsaei,28221,0,28221,2016.csv,2016,0.0,1.0
21223,London: The Modern Babylon,28219,0,28219,2012.csv,2012,0.0,1.0
21224,Baby Task Group,28219,0,28219,2017.csv,2017,0.0,1.0
21225,Love Songs 2011 Re-release,28215,0,28215,2011.csv,2011,0.0,1.0
21226,Two Years at Sea,28209,0,28209,2012.csv,2012,0.0,1.0
21227,"Like Sunday, Like Rain",28208,28208,0,2015.csv,2015,1.0,0.0
21228,St.,28208,0,28208,2010.csv,2010,0.0,1.0
21229,Interrogation,28184,0,28184,2018.csv,2018,0.0,1.0
21230,God Of War Kuan Kuong,28182,0,28182,2020.csv,2020,0.0,1.0
21231,7 Chinese Brothers,28180,28180,0,2015.csv,2015,1.0,0.0
21232,Wolfy the Incredible Secret,28175,0,28175,2013.csv,2013,0.0,1.0
21233,The Little Mermaid 2017 Re-release,28173,0,28173,2017.csv,2017,0.0,1.0
21234,Bebek Geliyorum Demez,28171,0,28171,2018.csv,2018,0.0,1.0
21235,Close to Me and Warm You,28169,0,28169,2019.csv,2019,0.0,1.0
21236,The Chaser 2010 Re-release,28161,0,28161,2010.csv,2010,0.0,1.0
21237,Enta Habibi We Bas,28139,0,28139,2019.csv,2019,0.0,1.0
21238,Noise & Resistance,28129,0,28129,2011.csv,2011,0.0,1.0
21239,Ciro y yo,28129,0,28129,2018.csv,2018,0.0,1.0
21240,Burn Burn Burn,28123,0,28123,2016.csv,2016,0.0,1.0
21241,Australien in 100 Tagen,28122,0,28122,2012.csv,2012,0.0,1.0
21242,Howard Lovecraft and the Frozen Kingdom,28115,0,28115,2017.csv,2017,0.0,1.0
21243,D.U.D.A! Werner Pirchner,28112,0,28112,2014.csv,2014,0.0,1.0
21244,La fille du 14 juillet,28104,0,28104,2013.csv,2013,0.0,1.0
21245,The Ambassador,28102,28102,0,2012.csv,2012,1.0,0.0
21246,Old Boys,28092,0,28092,2019.csv,2019,0.0,1.0
21247,Mo,28085,0,28085,2019.csv,2019,0.0,1.0
21248,Bikes vs Cars,28072,28072,0,2015.csv,2015,1.0,0.0
21249,Don't Look Back 2010 Re-release,28062,0,28062,2010.csv,2010,0.0,1.0
21250,Sembene!,28059,28059,0,2015.csv,2015,1.0,0.0
21251,SOKO 5113: Stoff aus der Heimat,28054,0,28054,2012.csv,2012,0.0,1.0
21252,Taxi 121,28050,0,28050,2016.csv,2016,0.0,1.0
21253,Mimi & Líza: Christmas Lights Mystery,28049,0,28049,2018.csv,2018,0.0,1.0
21254,Take Me to the River,28041,28041,0,2016.csv,2016,1.0,0.0
21255,Bloody Hell,28037,28037,0,2021.csv,2021,1.0,0.0
21256,Maharaja,28032,0,28032,2019.csv,2019,0.0,1.0
21257,Least Among Saints,28026,28026,0,2012.csv,2012,1.0,0.0
21258,Lawrence of Arabia 2017 Re-release,28023,0,28023,2017.csv,2017,0.0,1.0
21259,The Housemaid,28015,0,28015,2020.csv,2020,0.0,1.0
21260,Quai des Orfèvres 2018 Re-release,28013,28013,0,2018.csv,2018,1.0,0.0
21261,Beyond,28007,0,28007,2019.csv,2019,0.0,1.0
21262,Emu Runner,27999,0,27999,2019.csv,2019,0.0,1.0
21263,Kim Daha Mutlu?,27990,0,27990,2019.csv,2019,0.0,1.0
21264,Quatretondeta,27990,0,27990,2016.csv,2016,0.0,1.0
21265,My Father My Lord 2010 Re-release,27985,0,27985,2010.csv,2010,0.0,1.0
21266,Live Life,27979,0,27979,2019.csv,2019,0.0,1.0
21267,Into Dad's Woods,27968,0,27968,2020.csv,2020,0.0,1.0
21268,The Amendment,27961,27961,0,2018.csv,2018,1.0,0.0
21269,The Clink of Ice 2013 Re-release,27960,0,27960,2013.csv,2013,0.0,1.0
21270,Ribbons,27959,27959,0,2017.csv,2017,1.0,0.0
21271,Fruity Robo the Great Escape 2019 Re-release,27955,0,27955,2019.csv,2019,0.0,1.0
21272,Most van most,27949,0,27949,2019.csv,2019,0.0,1.0
21273,Barneraneren,27930,0,27930,2016.csv,2016,0.0,1.0
21274,El Norte 2019 Re-release,27920,27920,0,2019.csv,2019,1.0,0.0
21275,Every Time I Die,27913,0,27913,2020.csv,2020,0.0,1.0
21276,Navarathna,27909,0,27909,2020.csv,2020,0.0,1.0
21277,Nibunan,27905,0,27905,2017.csv,2017,0.0,1.0
21278,The Rezort 2017 Re-release,27885,0,27885,2017.csv,2017,0.0,1.0
21279,Chance,27857,0,27857,2011.csv,2011,0.0,1.0
21280,From the Balcony,27855,0,27855,2017.csv,2017,0.0,1.0
21281,Inuk,27840,0,27840,2013.csv,2013,0.0,1.0
21282,Radio Dreams,27836,27836,0,2017.csv,2017,1.0,0.0
21283,Notorious 2019 Re-release,27825,0,27825,2019.csv,2019,0.0,1.0
21284,L'amour fou 2012 Re-release,27824,0,27824,2012.csv,2012,0.0,1.0
21285,The Ultimate Wave Tahiti,27809,0,27809,2010.csv,2010,0.0,1.0
21286,Bauhaus Spirit: 100 Years of Bauhaus,27768,17122,10646,2019.csv,2019,0.6166090463843272,0.3833909536156727
21287,The Big Love Picture,27758,0,27758,2019.csv,2019,0.0,1.0
21288,Eva Nová,27745,0,27745,2015.csv,2015,0.0,1.0
21289,The Stolen,27741,0,27741,2017.csv,2017,0.0,1.0
21290,Simon Killer,27740,27740,0,2013.csv,2013,1.0,0.0
21291,30 Years of Garbage: The Garbage Pail Kids Story,27739,27739,0,2017.csv,2017,1.0,0.0
21292,The Dark,27738,0,27738,2019.csv,2019,0.0,1.0
21293,Senso,27723,27723,0,2018.csv,2018,1.0,0.0
21294,The Brussels Business,27719,0,27719,2012.csv,2012,0.0,1.0
21295,The Deep Blue Sea 2015 Re-release,27707,0,27707,2015.csv,2015,0.0,1.0
21296,"Mo' Money, Mo' Problems",27699,0,27699,2020.csv,2020,0.0,1.0
21297,Akhlaa El-Abid,27697,0,27697,2017.csv,2017,0.0,1.0
21298,John Doe,27694,0,27694,2011.csv,2011,0.0,1.0
21299,Purge of Kingdoms,27688,0,27688,2019.csv,2019,0.0,1.0
21300,The Amazing Johnathan Documentary,27682,0,27682,2019.csv,2019,0.0,1.0
21301,In the Heat of the Night 2016 Re-release,27669,0,27669,2016.csv,2016,0.0,1.0
21302,The Way We Were,27652,0,27652,2011.csv,2011,0.0,1.0
21303,Bad Johnson,27650,0,27650,2014.csv,2014,0.0,1.0
21304,Ip Man 2 2014 Re-release,27646,0,27646,2014.csv,2014,0.0,1.0
21305,Curse of the Scarecrow,27642,0,27642,2019.csv,2019,0.0,1.0
21306,Joseph et la fille 2011 Re-release,27639,0,27639,2011.csv,2011,0.0,1.0
21307,Met Opera: Agrippina,27610,0,27610,2020.csv,2020,0.0,1.0
21308,Solid Gold,27600,0,27600,2019.csv,2019,0.0,1.0
21309,Broadway Idiot,27595,27595,0,2013.csv,2013,1.0,0.0
21310,Someone Somewhere,27594,0,27594,2019.csv,2019,0.0,1.0
21311,Angel Whispers,27590,0,27590,2015.csv,2015,0.0,1.0
21312,Al Maa Wa Al Khoudra,27589,0,27589,2017.csv,2017,0.0,1.0
21313,Men on the Bridge,27563,0,27563,2010.csv,2010,0.0,1.0
21314,Eva Doesn't Sleep,27556,0,27556,2015.csv,2015,0.0,1.0
21315,Florbela,27553,0,27553,2014.csv,2014,0.0,1.0
21316,LazyTown,27538,0,27538,2013.csv,2013,0.0,1.0
21317,The King and the Mockingbird 2014 Re-release,27513,27513,0,2014.csv,2014,1.0,0.0
21318,Reality XL,27498,0,27498,2012.csv,2012,0.0,1.0
21319,The Artist: Reborn,27483,0,27483,2017.csv,2017,0.0,1.0
21320,Amitiés sincères 2014 Re-release,27483,0,27483,2014.csv,2014,0.0,1.0
21321,Jai Simha,27481,0,27481,2018.csv,2018,0.0,1.0
21322,Lena,27479,0,27479,2011.csv,2011,0.0,1.0
21323,Stalker,27475,0,27475,2016.csv,2016,0.0,1.0
21324,Without a Body,27453,0,27453,2020.csv,2020,0.0,1.0
21325,The Fight,27440,0,27440,2019.csv,2019,0.0,1.0
21326,Playhouse,27436,0,27436,2021.csv,2021,0.0,1.0
21327,Exists 2017 Re-release,27417,0,27417,2017.csv,2017,0.0,1.0
21328,12 Angry Lebanese: The Documentary,27415,0,27415,2010.csv,2010,0.0,1.0
21329,The Calling 2014 Re-release,27412,0,27412,2014.csv,2014,0.0,1.0
21330,Agent F.O.X.,27404,0,27404,2016.csv,2016,0.0,1.0
21331,Al Beh Romancy,27400,0,27400,2010.csv,2010,0.0,1.0
21332,Kate Plays Christine,27364,25564,1800,2016.csv,2016,0.9342201432539102,0.06577985674608976
21333,Itaker - Vietato agli italiani,27357,0,27357,2012.csv,2012,0.0,1.0
21334,Ngao: Kamkrai Kamman,27353,0,27353,2010.csv,2010,0.0,1.0
21335,Department,27351,0,27351,2012.csv,2012,0.0,1.0
21336,Crook: It's Good to Be Bad,27345,0,27345,2010.csv,2010,0.0,1.0
21337,Paharganj,27344,0,27344,2019.csv,2019,0.0,1.0
21338,The Cardinal,27340,0,27340,2019.csv,2019,0.0,1.0
21339,Cane River 2020 Re-release,27317,27317,0,2020.csv,2020,1.0,0.0
21340,Ghost in the Graveyard,27311,0,27311,2019.csv,2019,0.0,1.0
21341,The Runaways,27310,0,27310,2020.csv,2020,0.0,1.0
21342,Elelwani,27292,0,27292,2014.csv,2014,0.0,1.0
21343,Unlocking the Cage,27284,27284,0,2016.csv,2016,1.0,0.0
21344,Soldiers of the Damned,27267,0,27267,2015.csv,2015,0.0,1.0
21345,I Give You My Word,27257,0,27257,2013.csv,2013,0.0,1.0
21346,Kill Dil,27256,0,27256,2014.csv,2014,0.0,1.0
21347,Deux au carré,27245,0,27245,2015.csv,2015,0.0,1.0
21348,Oglan Bizim Kiz Bizim,27238,0,27238,2016.csv,2016,0.0,1.0
21349,I am the Procurator,27225,0,27225,2018.csv,2018,0.0,1.0
21350,LIE,27221,0,27221,2017.csv,2017,0.0,1.0
21351,My Friend from the Park,27216,0,27216,2015.csv,2015,0.0,1.0
21352,Kadhalum Kadandhu Pogum,27204,0,27204,2016.csv,2016,0.0,1.0
21353,Brave Father Online: Our Story of Final Fantasy XIV 2021 Re-release,27203,0,27203,2021.csv,2021,0.0,1.0
21354,Graduation Journey,27171,0,27171,2018.csv,2018,0.0,1.0
21355,Happy Sad Man,27163,0,27163,2019.csv,2019,0.0,1.0
21356,Tiger Eyes,27160,27160,0,2013.csv,2013,1.0,0.0
21357,Herr Wichmann aus der dritten Reihe,27159,0,27159,2012.csv,2012,0.0,1.0
21358,"Father, Son & Holy Cow",27155,0,27155,2012.csv,2012,0.0,1.0
21359,Bronx Gothic,27151,27151,0,2017.csv,2017,1.0,0.0
21360,Grown Up,27150,0,27150,2018.csv,2018,0.0,1.0
21361,Grace of Porridge,27149,0,27149,2019.csv,2019,0.0,1.0
21362,So Luckily,27143,0,27143,2016.csv,2016,0.0,1.0
21363,Tommaso,27136,0,27136,2019.csv,2019,0.0,1.0
21364,Together For Ever,27119,0,27119,2017.csv,2017,0.0,1.0
21365,Grown Ups 2020 Re-release,27112,0,27112,2020.csv,2020,0.0,1.0
21366,Zerre,27110,0,27110,2013.csv,2013,0.0,1.0
21367,Latitude 6,27108,0,27108,2015.csv,2015,0.0,1.0
21368,Justi&Cia,27076,0,27076,2014.csv,2014,0.0,1.0
21369,"Leaving Home, Coming Home: A Portrait of Robert Frank",27073,27073,0,2019.csv,2019,1.0,0.0
21370,Last Weekend,27053,27053,0,2014.csv,2014,1.0,0.0
21371,Alone with Her Dreams,27052,0,27052,2020.csv,2020,0.0,1.0
21372,Clash,27052,27052,0,2011.csv,2011,1.0,0.0
21373,The Night,27051,0,27051,2017.csv,2017,0.0,1.0
21374,The Combination 2010 Re-release,27043,0,27043,2010.csv,2010,0.0,1.0
21375,Something New 2017 Re-release,27043,0,27043,2017.csv,2017,0.0,1.0
21376,Eighteen: The World at My Feet,27042,0,27042,2011.csv,2011,0.0,1.0
21377,Sasha,27031,0,27031,2018.csv,2018,0.0,1.0
21378,Hemen Döneriz,27022,0,27022,2019.csv,2019,0.0,1.0
21379,Purgatorio 2015 Re-release,27010,0,27010,2015.csv,2015,0.0,1.0
21380,The Last Ride,27000,27000,0,2011.csv,2011,1.0,0.0
21381,Level Five,27000,27000,0,2014.csv,2014,1.0,0.0
21382,Pachakútec - Zeit des Wandels,26982,0,26982,2011.csv,2011,0.0,1.0
21383,5 Weddings,26980,0,26980,2018.csv,2018,0.0,1.0
21384,Beautiful Girl,26977,0,26977,2015.csv,2015,0.0,1.0
21385,Debt Collectors,26976,0,26976,2020.csv,2020,0.0,1.0
21386,Curtain Call,26964,0,26964,2016.csv,2016,0.0,1.0
21387,Daisy Quokka: World's Scariest Animal,26960,0,26960,2021.csv,2021,0.0,1.0
21388,Viriato,26953,0,26953,2019.csv,2019,0.0,1.0
21389,407 Dark Flight 3D 2015 Re-release,26951,0,26951,2015.csv,2015,0.0,1.0
21390,Mali Blues,26950,26950,0,2017.csv,2017,1.0,0.0
21391,"Three Changes, Mountain Changes",26942,0,26942,2019.csv,2019,0.0,1.0
21392,Binding Destiny,26941,0,26941,2018.csv,2018,0.0,1.0
21393,Our Little Sister 2018 Re-release,26927,0,26927,2018.csv,2018,0.0,1.0
21394,Sabit Kanca: Son Soru,26924,0,26924,2020.csv,2020,0.0,1.0
21395,Ohne Gnade!,26920,0,26920,2013.csv,2013,0.0,1.0
21396,Sadhu,26902,0,26902,2013.csv,2013,0.0,1.0
21397,Tholiprema,26878,0,26878,2018.csv,2018,0.0,1.0
21398,A Monster with a Thousand Heads,26865,24852,2013,2016.csv,2016,0.925069793411502,0.07493020658849804
21399,To Life!,26860,0,26860,2015.csv,2015,0.0,1.0
21400,La historia de Jan,26858,0,26858,2016.csv,2016,0.0,1.0
21401,Animals 2012 Re-release,26845,0,26845,2012.csv,2012,0.0,1.0
21402,City Lights 2019 Re-release,26827,0,26827,2019.csv,2019,0.0,1.0
21403,Beyond the Mountains and Hills,26824,0,26824,2018.csv,2018,0.0,1.0
21404,The Lenin Factor,26820,0,26820,2019.csv,2019,0.0,1.0
21405,"The Devil, Probably",26816,26816,0,2012.csv,2012,1.0,0.0
21406,Farinelli 2011 Re-release,26815,0,26815,2011.csv,2011,0.0,1.0
21407,Armida,26806,0,26806,2010.csv,2010,0.0,1.0
21408,Bankrot,26794,0,26794,2010.csv,2010,0.0,1.0
21409,Counter Column,26780,26780,0,2020.csv,2020,1.0,0.0
21410,Medal of Honor,26777,0,26777,2010.csv,2010,0.0,1.0
21411,Eusébio - The Story of a Legend,26769,0,26769,2017.csv,2017,0.0,1.0
21412,Ya Thadi Ya Taadi,26767,0,26767,2017.csv,2017,0.0,1.0
21413,No Tears for the Dead 2015 Re-release,26750,0,26750,2015.csv,2015,0.0,1.0
21414,Tap World,26747,26747,0,2015.csv,2015,1.0,0.0
21415,Stranger,26722,0,26722,2019.csv,2019,0.0,1.0
21416,Leo's Room,26719,0,26719,2010.csv,2010,0.0,1.0
21417,1921,26710,0,26710,2018.csv,2018,0.0,1.0
21418,Angel at Sea,26701,0,26701,2010.csv,2010,0.0,1.0
21419,Sagan 2010 Re-release,26697,0,26697,2010.csv,2010,0.0,1.0
21420,Now Is Good 2014 Re-release,26682,0,26682,2014.csv,2014,0.0,1.0
21421,A Small Family Business,26675,0,26675,2014.csv,2014,0.0,1.0
21422,The Prize 2013 Re-release,26671,0,26671,2013.csv,2013,0.0,1.0
21423,Fraud Saiyaan,26663,0,26663,2019.csv,2019,0.0,1.0
21424,Biting Fly,26659,0,26659,2017.csv,2017,0.0,1.0
21425,Siberia,26645,0,26645,2020.csv,2020,0.0,1.0
21426,Peace Officer,26632,26632,0,2015.csv,2015,1.0,0.0
21427,Prazdnik vzaperti,26632,0,26632,2012.csv,2012,0.0,1.0
21428,"Pink Ribbons, Inc.",26608,26608,0,2012.csv,2012,1.0,0.0
21429,Dead Mine,26597,0,26597,2012.csv,2012,0.0,1.0
21430,Wrestle,26597,26597,0,2019.csv,2019,1.0,0.0
21431,La Caleta,26582,0,26582,2018.csv,2018,0.0,1.0
21432,A Onda da Vida,26578,0,26578,2014.csv,2014,0.0,1.0
21433,A Memória que me Contam,26573,0,26573,2013.csv,2013,0.0,1.0
21434,Escort in Love 2012 Re-release,26572,0,26572,2012.csv,2012,0.0,1.0
21435,Milford Graves Full Mantis,26566,26566,0,2018.csv,2018,1.0,0.0
21436,The Vampire Spider,26565,0,26565,2012.csv,2012,0.0,1.0
21437,José,26563,26563,0,2020.csv,2020,1.0,0.0
21438,Return to Gandhi Road,26551,0,26551,2020.csv,2020,0.0,1.0
21439,Montanha,26550,0,26550,2015.csv,2015,0.0,1.0
21440,The White World According to Daliborek,26521,0,26521,2017.csv,2017,0.0,1.0
21441,Gypsy,26516,0,26516,2011.csv,2011,0.0,1.0
21442,Little One,26497,0,26497,2013.csv,2013,0.0,1.0
21443,Chalakkudykkaran Changathy,26496,0,26496,2018.csv,2018,0.0,1.0
21444,White As Snow,26490,0,26490,2011.csv,2011,0.0,1.0
21445,My Dad and Mr. Ito,26483,0,26483,2017.csv,2017,0.0,1.0
21446,Cao Cao and Yang Xiu,26449,0,26449,2018.csv,2018,0.0,1.0
21447,Departure,26448,0,26448,2016.csv,2016,0.0,1.0
21448,O Is Bende,26440,0,26440,2019.csv,2019,0.0,1.0
21449,Donkey Magistrate the Sandal Princess,26438,0,26438,2017.csv,2017,0.0,1.0
21450,Carmen 2013 Re-release,26428,0,26428,2013.csv,2013,0.0,1.0
21451,Rosetta 2019 Re-release,26427,0,26427,2019.csv,2019,0.0,1.0
21452,"Tayo, the Little Bus",26425,0,26425,2018.csv,2018,0.0,1.0
21453,Correspondence 2017 Re-release,26415,0,26415,2017.csv,2017,0.0,1.0
21454,Coupled,26414,0,26414,2019.csv,2019,0.0,1.0
21455,Front Cover,26409,26409,0,2016.csv,2016,1.0,0.0
21456,Das Pferd auf dem Balkon 2014 Re-release,26402,0,26402,2014.csv,2014,0.0,1.0
21457,Lengua materna,26394,0,26394,2010.csv,2010,0.0,1.0
21458,Eloise,26393,0,26393,2010.csv,2010,0.0,1.0
21459,Baltic Tribes,26366,0,26366,2020.csv,2020,0.0,1.0
21460,At First Light,26338,3292,23046,2018.csv,2018,0.12499050801123851,0.8750094919887614
21461,The Parents in the World,26334,0,26334,2018.csv,2018,0.0,1.0
21462,Marlina the Murderer in Four Acts,26331,17788,8543,2018.csv,2018,0.6755535300596255,0.32444646994037446
21463,Donnybrook,26284,26284,0,2019.csv,2019,1.0,0.0
21464,Una vita da sogno,26270,0,26270,2013.csv,2013,0.0,1.0
21465,XL,26233,0,26233,2013.csv,2013,0.0,1.0
21466,The Boat Race 2015 Re-release,26212,0,26212,2015.csv,2015,0.0,1.0
21467,Under Control,26209,0,26209,2011.csv,2011,0.0,1.0
21468,The Long Excuse,26198,0,26198,2017.csv,2017,0.0,1.0
21469,October Country,26185,26185,0,2010.csv,2010,1.0,0.0
21470,The Liar and His Lover 2018 Re-release,26171,0,26171,2018.csv,2018,0.0,1.0
21471,Leitis in Waiting,26130,0,26130,2018.csv,2018,0.0,1.0
21472,The Misandrists,26123,26123,0,2018.csv,2018,1.0,0.0
21473,"Bob, o Construtor: Mega Machines - O Filme",26121,0,26121,2017.csv,2017,0.0,1.0
21474,The Night,26114,26114,0,2021.csv,2021,1.0,0.0
21475,Jimmy in Pienk,26113,0,26113,2013.csv,2013,0.0,1.0
21476,Search Out,26105,0,26105,2020.csv,2020,0.0,1.0
21477,Dürrenmatt: Eine Liebesgeschichte,26102,0,26102,2015.csv,2015,0.0,1.0
21478,Deadly Treasure,26102,0,26102,2018.csv,2018,0.0,1.0
21479,An Almost Perfect Country 2018 Re-release,26096,0,26096,2018.csv,2018,0.0,1.0
21480,Yabanci,26087,0,26087,2013.csv,2013,0.0,1.0
21481,Les Invisibles,26083,0,26083,2012.csv,2012,0.0,1.0
21482,Bachelors,26081,0,26081,2016.csv,2016,0.0,1.0
21483,They Call Us Monsters,26080,26080,0,2017.csv,2017,1.0,0.0
21484,Outrageous,26069,0,26069,2010.csv,2010,0.0,1.0
21485,The Inventor,26062,0,26062,2020.csv,2020,0.0,1.0
21486,Kanli Postal,26052,0,26052,2015.csv,2015,0.0,1.0
21487,Coming Home,26047,0,26047,2012.csv,2012,0.0,1.0
21488,Bailaras,26045,0,26045,2017.csv,2017,0.0,1.0
21489,The Weather Inside,26021,0,26021,2016.csv,2016,0.0,1.0
21490,Tigers in the City,26021,0,26021,2012.csv,2012,0.0,1.0
21491,Ridge Runners,26019,26019,0,2018.csv,2018,1.0,0.0
21492,Lost Lives,26018,0,26018,2019.csv,2019,0.0,1.0
21493,Reach Me,26013,0,26013,2015.csv,2015,0.0,1.0
21494,Main Street,26011,2560,23451,2011.csv,2011,0.09841989927338433,0.9015801007266157
21495,The Voices,26011,0,26011,2020.csv,2020,0.0,1.0
21496,Jet Trash 2018 Re-release,26002,26002,0,2018.csv,2018,1.0,0.0
21497,Ciume,25983,0,25983,2018.csv,2018,0.0,1.0
21498,Merata: How Mom Decolonized the Screen,25965,0,25965,2019.csv,2019,0.0,1.0
21499,Victim,25962,0,25962,2017.csv,2017,0.0,1.0
21500,Silent Light 2010 Re-release,25956,0,25956,2010.csv,2010,0.0,1.0
21501,Otelo Burning,25956,0,25956,2012.csv,2012,0.0,1.0
21502,Girl,25955,0,25955,2020.csv,2020,0.0,1.0
21503,Chinatown 2013 Re-release,25935,0,25935,2013.csv,2013,0.0,1.0
21504,Requiem 2012 Re-release,25934,0,25934,2012.csv,2012,0.0,1.0
21505,O Caseiro,25928,0,25928,2016.csv,2016,0.0,1.0
21506,Ogul,25925,0,25925,2011.csv,2011,0.0,1.0
21507,The Sound of Music 2012 Re-release,25922,0,25922,2012.csv,2012,0.0,1.0
21508,Black Mother,25919,18762,7157,2018.csv,2018,0.7238705196959759,0.27612948030402407
21509,Django,25916,25916,0,2012.csv,2012,1.0,0.0
21510,Trabantem do posledního dychu,25886,0,25886,2016.csv,2016,0.0,1.0
21511,Army Daze,25882,0,25882,2013.csv,2013,0.0,1.0
21512,Paris Opera Ballet: Romeo and Juliet,25872,0,25872,2012.csv,2012,0.0,1.0
21513,Kita tylos puse,25869,0,25869,2019.csv,2019,0.0,1.0
21514,Ronaldo vs. Messi,25859,0,25859,2018.csv,2018,0.0,1.0
21515,Women Like Us,25859,25859,0,2017.csv,2017,1.0,0.0
21516,Caesar and Otto's Summer Camp Massacre,25844,25844,0,2011.csv,2011,1.0,0.0
21517,Lucky Monster,25829,0,25829,2020.csv,2020,0.0,1.0
21518,Casting,25818,0,25818,2010.csv,2010,0.0,1.0
21519,Holiday 2019 Re-release,25798,0,25798,2019.csv,2019,0.0,1.0
21520,Elena,25788,25788,0,2014.csv,2014,1.0,0.0
21521,The Metropolitan Opera HD Live: Mussorgsky: Boris Godunov,25773,0,25773,2010.csv,2010,0.0,1.0
21522,Söz Vermistin,25749,0,25749,2018.csv,2018,0.0,1.0
21523,The Roly Poly Man,25745,0,25745,2011.csv,2011,0.0,1.0
21524,Horses of God 2015 Re-release,25735,0,25735,2015.csv,2015,0.0,1.0
21525,Orphans & Kingdoms,25722,0,25722,2016.csv,2016,0.0,1.0
21526,Agnosia 2013 Re-release,25708,0,25708,2013.csv,2013,0.0,1.0
21527,Die Grosse Reise,25707,0,25707,2013.csv,2013,0.0,1.0
21528,Kills On Wheels,25678,0,25678,2016.csv,2016,0.0,1.0
21529,Withering,25669,0,25669,2013.csv,2013,0.0,1.0
21530,NBC White Paper: Railroads: The End of the Line?,25654,0,25654,2015.csv,2015,0.0,1.0
21531,Gurukulam,25651,25651,0,2016.csv,2016,1.0,0.0
21532,1983,25646,0,25646,2014.csv,2014,0.0,1.0
21533,Everyday,25644,0,25644,2014.csv,2014,0.0,1.0
21534,Ni pies ni cabeza,25639,0,25639,2012.csv,2012,0.0,1.0
21535,The Metropolitan Opera HD Live: Wagner: Parsifal,25638,0,25638,2013.csv,2013,0.0,1.0
21536,An Ordinary Man 2018 Re-release,25636,0,25636,2018.csv,2018,0.0,1.0
21537,Shadows,25636,0,25636,2010.csv,2010,0.0,1.0
21538,Wheesung,25635,0,25635,2010.csv,2010,0.0,1.0
21539,National Theatre Live: The Last of the Haussmans,25631,0,25631,2012.csv,2012,0.0,1.0
21540,Ted Sieger's Molly Monster,25624,0,25624,2016.csv,2016,0.0,1.0
21541,Daughter of Shanghai,25618,0,25618,2019.csv,2019,0.0,1.0
21542,Passion Play,25603,3669,21934,2011.csv,2011,0.14330351911885325,0.8566964808811467
21543,La última cima 2014 Re-release,25601,0,25601,2014.csv,2014,0.0,1.0
21544,Francisco Brennand,25589,0,25589,2013.csv,2013,0.0,1.0
21545,The Exploding Girl,25572,25572,0,2010.csv,2010,1.0,0.0
21546,Over the Years,25566,0,25566,2015.csv,2015,0.0,1.0
21547,Banjo,25531,25531,0,2016.csv,2016,1.0,0.0
21548,Diamantenfieber,25521,0,25521,2013.csv,2013,0.0,1.0
21549,Waiting for Forever,25517,25517,0,2011.csv,2011,1.0,0.0
21550,The Longest Wave,25511,0,25511,2020.csv,2020,0.0,1.0
21551,The Man from Mo'Wax,25502,0,25502,2018.csv,2018,0.0,1.0
21552,Boca de fresa,25494,0,25494,2010.csv,2010,0.0,1.0
21553,Unsubscribe,25488,25488,0,2020.csv,2020,1.0,0.0
21554,The Princess Bride 2020 Re-release,25486,0,25486,2020.csv,2020,0.0,1.0
21555,Christian Mingle,25480,25480,0,2014.csv,2014,1.0,0.0
21556,The Sacrifice 2016 Re-release,25473,0,25473,2016.csv,2016,0.0,1.0
21557,The Child Remains,25464,0,25464,2019.csv,2019,0.0,1.0
21558,The Bastards Fig Tree,25461,0,25461,2017.csv,2017,0.0,1.0
21559,Eso que llaman amor 2016 Re-release,25455,0,25455,2016.csv,2016,0.0,1.0
21560,Kill Command,25427,0,25427,2016.csv,2016,0.0,1.0
21561,The Wonders 2018 Re-release,25388,0,25388,2018.csv,2018,0.0,1.0
21562,Madras Beats,25388,0,25388,2019.csv,2019,0.0,1.0
21563,The Needle,25387,0,25387,2019.csv,2019,0.0,1.0
21564,Daivame Kaithozham K. Kumarakanam,25373,0,25373,2018.csv,2018,0.0,1.0
21565,Burn,25373,0,25373,2019.csv,2019,0.0,1.0
21566,The Royal Wedding of HRH Prince Harry & Miss Meghan Markle,25373,0,25373,2018.csv,2018,0.0,1.0
21567,Nobody Walks,25342,25342,0,2012.csv,2012,1.0,0.0
21568,Paradoksy,25333,0,25333,2020.csv,2020,0.0,1.0
21569,Great Poetry,25331,0,25331,2019.csv,2019,0.0,1.0
21570,The Killing$ of Tony Blair,25318,0,25318,2016.csv,2016,0.0,1.0
21571,Rediscover Sautet,25314,25314,0,2015.csv,2015,1.0,0.0
21572,Loop,25295,0,25295,2016.csv,2016,0.0,1.0
21573,Disturbing the Peace,25287,25287,0,2016.csv,2016,1.0,0.0
21574,Summer of Giacomo,25278,0,25278,2012.csv,2012,0.0,1.0
21575,In Search of Fellini,25269,12772,12497,2017.csv,2017,0.5054414499980213,0.49455855000197874
21576,Para Elisa,25264,0,25264,2013.csv,2013,0.0,1.0
21577,The Merger,25251,0,25251,2015.csv,2015,0.0,1.0
21578,Death of the Virgin,25247,25247,0,2012.csv,2012,1.0,0.0
21579,Tokyo Slaves,25231,0,25231,2014.csv,2014,0.0,1.0
21580,Sky Corps - Star Beast War,25210,0,25210,2019.csv,2019,0.0,1.0
21581,Rol,25209,0,25209,2013.csv,2013,0.0,1.0
21582,The Worst Movie Ever!,25206,25206,0,2011.csv,2011,1.0,0.0
21583,Do Dooni Panj,25195,0,25195,2019.csv,2019,0.0,1.0
21584,Sous le même toit 2018 Re-release,25192,0,25192,2018.csv,2018,0.0,1.0
21585,Howards End 2020 Re-release,25188,0,25188,2020.csv,2020,0.0,1.0
21586,"Marieke, Marieke",25177,0,25177,2011.csv,2011,0.0,1.0
21587,Al Berto,25173,0,25173,2017.csv,2017,0.0,1.0
21588,RTT 2010 Re-release,25166,0,25166,2010.csv,2010,0.0,1.0
21589,The Awakening of the Ants,25162,0,25162,2019.csv,2019,0.0,1.0
21590,Sour Grapes,25147,0,25147,2016.csv,2016,0.0,1.0
21591,Anselmi: The Young Werewolf,25146,0,25146,2014.csv,2014,0.0,1.0
21592,Blood Myth,25141,0,25141,2019.csv,2019,0.0,1.0
21593,SuperBrother 2011 Re-release,25133,0,25133,2011.csv,2011,0.0,1.0
21594,Tehran: City of Love,25131,0,25131,2019.csv,2019,0.0,1.0
21595,Fresh,25115,25115,0,2010.csv,2010,1.0,0.0
21596,Gemini Ganeshanum Suruli Raajanum,25109,0,25109,2017.csv,2017,0.0,1.0
21597,Il teatro al lavoro,25103,0,25103,2018.csv,2018,0.0,1.0
21598,Bi Ghamdet 3ein,25100,0,25100,2017.csv,2017,0.0,1.0
21599,Vazante,25091,23884,1207,2018.csv,2018,0.9518951018293412,0.0481048981706588
21600,Disappearance at Clifton Hill,25084,25084,0,2020.csv,2020,1.0,0.0
21601,The Bolshoi Ballet: Live From Moscow - Raymonda,25079,0,25079,2012.csv,2012,0.0,1.0
21602,Baby Balloon,25072,0,25072,2013.csv,2013,0.0,1.0
21603,My Bossy Girl,25064,0,25064,2019.csv,2019,0.0,1.0
21604,NeTikros prancuziskos vestuves,25052,0,25052,2015.csv,2015,0.0,1.0
21605,Blue Amber,25049,0,25049,2018.csv,2018,0.0,1.0
21606,What My Eyes Have Seen 2010 Re-release,25048,0,25048,2010.csv,2010,0.0,1.0
21607,Prime Time Soap,25047,0,25047,2012.csv,2012,0.0,1.0
21608,Here Alone,25043,0,25043,2017.csv,2017,0.0,1.0
21609,Martirio satánico,25041,0,25041,2016.csv,2016,0.0,1.0
21610,Art & Mind,25036,0,25036,2019.csv,2019,0.0,1.0
21611,The Last Season: Shawaks,25035,0,25035,2010.csv,2010,0.0,1.0
21612,Andiamo a quel paese 2017 Re-release,25033,0,25033,2017.csv,2017,0.0,1.0
21613,Bende Kal,25027,0,25027,2018.csv,2018,0.0,1.0
21614,Bonnie & Clyde vs. Dracula,25027,25027,0,2011.csv,2011,1.0,0.0
21615,The Lucky Man,25015,25015,0,2017.csv,2017,1.0,0.0
21616,1985,25013,0,25013,2018.csv,2018,0.0,1.0
21617,Bi anai,25001,0,25001,2011.csv,2011,0.0,1.0
21618,Boyz n the Hood 2016 Re-release,25001,0,25001,2016.csv,2016,0.0,1.0
21619,The Power of Few,25000,25000,0,2013.csv,2013,1.0,0.0
21620,The Double Life of Véronique 2016 Re-release,24998,0,24998,2016.csv,2016,0.0,1.0
21621,Mami Blue,24996,0,24996,2011.csv,2011,0.0,1.0
21622,Paavada,24985,0,24985,2016.csv,2016,0.0,1.0
21623,O Último Cine Drive-in,24962,0,24962,2015.csv,2015,0.0,1.0
21624,Victor 2017 Re-release,24960,0,24960,2017.csv,2017,0.0,1.0
21625,Ugetsu,24959,11197,13762,2017.csv,2017,0.44861572979686687,0.5513842702031332
21626,R100,24956,24956,0,2015.csv,2015,1.0,0.0
21627,Kung Fu Angels,24950,0,24950,2014.csv,2014,0.0,1.0
21628,45 25: #KusursuzCinayet,24943,0,24943,2019.csv,2019,0.0,1.0
21629,So Much Water,24939,0,24939,2013.csv,2013,0.0,1.0
21630,The Mali-Cuba Connection,24938,0,24938,2020.csv,2020,0.0,1.0
21631,Force of Nature Natalia,24932,0,24932,2019.csv,2019,0.0,1.0
21632,Inside Llewyn Davis 2016 Re-release,24930,0,24930,2016.csv,2016,0.0,1.0
21633,The Business Strom of Ruhai,24930,0,24930,2019.csv,2019,0.0,1.0
21634,They Are All Dead 2015 Re-release,24918,0,24918,2015.csv,2015,0.0,1.0
21635,Kanunsuzlar,24911,0,24911,2014.csv,2014,0.0,1.0
21636,Piranha 3DD 2013 Re-release,24906,0,24906,2013.csv,2013,0.0,1.0
21637,Let's Go!,24902,0,24902,2011.csv,2011,0.0,1.0
21638,L'ora legale 2018 Re-release,24885,0,24885,2018.csv,2018,0.0,1.0
21639,Thackeray,24880,0,24880,2019.csv,2019,0.0,1.0
21640,Naples '44,24863,24620,243,2017.csv,2017,0.9902264408961107,0.009773559103889313
21641,A Dragon Arrives!,24846,0,24846,2016.csv,2016,0.0,1.0
21642,An Elephant's Journey,24844,24844,0,2018.csv,2018,1.0,0.0
21643,Pasos de héroe,24843,0,24843,2016.csv,2016,0.0,1.0
21644,À ciel ouvert 2014 Re-release,24842,0,24842,2014.csv,2014,0.0,1.0
21645,Tiny Furniture 2012 Re-release,24824,0,24824,2012.csv,2012,0.0,1.0
21646,Madaari,24822,0,24822,2016.csv,2016,0.0,1.0
21647,While We're Young 2020 Re-release,24819,0,24819,2020.csv,2020,0.0,1.0
21648,Puzzled Love,24817,0,24817,2012.csv,2012,0.0,1.0
21649,Exhibition on Screen: Michelangelo Love and Death,24812,0,24812,2018.csv,2018,0.0,1.0
21650,Light from Light,24808,24808,0,2019.csv,2019,1.0,0.0
21651,Hedi Schneider Is Stuck,24788,0,24788,2015.csv,2015,0.0,1.0
21652,Marius/Fanny/César,24787,24787,0,2017.csv,2017,1.0,0.0
21653,The Seagull,24768,0,24768,2019.csv,2019,0.0,1.0
21654,Jellyfish 2010 Re-release,24761,0,24761,2010.csv,2010,0.0,1.0
21655,West of Sunshine,24760,0,24760,2018.csv,2018,0.0,1.0
21656,Machine,24755,0,24755,2019.csv,2019,0.0,1.0
21657,Paradise 2017 Re-release,24749,24749,0,2017.csv,2017,1.0,0.0
21658,Kalb Balady,24746,0,24746,2017.csv,2017,0.0,1.0
21659,Strike,24743,15758,8985,2019.csv,2019,0.6368669926847997,0.36313300731520026
21660,Bernie the Dolphin 2,24742,0,24742,2019.csv,2019,0.0,1.0
21661,La tierra roja,24741,0,24741,2015.csv,2015,0.0,1.0
21662,Chalo,24740,0,24740,2018.csv,2018,0.0,1.0
21663,Walking,24738,0,24738,2011.csv,2011,0.0,1.0
21664,Stage Mother,24736,0,24736,2020.csv,2020,0.0,1.0
21665,Cold Comes the Night,24732,16971,7761,2013.csv,2013,0.6861960213488598,0.31380397865114024
21666,Sandouq Al Dunia,24721,0,24721,2020.csv,2020,0.0,1.0
21667,A Midsummer Night's Dream,24711,0,24711,2019.csv,2019,0.0,1.0
21668,Axel: The Biggest Little Hero,24702,0,24702,2015.csv,2015,0.0,1.0
21669,The Viral Factor 2014 Re-release,24695,0,24695,2014.csv,2014,0.0,1.0
21670,Kaufman's Game,24694,0,24694,2018.csv,2018,0.0,1.0
21671,Paathshaala,24690,0,24690,2010.csv,2010,0.0,1.0
21672,The Day,24686,20984,3702,2012.csv,2012,0.8500364579113667,0.14996354208863324
21673,Hyenas,24672,24672,0,2019.csv,2019,1.0,0.0
21674,Roy,24669,0,24669,2015.csv,2015,0.0,1.0
21675,El Beneficio de la Duda,24668,0,24668,2015.csv,2015,0.0,1.0
21676,Final Ascent: The Legend of Hamish MacInnes,24666,0,24666,2019.csv,2019,0.0,1.0
21677,Pig,24666,0,24666,2018.csv,2018,0.0,1.0
21678,The Departure,24662,24662,0,2017.csv,2017,1.0,0.0
21679,Harvest,24657,24657,0,2011.csv,2011,1.0,0.0
21680,Knuckle,24655,2647,22008,2011.csv,2011,0.1073615899411884,0.8926384100588116
21681,Och Piccadilly Circus ligger inte i Kumla,24651,0,24651,2014.csv,2014,0.0,1.0
21682,Peeping Tom,24640,0,24640,2010.csv,2010,0.0,1.0
21683,Olvidados 2015 Re-release,24638,24638,0,2015.csv,2015,1.0,0.0
21684,Harry Potter and the Prisoner of Azkaban 2021 Re-release,24638,0,24638,2021.csv,2021,0.0,1.0
21685,Mateo,24631,0,24631,2014.csv,2014,0.0,1.0
21686,Born to Fly: Elizabeth Streb vs. Gravity,24630,24630,0,2014.csv,2014,1.0,0.0
21687,His Master's Voice,24627,0,24627,2018.csv,2018,0.0,1.0
21688,The Metropolitan Opera Presents: Les Troyens,24617,0,24617,2013.csv,2013,0.0,1.0
21689,Mazlum Kuzey & Kuddusi 2 La! Kasada Para Var!,24612,0,24612,2019.csv,2019,0.0,1.0
21690,On Air,24600,0,24600,2013.csv,2013,0.0,1.0
21691,Behind the Trees,24595,0,24595,2019.csv,2019,0.0,1.0
21692,A Call Girl,24595,0,24595,2011.csv,2011,0.0,1.0
21693,Periodo de prueba,24586,0,24586,2018.csv,2018,0.0,1.0
21694,La-Fa-Fun: Confession of the Winners,24570,0,24570,2010.csv,2010,0.0,1.0
21695,Fear of Rain,24565,0,24565,2021.csv,2021,0.0,1.0
21696,Colourful 2011 Re-release,24565,0,24565,2011.csv,2011,0.0,1.0
21697,The Aspern Papers,24554,9277,15277,2019.csv,2019,0.3778203144090576,0.6221796855909424
21698,Immigration Tango,24554,24554,0,2011.csv,2011,1.0,0.0
21699,After,24544,24544,0,2011.csv,2011,1.0,0.0
21700,Eish Hayatak,24540,0,24540,2019.csv,2019,0.0,1.0
21701,Sirphire,24539,0,24539,2012.csv,2012,0.0,1.0
21702,How to Plan an Orgy in a Small Town,24532,0,24532,2016.csv,2016,0.0,1.0
21703,Graceland,24529,24529,0,2013.csv,2013,1.0,0.0
21704,Mía,24528,0,24528,2011.csv,2011,0.0,1.0
21705,Kayseri aslani: Çin isi...,24522,0,24522,2017.csv,2017,0.0,1.0
21706,The Miner,24518,0,24518,2017.csv,2017,0.0,1.0
21707,La amante del libertador,24498,0,24498,2014.csv,2014,0.0,1.0
21708,Too Late to Die Young,24487,16591,7896,2018.csv,2018,0.6775431861804223,0.32245681381957775
21709,Accidental Love,24487,0,24487,2015.csv,2015,0.0,1.0
21710,Sudden Fear,24476,24476,0,2016.csv,2016,1.0,0.0
21711,Big Big World,24458,0,24458,2017.csv,2017,0.0,1.0
21712,Out of Love,24456,0,24456,2016.csv,2016,0.0,1.0
21713,Otter 501,24449,24449,0,2012.csv,2012,1.0,0.0
21714,David Bowie Is,24438,0,24438,2015.csv,2015,0.0,1.0
21715,"It's Your Turn, Honey!",24434,0,24434,2018.csv,2018,0.0,1.0
21716,The Dead and the Living,24425,0,24425,2012.csv,2012,0.0,1.0
21717,The Line,24423,0,24423,2010.csv,2010,0.0,1.0
21718,In the Port of Cape Town,24414,0,24414,2019.csv,2019,0.0,1.0
21719,Channo Kamli Yaar Di,24404,0,24404,2015.csv,2015,0.0,1.0
21720,Passed by Censor,24399,0,24399,2018.csv,2018,0.0,1.0
21721,Touch Chesi Chudu,24394,0,24394,2018.csv,2018,0.0,1.0
21722,El ingeniero,24384,0,24384,2012.csv,2012,0.0,1.0
21723,Benavidez's Case,24381,0,24381,2017.csv,2017,0.0,1.0
21724,Ferox,24361,0,24361,2013.csv,2013,0.0,1.0
21725,Special Actors,24361,0,24361,2020.csv,2020,0.0,1.0
21726,Last Days in the Desert,24352,0,24352,2016.csv,2016,0.0,1.0
21727,Balu Mahi,24349,0,24349,2017.csv,2017,0.0,1.0
21728,Honeymoon,24343,9318,15025,2014.csv,2014,0.3827794437826069,0.6172205562173931
21729,Wonder Boy for President,24341,0,24341,2016.csv,2016,0.0,1.0
21730,Ögrenci Kafasi: Soygun,24314,0,24314,2018.csv,2018,0.0,1.0
21731,The New Life,24312,0,24312,2011.csv,2011,0.0,1.0
21732,Room of Death 2010 Re-release,24310,0,24310,2010.csv,2010,0.0,1.0
21733,Close-Knit,24306,0,24306,2017.csv,2017,0.0,1.0
21734,Le Petit Soldat,24296,24296,0,2013.csv,2013,1.0,0.0
21735,Rampart 2013 Re-release,24292,0,24292,2013.csv,2013,0.0,1.0
21736,Aparição,24278,0,24278,2018.csv,2018,0.0,1.0
21737,"On Vodka, Beers, and Regrets",24275,0,24275,2020.csv,2020,0.0,1.0
21738,Jigarthanda,24274,0,24274,2014.csv,2014,0.0,1.0
21739,Triangle 2018 Re-release,24270,0,24270,2018.csv,2018,0.0,1.0
21740,3 5 Comedy of Errors,24266,0,24266,2012.csv,2012,0.0,1.0
21741,Brand - Eine Totengeschichte,24260,0,24260,2011.csv,2011,0.0,1.0
21742,Jasmine,24248,24248,0,2017.csv,2017,1.0,0.0
21743,Vincent Van Gogh - A New Way Of Seeing,24241,0,24241,2015.csv,2015,0.0,1.0
21744,Amaren eskuak,24237,0,24237,2013.csv,2013,0.0,1.0
21745,Pleasant Goat and Big Big Wolf 2 2011 Re-release,24234,0,24234,2011.csv,2011,0.0,1.0
21746,Action Hero Biju,24233,0,24233,2016.csv,2016,0.0,1.0
21747,Hier ben ik,24230,0,24230,2017.csv,2017,0.0,1.0
21748,Little Lord,24224,0,24224,2015.csv,2015,0.0,1.0
21749,Chuzhaya molitva,24207,0,24207,2017.csv,2017,0.0,1.0
21750,Eter,24203,0,24203,2019.csv,2019,0.0,1.0
21751,Another Egg and Chicken Movie 2011 Re-release,24194,0,24194,2011.csv,2011,0.0,1.0
21752,Close-ups,24193,0,24193,2014.csv,2014,0.0,1.0
21753,Sid and Nancy 2016 Re-release,24184,0,24184,2016.csv,2016,0.0,1.0
21754,Parasol,24171,0,24171,2016.csv,2016,0.0,1.0
21755,Loud Krazy Love,24169,0,24169,2019.csv,2019,0.0,1.0
21756,Hunger 2010 Re-release,24144,0,24144,2010.csv,2010,0.0,1.0
21757,Heart of Africa,24139,24139,0,2020.csv,2020,1.0,0.0
21758,The Song of Roland,24136,0,24136,2011.csv,2011,0.0,1.0
21759,"Paris, Texas 2017 Re-release",24134,0,24134,2017.csv,2017,0.0,1.0
21760,"Ca Chon, Anh Dung Di!",24130,0,24130,2019.csv,2019,0.0,1.0
21761,On the Way Home,24110,0,24110,2012.csv,2012,0.0,1.0
21762,Ölü Yatirim,24101,0,24101,2019.csv,2019,0.0,1.0
21763,Radio Unnameable,24090,24090,0,2012.csv,2012,1.0,0.0
21764,Gigola,24085,0,24085,2010.csv,2010,0.0,1.0
21765,Level Up,24083,1469,22614,2016.csv,2016,0.06099738404683802,0.939002615953162
21766,A Respectable Family,24083,0,24083,2012.csv,2012,0.0,1.0
21767,Aquaman 2020 Re-release,24079,0,24079,2020.csv,2020,0.0,1.0
21768,Running Like Wind,24077,0,24077,2017.csv,2017,0.0,1.0
21769,Killbillies,24070,0,24070,2015.csv,2015,0.0,1.0
21770,Uchithanai Muharnthaal,24067,0,24067,2012.csv,2012,0.0,1.0
21771,Chasing Einstein,24057,24057,0,2019.csv,2019,1.0,0.0
21772,Our House,24039,0,24039,2018.csv,2018,0.0,1.0
21773,It Always Rains on Sunday 2012 Re-release,24037,0,24037,2012.csv,2012,0.0,1.0
21774,Ranchero,24036,24036,0,2011.csv,2011,1.0,0.0
21775,Void,24035,0,24035,2014.csv,2014,0.0,1.0
21776,The Naked Wanderer,24034,0,24034,2019.csv,2019,0.0,1.0
21777,Live in Live,24034,0,24034,2013.csv,2013,0.0,1.0
21778,The Liverpool Goalie 2012 Re-release,24014,0,24014,2012.csv,2012,0.0,1.0
21779,Steven Universe: The Movie,24012,0,24012,2019.csv,2019,0.0,1.0
21780,Tiger Team: The Mountain of the 1000 Dragons 2011 Re-release,24009,0,24009,2011.csv,2011,0.0,1.0
21781,The Gandhi Murder,24000,0,24000,2019.csv,2019,0.0,1.0
21782,Beneath the Darkness,23998,0,23998,2012.csv,2012,0.0,1.0
21783,Carreras,23995,0,23995,2013.csv,2013,0.0,1.0
21784,The Fiancé,23986,23986,0,2016.csv,2016,1.0,0.0
21785,A Wedding 2019 Re-release,23985,0,23985,2019.csv,2019,0.0,1.0
21786,Lakshmi's NTR,23985,0,23985,2019.csv,2019,0.0,1.0
21787,Aranmanai 2,23980,0,23980,2016.csv,2016,0.0,1.0
21788,The Letter Writer,23965,0,23965,2014.csv,2014,0.0,1.0
21789,Sing Me a Song,23959,0,23959,2018.csv,2018,0.0,1.0
21790,Harry Dean Stanton: Partly Fiction,23959,23959,0,2013.csv,2013,1.0,0.0
21791,Almost Holy,23957,21142,2815,2016.csv,2016,0.8824978085736945,0.11750219142630547
21792,Boomerang,23956,0,23956,2019.csv,2019,0.0,1.0
21793,Bill & Ted's Excellent Adventure 2020 Re-release,23955,0,23955,2020.csv,2020,0.0,1.0
21794,Pasanga 2,23953,0,23953,2015.csv,2015,0.0,1.0
21795,"Robbi, Tobbi und das Fliewatüüt 2019 Re-release",23948,0,23948,2019.csv,2019,0.0,1.0
21796,The Magistrate,23942,0,23942,2013.csv,2013,0.0,1.0
21797,Life During Wartime 2011 Re-release,23930,0,23930,2011.csv,2011,0.0,1.0
21798,The Child Prodigy,23927,0,23927,2010.csv,2010,0.0,1.0
21799,3,23922,0,23922,2012.csv,2012,0.0,1.0
21800,Letter from Masanjia,23922,23481,441,2018.csv,2018,0.9815650865312265,0.018434913468773514
21801,Russkiy Bes,23919,0,23919,2019.csv,2019,0.0,1.0
21802,Back of the Moon,23918,0,23918,2019.csv,2019,0.0,1.0
21803,Simple Creature,23918,23918,0,2017.csv,2017,1.0,0.0
21804,In der Welt habt ihr Angst,23917,0,23917,2011.csv,2011,0.0,1.0
21805,Jhootha Hi Sahi,23917,0,23917,2010.csv,2010,0.0,1.0
21806,Get a Job,23910,0,23910,2016.csv,2016,0.0,1.0
21807,Chennai 600028 II: Second Innings,23906,0,23906,2016.csv,2016,0.0,1.0
21808,Killing the Dead,23902,0,23902,2019.csv,2019,0.0,1.0
21809,Shut Up Little Man! An Audio Misadventure,23901,23901,0,2011.csv,2011,1.0,0.0
21810,Dear Mr. Watterson,23899,23899,0,2013.csv,2013,1.0,0.0
21811,I Used to Go Here,23898,0,23898,2020.csv,2020,0.0,1.0
21812,Under the Wire,23897,3429,20468,2018.csv,2018,0.14349081474662093,0.856509185253379
21813,Vincent N Roxxy,23896,0,23896,2017.csv,2017,0.0,1.0
21814,10 Days in Sun City,23894,0,23894,2017.csv,2017,0.0,1.0
21815,Gop-Stop,23891,0,23891,2011.csv,2011,0.0,1.0
21816,Behind the Burly Q,23889,23889,0,2010.csv,2010,1.0,0.0
21817,Salt and Fire,23888,0,23888,2017.csv,2017,0.0,1.0
21818,Sal,23881,0,23881,2012.csv,2012,0.0,1.0
21819,Emoticon ;),23881,23881,0,2014.csv,2014,1.0,0.0
21820,Blank,23876,0,23876,2019.csv,2019,0.0,1.0
21821,Si muore solo da vivi,23868,0,23868,2020.csv,2020,0.0,1.0
21822,Happy Valley,23868,23868,0,2014.csv,2014,1.0,0.0
21823,Argentina,23864,14869,8995,2015.csv,2015,0.623072410325176,0.376927589674824
21824,An International Local Story,23853,0,23853,2019.csv,2019,0.0,1.0
21825,The Monkey King Havoc in Heavens Palace 2016 Re-release,23852,0,23852,2016.csv,2016,0.0,1.0
21826,The Dig,23839,0,23839,2019.csv,2019,0.0,1.0
21827,Death House,23833,23833,0,2018.csv,2018,1.0,0.0
21828,Fliegende Fische müssen ins Meer,23822,0,23822,2011.csv,2011,0.0,1.0
21829,Bike and Old Electronic Piano,23800,0,23800,2018.csv,2018,0.0,1.0
21830,The Metropolitan Opera HD Live: R. Strauss: Der Rosenkavalier,23792,0,23792,2010.csv,2010,0.0,1.0
21831,Three-Quarters Decent,23792,0,23792,2012.csv,2012,0.0,1.0
21832,Bibi & Tina 2015 Re-release,23791,0,23791,2015.csv,2015,0.0,1.0
21833,More Than Family,23781,0,23781,2020.csv,2020,0.0,1.0
21834,The Furthest End Awaits,23766,0,23766,2015.csv,2015,0.0,1.0
21835,Dead Night,23751,0,23751,2018.csv,2018,0.0,1.0
21836,The Tragedy of King Richard the Second,23748,0,23748,2019.csv,2019,0.0,1.0
21837,The Metropolitan Opera HD Live: John Adams: Nixon in China,23739,0,23739,2011.csv,2011,0.0,1.0
21838,Vosotros sois mi película,23738,0,23738,2019.csv,2019,0.0,1.0
21839,Bullet,23730,0,23730,2014.csv,2014,0.0,1.0
21840,Alois Nebel 2013 Re-release,23727,0,23727,2013.csv,2013,0.0,1.0
21841,Black Mountain Poets,23722,0,23722,2016.csv,2016,0.0,1.0
21842,Flicker,23722,0,23722,2012.csv,2012,0.0,1.0
21843,Greenwich Village: Music That Defined a Generation,23701,23701,0,2013.csv,2013,1.0,0.0
21844,Pilgrimage,23689,0,23689,2017.csv,2017,0.0,1.0
21845,Looking for Goddess Jiao Ai,23688,0,23688,2018.csv,2018,0.0,1.0
21846,My Papa Rich,23687,0,23687,2015.csv,2015,0.0,1.0
21847,Doctor Who: Resolution,23686,0,23686,2019.csv,2019,0.0,1.0
21848,2010 Seoul Vacation,23673,0,23673,2010.csv,2010,0.0,1.0
21849,The Sacrifice,23672,0,23672,2017.csv,2017,0.0,1.0
21850,Raw Faith,23667,23667,0,2011.csv,2011,1.0,0.0
21851,Southbound,23665,23665,0,2016.csv,2016,1.0,0.0
21852,Back to the Future Part II 2020 Re-release,23643,0,23643,2020.csv,2020,0.0,1.0
21853,Common Denominator,23641,0,23641,2014.csv,2014,0.0,1.0
21854,White Island,23638,0,23638,2016.csv,2016,0.0,1.0
21855,Good Kids,23627,0,23627,2016.csv,2016,0.0,1.0
21856,The Violent Heart,23614,23614,0,2020.csv,2020,1.0,0.0
21857,"Phoenix, Oregon",23613,23613,0,2020.csv,2020,1.0,0.0
21858,Space Dogs 2013 Re-release,23609,0,23609,2013.csv,2013,0.0,1.0
21859,Vízipók-csodapók,23602,0,23602,2019.csv,2019,0.0,1.0
21860,Servants,23601,0,23601,2020.csv,2020,0.0,1.0
21861,Enxaneta,23596,0,23596,2011.csv,2011,0.0,1.0
21862,Lost Bohemia,23584,23584,0,2011.csv,2011,1.0,0.0
21863,Secrets of War 2016 Re-release,23565,0,23565,2016.csv,2016,0.0,1.0
21864,The Shamer's Daughter 2017 Re-release,23562,0,23562,2017.csv,2017,0.0,1.0
21865,"A Woman, a Part",23562,23562,0,2017.csv,2017,1.0,0.0
21866,Tutto liscio,23556,0,23556,2019.csv,2019,0.0,1.0
21867,Casablanca 2010 Re-release,23551,0,23551,2010.csv,2010,0.0,1.0
21868,Ikko Mikke,23550,0,23550,2020.csv,2020,0.0,1.0
21869,Dom na obochine,23547,0,23547,2012.csv,2012,0.0,1.0
21870,The Down,23544,0,23544,2015.csv,2015,0.0,1.0
21871,Robodog 2018 Re-release,23518,0,23518,2018.csv,2018,0.0,1.0
21872,An Evening with Beverly Luff Linn,23515,6701,16814,2018.csv,2018,0.28496704231341696,0.715032957686583
21873,Begletsy,23501,0,23501,2019.csv,2019,0.0,1.0
21874,Breaking the Waves 2021 Re-release,23500,0,23500,2021.csv,2021,0.0,1.0
21875,Norberto's Deadline,23494,0,23494,2010.csv,2010,0.0,1.0
21876,The Innocence of Childhood,23493,0,23493,2018.csv,2018,0.0,1.0
21877,The Hill Chris Climbed: The Gridiron Heroes Story,23487,23487,0,2016.csv,2016,1.0,0.0
21878,Suspects in Love,23482,0,23482,2013.csv,2013,0.0,1.0
21879,Night Drive,23458,0,23458,2011.csv,2011,0.0,1.0
21880,Lakshmi 2018 Re-release,23446,0,23446,2018.csv,2018,0.0,1.0
21881,"The Good, the Bad, the Corny",23444,0,23444,2017.csv,2017,0.0,1.0
21882,Notting Hill 2019 Re-release,23436,0,23436,2020.csv,2020,0.0,1.0
21883,Robert the Bruce,23425,0,23425,2019.csv,2019,0.0,1.0
21884,Believe Me,23419,23419,0,2014.csv,2014,1.0,0.0
21885,The End of the World,23406,0,23406,2020.csv,2020,0.0,1.0
21886,The Writing's on The Wall,23398,0,23398,2016.csv,2016,0.0,1.0
21887,Rocky Mental,23392,0,23392,2017.csv,2017,0.0,1.0
21888,10 Billion - What's on your plate?,23389,0,23389,2015.csv,2015,0.0,1.0
21889,The Revenge of Phantom Knight,23369,0,23369,2018.csv,2018,0.0,1.0
21890,Cutter's Way 2011 Re-release,23360,0,23360,2011.csv,2011,0.0,1.0
21891,The Legend of LiuYi,23337,0,23337,2018.csv,2018,0.0,1.0
21892,Nina,23313,0,23313,2017.csv,2017,0.0,1.0
21893,The Beat That My Heart Skipped 2016 Re-release,23311,0,23311,2016.csv,2016,0.0,1.0
21894,Serrat y Sabina: el símbolo y el cuate,23305,0,23305,2013.csv,2013,0.0,1.0
21895,Em Busca de Iara,23303,0,23303,2014.csv,2014,0.0,1.0
21896,Arthur and the Invisibles 2011 Re-release,23289,0,23289,2011.csv,2011,0.0,1.0
21897,Devarattam,23285,0,23285,2019.csv,2019,0.0,1.0
21898,A Somewhat Gentle Man 2012 Re-release,23278,0,23278,2012.csv,2012,0.0,1.0
21899,Final Mission,23276,0,23276,2017.csv,2017,0.0,1.0
21900,Volverte a ver 2010 Re-release,23268,0,23268,2010.csv,2010,0.0,1.0
21901,Can't Stand Losing You: Surviving the Police,23262,23262,0,2015.csv,2015,1.0,0.0
21902,Take Me Home 2013 Re-release,23261,0,23261,2013.csv,2013,0.0,1.0
21903,BBC Proms: Last Night of the Proms,23235,0,23235,2011.csv,2011,0.0,1.0
21904,The Voice of the Moon,23222,0,23222,2021.csv,2021,0.0,1.0
21905,Toloka,23206,0,23206,2020.csv,2020,0.0,1.0
21906,Hamid,23191,0,23191,2019.csv,2019,0.0,1.0
21907,The Famous and the Dead,23177,0,23177,2010.csv,2010,0.0,1.0
21908,I Am Home,23162,0,23162,2019.csv,2019,0.0,1.0
21909,Vaisakhi List,23162,0,23162,2016.csv,2016,0.0,1.0
21910,Pororoca,23157,0,23157,2018.csv,2018,0.0,1.0
21911,Listen to Your Heart,23148,0,23148,2011.csv,2011,0.0,1.0
21912,When a Man Comes Home 2011 Re-release,23141,0,23141,2011.csv,2011,0.0,1.0
21913,For Ahkeem,23136,23136,0,2017.csv,2017,1.0,0.0
21914,The Judge,23127,22257,870,2018.csv,2018,0.9623816318588663,0.03761836814113374
21915,Na Maloom Afraad 2,23124,0,23124,2017.csv,2017,0.0,1.0
21916,Gary Numan: Android in La La Land,23121,0,23121,2016.csv,2016,0.0,1.0
21917,Olvidate Da Link,23117,0,23117,2018.csv,2018,0.0,1.0
21918,Finding Oscar,23116,23116,0,2017.csv,2017,1.0,0.0
21919,The Iran Job,23115,23115,0,2012.csv,2012,1.0,0.0
21920,Gece Seansi,23114,0,23114,2016.csv,2016,0.0,1.0
21921,Lost in London,23102,0,23102,2017.csv,2017,0.0,1.0
21922,VFW,23101,0,23101,2020.csv,2020,0.0,1.0
21923,Impepata di nozze,23099,0,23099,2012.csv,2012,0.0,1.0
21924,Inevitable,23098,0,23098,2014.csv,2014,0.0,1.0
21925,Gukoroku - Traces of Sin,23096,0,23096,2019.csv,2019,0.0,1.0
21926,Tucked,23080,0,23080,2019.csv,2019,0.0,1.0
21927,The Grace of Jake,23078,23078,0,2017.csv,2017,1.0,0.0
21928,Premature,23071,23071,0,2020.csv,2020,1.0,0.0
21929,Three Peaks,23069,16216,6853,2018.csv,2018,0.7029346742381551,0.2970653257618449
21930,Soldiers: Story from Ferentari,23057,0,23057,2018.csv,2018,0.0,1.0
21931,History of Jazz: Oxygen for the Ears,23048,23048,0,2014.csv,2014,1.0,0.0
21932,Video Games: The Movie,23043,23043,0,2014.csv,2014,1.0,0.0
21933,Faster Fene,23031,0,23031,2017.csv,2017,0.0,1.0
21934,State Funeral,23024,0,23024,2019.csv,2019,0.0,1.0
21935,Aquí y Allá: Here and There,23022,0,23022,2013.csv,2013,0.0,1.0
21936,Goat,23020,23020,0,2016.csv,2016,1.0,0.0
21937,The God of Wood,23017,0,23017,2010.csv,2010,0.0,1.0
21938,The Castle,22993,0,22993,2020.csv,2020,0.0,1.0
21939,The Third Side of the River,22990,0,22990,2014.csv,2014,0.0,1.0
21940,Move the Grave,22981,0,22981,2020.csv,2020,0.0,1.0
21941,Kirrak Party,22977,0,22977,2018.csv,2018,0.0,1.0
21942,Diamantes negros,22974,0,22974,2013.csv,2013,0.0,1.0
21943,The Liar,22953,0,22953,2015.csv,2015,0.0,1.0
21944,El Secreto De Lucia,22948,0,22948,2014.csv,2014,0.0,1.0
21945,The Pinkies Are Back,22947,0,22947,2021.csv,2021,0.0,1.0
21946,Aftermath 2019 Re-release,22935,0,22935,2019.csv,2019,0.0,1.0
21947,Abraham,22929,0,22929,2015.csv,2015,0.0,1.0
21948,Nobody's Watching,22928,0,22928,2017.csv,2017,0.0,1.0
21949,Hero Song,22917,0,22917,2019.csv,2019,0.0,1.0
21950,Wrinkles 2013 Re-release,22916,0,22916,2013.csv,2013,0.0,1.0
21951,Homeland,22903,0,22903,2014.csv,2014,0.0,1.0
21952,Mong songkraam weeraburut,22898,0,22898,2012.csv,2012,0.0,1.0
21953,Hellbound?,22887,22887,0,2012.csv,2012,1.0,0.0
21954,Mirza's Lady,22886,0,22886,2016.csv,2016,0.0,1.0
21955,Still Life,22864,0,22864,2012.csv,2012,0.0,1.0
21956,A Coleção Invisível,22852,0,22852,2013.csv,2013,0.0,1.0
21957,The Last Ice Hunters,22847,0,22847,2018.csv,2018,0.0,1.0
21958,Morg,22846,0,22846,2017.csv,2017,0.0,1.0
21959,Robinson in Ruins,22845,0,22845,2010.csv,2010,0.0,1.0
21960,Shelter,22837,0,22837,2011.csv,2011,0.0,1.0
21961,NTR: Mahanayakudu,22837,0,22837,2019.csv,2019,0.0,1.0
21962,Surveillance 2010 Re-release,22829,0,22829,2010.csv,2010,0.0,1.0
21963,Omnivores,22826,0,22826,2013.csv,2013,0.0,1.0
21964,Keyhole,22826,22826,0,2012.csv,2012,1.0,0.0
21965,La sublevación,22812,0,22812,2013.csv,2013,0.0,1.0
21966,A History of Jealousy,22781,0,22781,2019.csv,2019,0.0,1.0
21967,Prospect,22777,0,22777,2019.csv,2019,0.0,1.0
21968,Musabbar,22767,0,22767,2019.csv,2019,0.0,1.0
21969,The Long Day Closes,22765,22765,0,2012.csv,2012,1.0,0.0
21970,Outback,22764,0,22764,2020.csv,2020,0.0,1.0
21971,Rabbi Wolff,22755,0,22755,2016.csv,2016,0.0,1.0
21972,Carol Channing: Larger Than Life,22740,22740,0,2012.csv,2012,1.0,0.0
21973,Berg Fidel,22734,0,22734,2012.csv,2012,0.0,1.0
21974,B-Movie: Lust & Sound in West-Berlin 1979-1989,22721,0,22721,2015.csv,2015,0.0,1.0
21975,Zé Pedro Rock'n'Roll,22706,0,22706,2020.csv,2020,0.0,1.0
21976,Adventure Journey,22698,0,22698,2019.csv,2019,0.0,1.0
21977,Twin Peaks: Fire Walk with Me 2017 Re-release,22696,0,22696,2017.csv,2017,0.0,1.0
21978,Tender Son: The Frankenstein Project,22673,0,22673,2011.csv,2011,0.0,1.0
21979,Pleasant Goat and Big Big Wolf: Amazing Pleasant Goat 2019 Re-release,22665,0,22665,2019.csv,2019,0.0,1.0
21980,Gifted 2019 Re-release,22664,0,22664,2019.csv,2019,0.0,1.0
21981,The Revisionaries,22664,22664,0,2012.csv,2012,1.0,0.0
21982,La banda Grossi,22662,0,22662,2018.csv,2018,0.0,1.0
21983,Le Ride,22658,0,22658,2016.csv,2016,0.0,1.0
21984,Cowboy,22656,0,22656,2011.csv,2011,0.0,1.0
21985,Roba da matti,22636,0,22636,2012.csv,2012,0.0,1.0
21986,A Oeste do Fim do Mundo,22619,0,22619,2014.csv,2014,0.0,1.0
21987,my suburban stories,22618,0,22618,2017.csv,2017,0.0,1.0
21988,Muppozhudhum Un Karpanaigal,22614,0,22614,2012.csv,2012,0.0,1.0
21989,Killing God,22603,0,22603,2018.csv,2018,0.0,1.0
21990,Lucania,22595,0,22595,2019.csv,2019,0.0,1.0
21991,Ode to Joy,22594,17303,5291,2019.csv,2019,0.7658227848101266,0.23417721518987342
21992,Gone Fishing 2014 Re-release,22590,0,22590,2014.csv,2014,0.0,1.0
21993,Corporate Animals,22588,0,22588,2019.csv,2019,0.0,1.0
21994,Kalevala - uusi aika,22588,0,22588,2013.csv,2013,0.0,1.0
21995,Trophy,22553,21439,1114,2017.csv,2017,0.9506052409878952,0.04939475901210482
21996,L'Innocente,22549,22549,0,2020.csv,2020,1.0,0.0
21997,No Choice,22542,0,22542,2018.csv,2018,0.0,1.0
21998,The Other City,22539,22539,0,2010.csv,2010,1.0,0.0
21999,Anything,22537,19037,3500,2018.csv,2018,0.8446998269512358,0.15530017304876426
22000,The Long Night of Francisco Sanctis,22537,0,22537,2016.csv,2016,0.0,1.0
22001,The Black Dove,22517,22517,0,2016.csv,2016,1.0,0.0
22002,Nobody from Nowhere 2016 Re-release,22511,0,22511,2016.csv,2016,0.0,1.0
22003,Sacrifice,22504,0,22504,2016.csv,2016,0.0,1.0
22004,Aficionados,22503,0,22503,2011.csv,2011,0.0,1.0
22005,Casting By,22497,18164,4333,2013.csv,2013,0.8073965417611237,0.19260345823887629
22006,Middleground,22490,0,22490,2017.csv,2017,0.0,1.0
22007,Crime in Our Neighborhood,22475,0,22475,2011.csv,2011,0.0,1.0
22008,Reykjavik-Rotterdam 2010 Re-release,22472,0,22472,2010.csv,2010,0.0,1.0
22009,Atakan,22466,0,22466,2020.csv,2020,0.0,1.0
22010,Happy Tears,22464,22464,0,2010.csv,2010,1.0,0.0
22011,Incendiary,22457,22457,0,2011.csv,2011,1.0,0.0
22012,Falling Star,22455,0,22455,2014.csv,2014,0.0,1.0
22013,Fresh Meat,22455,0,22455,2012.csv,2012,0.0,1.0
22014,Realms,22443,147,22296,2017.csv,2017,0.006549926480417056,0.9934500735195829
22015,Kamikaze 89,22440,22440,0,2016.csv,2016,1.0,0.0
22016,Taipei Story 2019 Re-release,22439,0,22439,2019.csv,2019,0.0,1.0
22017,Asfouri,22426,0,22426,2013.csv,2013,0.0,1.0
22018,Be Here Now,22424,22424,0,2016.csv,2016,1.0,0.0
22019,Lost in France,22421,0,22421,2017.csv,2017,0.0,1.0
22020,Safar Edtirari,22418,0,22418,2019.csv,2019,0.0,1.0
22021,Being Good,22396,0,22396,2016.csv,2016,0.0,1.0
22022,Anti Matter,22384,0,22384,2019.csv,2019,0.0,1.0
22023,Paradise Club,22381,22381,0,2017.csv,2017,1.0,0.0
22024,La Candidata: Sólo nos salva la bruja,22380,0,22380,2019.csv,2019,0.0,1.0
22025,Salute! Sun Yat-Sen,22379,0,22379,2014.csv,2014,0.0,1.0
22026,In This Country You Do Not Believe,22376,0,22376,2018.csv,2018,0.0,1.0
22027,Picture Me,22369,12008,10361,2010.csv,2010,0.5368143412758729,0.46318565872412715
22028,Girl Model,22369,21154,1215,2012.csv,2012,0.9456837587733024,0.05431624122669766
22029,Maheshinte Prathikaaram,22361,0,22361,2016.csv,2016,0.0,1.0
22030,Project Ghazi,22346,0,22346,2019.csv,2019,0.0,1.0
22031,Hello!,22345,0,22345,2017.csv,2017,0.0,1.0
22032,Out of Crimes,22337,0,22337,2019.csv,2019,0.0,1.0
22033,DSP Dev,22331,0,22331,2019.csv,2019,0.0,1.0
22034,Faraar,22316,0,22316,2015.csv,2015,0.0,1.0
22035,The Painting,22313,21008,1305,2012.csv,2012,0.9415139156545511,0.058486084345448844
22036,Tar,22307,22307,0,2020.csv,2020,1.0,0.0
22037,Minte-ma frumos în Centrul Vechi,22307,0,22307,2016.csv,2016,0.0,1.0
22038,What Did I Mess,22303,0,22303,2019.csv,2019,0.0,1.0
22039,The Atomic Cafe,22293,22293,0,2018.csv,2018,1.0,0.0
22040,Metropolitan 2015 Re-release,22284,22284,0,2015.csv,2015,1.0,0.0
22041,The Redeemers,22283,0,22283,2021.csv,2021,0.0,1.0
22042,The Legend of King Solomon,22282,0,22282,2017.csv,2017,0.0,1.0
22043,A Lone Tree,22279,0,22279,2010.csv,2010,0.0,1.0
22044,Jedlíci aneb Sto kilo lásky,22278,0,22278,2013.csv,2013,0.0,1.0
22045,Slow Learners,22272,22272,0,2015.csv,2015,1.0,0.0
22046,Generation Startup,22271,22271,0,2016.csv,2016,1.0,0.0
22047,Reparation,22267,22267,0,2016.csv,2016,1.0,0.0
22048,Female Fight Squad,22253,0,22253,2017.csv,2017,0.0,1.0
22049,Pity the Lovers,22246,0,22246,2019.csv,2019,0.0,1.0
22050,Yaara O Dildaara,22245,0,22245,2011.csv,2011,0.0,1.0
22051,Locos de Amor,22244,0,22244,2017.csv,2017,0.0,1.0
22052,The Gruffalo's Child 2018 Re-release,22229,0,22229,2018.csv,2018,0.0,1.0
22053,Mamá,22221,0,22221,2017.csv,2017,0.0,1.0
22054,Butterfly 2010 Re-release,22219,0,22219,2010.csv,2010,0.0,1.0
22055,Copacabana Palace 2012 Re-release,22216,0,22216,2012.csv,2012,0.0,1.0
22056,Endless Night,22203,0,22203,2019.csv,2019,0.0,1.0
22057,The Announcement,22193,0,22193,2017.csv,2017,0.0,1.0
22058,The Forgotten Kingdom,22193,0,22193,2014.csv,2014,0.0,1.0
22059,Winning Formula,22189,22189,0,2018.csv,2018,1.0,0.0
22060,Friends with Kids 2014 Re-release,22181,0,22181,2014.csv,2014,0.0,1.0
22061,All's Faire in Love,22180,22180,0,2011.csv,2011,1.0,0.0
22062,Princess Cut,22167,22167,0,2015.csv,2015,1.0,0.0
22063,F20,22165,0,22165,2018.csv,2018,0.0,1.0
22064,Members Only,22163,0,22163,2017.csv,2017,0.0,1.0
22065,100 Days of Loneliness,22158,0,22158,2018.csv,2018,0.0,1.0
22066,We Will Be the World Champions,22150,0,22150,2015.csv,2015,0.0,1.0
22067,Dom vetra,22133,0,22133,2011.csv,2011,0.0,1.0
22068,Disparos,22129,0,22129,2012.csv,2012,0.0,1.0
22069,Richard Müller: Nespoznany,22117,0,22117,2016.csv,2016,0.0,1.0
22070,Soldier Jane,22108,0,22108,2013.csv,2013,0.0,1.0
22071,Murder Eleven,22107,22107,0,2013.csv,2013,1.0,0.0
22072,Mard Ko Dard Nahin Hota,22094,0,22094,2019.csv,2019,0.0,1.0
22073,The Garden of Eden,22083,22083,0,2010.csv,2010,1.0,0.0
22074,Losing Control,22081,22081,0,2012.csv,2012,1.0,0.0
22075,And Everything Is Going Fine,22080,22080,0,2010.csv,2010,1.0,0.0
22076,Room on the Broom 2018 Re-release,22072,0,22072,2018.csv,2018,0.0,1.0
22077,Four Adventures of Reinette and Mirabelle,22039,22039,0,2011.csv,2011,1.0,0.0
22078,Answers to Nothing,22029,22029,0,2011.csv,2011,1.0,0.0
22079,Rialto,22028,0,22028,2020.csv,2020,0.0,1.0
22080,Two Million Tears: Africa's Silent Epidemic,22025,0,22025,2011.csv,2011,0.0,1.0
22081,The Drummer and the Keeper,22012,0,22012,2017.csv,2017,0.0,1.0
22082,Lola Montès 2010 Re-release,22009,0,22009,2010.csv,2010,0.0,1.0
22083,My Big Mama's Crazy Ride,22004,0,22004,2021.csv,2021,0.0,1.0
22084,Pet,22003,8004,13999,2016.csv,2016,0.3637685770122256,0.6362314229877744
22085,The Easy Way Out 2018 Re-release,22000,0,22000,2018.csv,2018,0.0,1.0
22086,Three Guys NAO,21997,0,21997,2016.csv,2016,0.0,1.0
22087,Silence 2013 Re-release,21995,0,21995,2013.csv,2013,0.0,1.0
22088,The Sound of Silence,21994,20013,1981,2019.csv,2019,0.9099299809038829,0.09007001909611713
22089,Had Samea Haga,21976,0,21976,2011.csv,2011,0.0,1.0
22090,Witness of Another World,21969,0,21969,2018.csv,2018,0.0,1.0
22091,Crazy About Tiffany's,21968,0,21968,2016.csv,2016,0.0,1.0
22092,The Highway Rat,21964,0,21964,2019.csv,2019,0.0,1.0
22093,A Real Vermeer 2018 Re-release,21963,0,21963,2018.csv,2018,0.0,1.0
22094,Albatross,21953,0,21953,2015.csv,2015,0.0,1.0
22095,Antoine and Sebastian 2015 Re-release,21949,0,21949,2015.csv,2015,0.0,1.0
22096,Seeing the Unseen,21948,0,21948,2019.csv,2019,0.0,1.0
22097,Da Daoli,21944,0,21944,2019.csv,2019,0.0,1.0
22098,Speed Sisters,21931,0,21931,2016.csv,2016,0.0,1.0
22099,Sound of Heimat - Deutschland singt,21931,0,21931,2012.csv,2012,0.0,1.0
22100,Mamarosh,21905,0,21905,2013.csv,2013,0.0,1.0
22101,The Big Sleep 2010 Re-release,21905,0,21905,2010.csv,2010,0.0,1.0
22102,Finding Steve McQueen,21905,0,21905,2019.csv,2019,0.0,1.0
22103,Kizim için,21900,0,21900,2014.csv,2014,0.0,1.0
22104,At the End of Daybreak,21900,0,21900,2010.csv,2010,0.0,1.0
22105,The Heart Dances - the journey of The Piano: the ballet,21883,0,21883,2019.csv,2019,0.0,1.0
22106,The Passion of Joan of Arc,21877,21877,0,2017.csv,2017,1.0,0.0
22107,Train to Busan 2020 Re-release,21876,0,21876,2020.csv,2020,0.0,1.0
22108,Deep Gold 3D,21868,12000,9868,2011.csv,2011,0.5487470276202671,0.45125297237973294
22109,The Foundling,21857,0,21857,2019.csv,2019,0.0,1.0
22110,Omsch,21853,0,21853,2013.csv,2013,0.0,1.0
22111,HIT,21852,0,21852,2020.csv,2020,0.0,1.0
22112,Bibliothèque Pascal,21851,0,21851,2010.csv,2010,0.0,1.0
22113,Donnie Darko 2016 Re-release,21840,0,21840,2016.csv,2016,0.0,1.0
22114,The ABCs of Death,21832,21832,0,2013.csv,2013,1.0,0.0
22115,Animals 2015 Re-release,21821,21821,0,2015.csv,2015,1.0,0.0
22116,Sorma neden,21820,0,21820,2018.csv,2018,0.0,1.0
22117,Viola,21818,21818,0,2013.csv,2013,1.0,0.0
22118,Are Marler,21809,0,21809,2017.csv,2017,0.0,1.0
22119,Tell No One 2010 Re-release,21807,0,21807,2010.csv,2010,0.0,1.0
22120,Max Beckmann - Departure,21799,0,21799,2013.csv,2013,0.0,1.0
22121,Otôto,21797,0,21797,2010.csv,2010,0.0,1.0
22122,A Boy and Sungreen,21795,0,21795,2019.csv,2019,0.0,1.0
22123,The Female Brain,21786,21786,0,2018.csv,2018,1.0,0.0
22124,The Ashram,21785,0,21785,2018.csv,2018,0.0,1.0
22125,The Petrov File,21782,0,21782,2015.csv,2015,0.0,1.0
22126,Samurai Cat 2,21782,0,21782,2015.csv,2015,0.0,1.0
22127,Spec. Zverynas,21781,0,21781,2019.csv,2019,0.0,1.0
22128,Return of the Don,21781,0,21781,2016.csv,2016,0.0,1.0
22129,Lamb of God 2011 Re-release,21777,0,21777,2011.csv,2011,0.0,1.0
22130,Number One 2019 Re-release,21761,0,21761,2019.csv,2019,0.0,1.0
22131,Les tribulations d'une caissière,21753,0,21753,2011.csv,2011,0.0,1.0
22132,The Nerd's Confession,21752,0,21752,2016.csv,2016,0.0,1.0
22133,La Haine 2020 Re-release,21747,0,21747,2020.csv,2020,0.0,1.0
22134,Lady Winsley,21740,0,21740,2019.csv,2019,0.0,1.0
22135,Margaret Mee e a Flor da Lua,21736,0,21736,2013.csv,2013,0.0,1.0
22136,Mala matura 1947,21726,0,21726,2011.csv,2011,0.0,1.0
22137,A Night of Horror: Nightmare Radio,21725,0,21725,2020.csv,2020,0.0,1.0
22138,The Apple of My Eye,21724,0,21724,2016.csv,2016,0.0,1.0
22139,Love Love You,21713,0,21713,2015.csv,2015,0.0,1.0
22140,Above Suspicion,21712,0,21712,2019.csv,2019,0.0,1.0
22141,Garfield's Fun Fest 2013 Re-release,21705,0,21705,2013.csv,2013,0.0,1.0
22142,Occupation,21704,0,21704,2018.csv,2018,0.0,1.0
22143,Sniper Special Ops,21701,0,21701,2017.csv,2017,0.0,1.0
22144,The Godfather 2018 Re-release,21701,0,21701,2018.csv,2018,0.0,1.0
22145,Better Than Something: Jay Reatard,21697,21697,0,2012.csv,2012,1.0,0.0
22146,Galloping Mind,21696,0,21696,2015.csv,2015,0.0,1.0
22147,Dead Awake,21675,11528,10147,2017.csv,2017,0.5318569780853518,0.46814302191464824
22148,The Pension,21665,0,21665,2018.csv,2018,0.0,1.0
22149,Veerey Ki Wedding,21664,0,21664,2018.csv,2018,0.0,1.0
22150,Évocateur: The Morton Downey Jr. Movie,21652,21652,0,2013.csv,2013,1.0,0.0
22151,The Call of Destiny,21651,0,21651,2019.csv,2019,0.0,1.0
22152,Toe to Toe,21648,21648,0,2010.csv,2010,1.0,0.0
22153,Kapidaki Sir,21640,0,21640,2018.csv,2018,0.0,1.0
22154,The Divide,21639,0,21639,2016.csv,2016,0.0,1.0
22155,Sedona,21638,21638,0,2012.csv,2012,1.0,0.0
22156,Hong hun,21633,0,21633,2014.csv,2014,0.0,1.0
22157,Swandown,21632,0,21632,2012.csv,2012,0.0,1.0
22158,Funny Pets 2,21629,0,21629,2019.csv,2019,0.0,1.0
22159,Blue Jay,21626,21626,0,2016.csv,2016,1.0,0.0
22160,Empire Hotel,21623,0,21623,2019.csv,2019,0.0,1.0
22161,When You Wake Up,21621,0,21621,2014.csv,2014,0.0,1.0
22162,Feather Friends,21613,0,21613,2019.csv,2019,0.0,1.0
22163,Wicked Witches,21600,21600,0,2019.csv,2019,1.0,0.0
22164,Med hjertet i dansen,21590,0,21590,2016.csv,2016,0.0,1.0
22165,Half the Picture,21589,21589,0,2018.csv,2018,1.0,0.0
22166,The White Silk Dress 2010 Re-release,21588,0,21588,2010.csv,2010,0.0,1.0
22167,"Und in der Mitte, da sind wir",21582,0,21582,2014.csv,2014,0.0,1.0
22168,Waiting for Lightning,21577,21577,0,2012.csv,2012,1.0,0.0
22169,Guilty,21577,0,21577,2015.csv,2015,0.0,1.0
22170,Great Grand Masti,21567,0,21567,2016.csv,2016,0.0,1.0
22171,EXHIBITION: Munch 150,21565,0,21565,2013.csv,2013,0.0,1.0
22172,10 timer til Paradis,21561,16000,5561,2012.csv,2012,0.742080608506099,0.25791939149390103
22173,Beduin,21560,0,21560,2012.csv,2012,0.0,1.0
22174,Kee,21557,0,21557,2019.csv,2019,0.0,1.0
22175,Monogamy,21527,21527,0,2011.csv,2011,1.0,0.0
22176,Inflame,21527,0,21527,2017.csv,2017,0.0,1.0
22177,Vunnadhi Okate Zindagi,21520,0,21520,2017.csv,2017,0.0,1.0
22178,The Bystander,21516,0,21516,2020.csv,2020,0.0,1.0
22179,The Penitent Thief,21507,0,21507,2021.csv,2021,0.0,1.0
22180,Thank You for Your Service,21497,21497,0,2016.csv,2016,1.0,0.0
22181,Tara Mira,21496,0,21496,2019.csv,2019,0.0,1.0
22182,Stockholm Stories,21491,0,21491,2014.csv,2014,0.0,1.0
22183,Hagazussa,21487,13253,8234,2018.csv,2018,0.616791548378089,0.3832084516219109
22184,Anton Chekhov 1890,21462,0,21462,2016.csv,2016,0.0,1.0
22185,Morgen,21462,0,21462,2010.csv,2010,0.0,1.0
22186,Tommy 2019 Re-release,21461,0,21461,2019.csv,2019,0.0,1.0
22187,Tyrel,21456,21456,0,2018.csv,2018,1.0,0.0
22188,Mr. Long,21454,0,21454,2018.csv,2018,0.0,1.0
22189,Dvilypis Meiluzis,21449,0,21449,2017.csv,2017,0.0,1.0
22190,Kodathi Samaksham Balan Vakeel,21448,0,21448,2019.csv,2019,0.0,1.0
22191,Judas Priest: Epitaph,21424,0,21424,2013.csv,2013,0.0,1.0
22192,Yvy Maraey,21403,0,21403,2013.csv,2013,0.0,1.0
22193,Making the Grade,21400,0,21400,2018.csv,2018,0.0,1.0
22194,The Lost City 2010 Re-release,21393,0,21393,2010.csv,2010,0.0,1.0
22195,Gitme Baba,21391,0,21391,2013.csv,2013,0.0,1.0
22196,Last Train Home 2011 Re-release,21389,0,21389,2011.csv,2011,0.0,1.0
22197,Real Beleza,21382,0,21382,2015.csv,2015,0.0,1.0
22198,Cirque du Soleil: Delirium 2013 Re-release,21381,0,21381,2013.csv,2013,0.0,1.0
22199,Bucuresti NonStop,21379,0,21379,2015.csv,2015,0.0,1.0
22200,"Juana Azurduy, Guerrillera de la Patria Grande",21373,0,21373,2016.csv,2016,0.0,1.0
22201,Zombie,21372,0,21372,2016.csv,2016,0.0,1.0
22202,Woman in a Dressing Gown,21371,0,21371,2012.csv,2012,0.0,1.0
22203,An Evening with George Smiley,21370,0,21370,2017.csv,2017,0.0,1.0
22204,The Code of Cain,21367,0,21367,2016.csv,2016,0.0,1.0
22205,Yatagan,21366,0,21366,2020.csv,2020,0.0,1.0
22206,Song Of Granite,21349,16182,5167,2017.csv,2017,0.7579746123940231,0.24202538760597686
22207,"On the road, Khaosan Tango",21342,0,21342,2020.csv,2020,0.0,1.0
22208,Oscuridad,21336,0,21336,2019.csv,2019,0.0,1.0
22209,Gercek Kesit: Manyak,21321,0,21321,2018.csv,2018,0.0,1.0
22210,4th Republic,21319,0,21319,2019.csv,2019,0.0,1.0
22211,Tio Papi,21316,21316,0,2013.csv,2013,1.0,0.0
22212,[REC] 3: Genesis 2014 Re-release,21308,0,21308,2014.csv,2014,0.0,1.0
22213,The Intent,21305,0,21305,2016.csv,2016,0.0,1.0
22214,Andrei Rublev,21302,0,21302,2016.csv,2016,0.0,1.0
22215,The Honourable Rebel,21297,0,21297,2015.csv,2015,0.0,1.0
22216,Memphis,21286,21286,0,2014.csv,2014,1.0,0.0
22217,Gandarrapiddo: The Revenger Squad,21275,0,21275,2017.csv,2017,0.0,1.0
22218,El Padre De Gardel,21275,0,21275,2014.csv,2014,0.0,1.0
22219,Outside Bet,21274,0,21274,2012.csv,2012,0.0,1.0
22220,Escape from Tibet,21272,0,21272,2012.csv,2012,0.0,1.0
22221,Toz Bezi,21254,0,21254,2015.csv,2015,0.0,1.0
22222,Resurrect Dead: The Mystery of the Toynbee Tiles,21242,21242,0,2011.csv,2011,1.0,0.0
22223,A Matter of Size,21239,0,21239,2010.csv,2010,0.0,1.0
22224,The First Line,21233,0,21233,2014.csv,2014,0.0,1.0
22225,Casino Jack 2014 Re-release,21224,0,21224,2014.csv,2014,0.0,1.0
22226,Dark Crimes,21216,0,21216,2018.csv,2018,0.0,1.0
22227,Ratter,21214,0,21214,2016.csv,2016,0.0,1.0
22228,Already Tomorrow in Hong Kong,21206,21206,0,2016.csv,2016,1.0,0.0
22229,The Light from the Chocolate Factory,21200,0,21200,2020.csv,2020,0.0,1.0
22230,Ganja & Hess,21197,21197,0,2018.csv,2018,1.0,0.0
22231,"Reidy, a construção da utopia",21190,0,21190,2011.csv,2011,0.0,1.0
22232,Oniichan no hanabi,21189,0,21189,2011.csv,2011,0.0,1.0
22233,The Oscar Nominated Short Films 2016: Animation,21170,0,21170,2016.csv,2016,0.0,1.0
22234,The Pale Door,21166,0,21166,2020.csv,2020,0.0,1.0
22235,Toshimaen: Haunted Park,21161,0,21161,2020.csv,2020,0.0,1.0
22236,Hello Guru Prema Kosame,21160,0,21160,2018.csv,2018,0.0,1.0
22237,The Magic of Hope,21158,0,21158,2011.csv,2011,0.0,1.0
22238,Yeni Dünya,21153,0,21153,2015.csv,2015,0.0,1.0
22239,I Am Not a Serial Killer,21148,0,21148,2016.csv,2016,0.0,1.0
22240,NightLights,21147,21147,0,2014.csv,2014,1.0,0.0
22241,Silent Voice,21147,0,21147,2010.csv,2010,0.0,1.0
22242,Matar el tiempo,21146,0,21146,2015.csv,2015,0.0,1.0
22243,Valley of Shadows,21144,0,21144,2017.csv,2017,0.0,1.0
22244,"Morgen, ihr Luschen! Der Ausbilder-Schmidt-Film 2011 Re-release",21142,0,21142,2011.csv,2011,0.0,1.0
22245,Eye on Juliet,21140,0,21140,2019.csv,2019,0.0,1.0
22246,God Knows Where I Am,21135,21135,0,2017.csv,2017,1.0,0.0
22247,Shadow Behind,21133,0,21133,2016.csv,2016,0.0,1.0
22248,One of Us,21132,0,21132,2015.csv,2015,0.0,1.0
22249,Seneca's Day,21121,0,21121,2016.csv,2016,0.0,1.0
22250,The Marsh 2012 Re-release,21121,0,21121,2012.csv,2012,0.0,1.0
22251,The Happys,21108,21108,0,2018.csv,2018,1.0,0.0
22252,Massacre on Aisle 12,21106,21106,0,2017.csv,2017,1.0,0.0
22253,Ver Kaç,21097,0,21097,2017.csv,2017,0.0,1.0
22254,The Achy Breaky Hearts,21096,0,21096,2016.csv,2016,0.0,1.0
22255,Meat,21087,0,21087,2017.csv,2017,0.0,1.0
22256,Net I Die,21073,0,21073,2017.csv,2017,0.0,1.0
22257,Balloon,21071,0,21071,2017.csv,2017,0.0,1.0
22258,Mali,21062,0,21062,2019.csv,2019,0.0,1.0
22259,Duck Town,21052,0,21052,2018.csv,2018,0.0,1.0
22260,The Last Diamond 2015 Re-release,21045,0,21045,2015.csv,2015,0.0,1.0
22261,Il Ministro,21033,0,21033,2017.csv,2017,0.0,1.0
22262,A Beginner's Guide to Snuff,21031,21031,0,2017.csv,2017,1.0,0.0
22263,Love is Potatoes,21014,0,21014,2017.csv,2017,0.0,1.0
22264,Sabre Dance,21011,0,21011,2020.csv,2020,0.0,1.0
22265,Hoa Fi Kidah,21010,0,21010,2013.csv,2013,0.0,1.0
22266,Kinavally,21001,0,21001,2018.csv,2018,0.0,1.0
22267,Snowfall in Taipei,20996,0,20996,2012.csv,2012,0.0,1.0
22268,Kir,20996,0,20996,2011.csv,2011,0.0,1.0
22269,Shaun of the Dead 2020 Re-release,20990,0,20990,2020.csv,2020,0.0,1.0
22270,Rüzgarda salinan nilüfer,20983,0,20983,2016.csv,2016,0.0,1.0
22271,Loving in Tandem,20980,0,20980,2017.csv,2017,0.0,1.0
22272,Lahore Se Aagey,20979,0,20979,2016.csv,2016,0.0,1.0
22273,Yolculuk,20973,0,20973,2016.csv,2016,0.0,1.0
22274,Love at the End of the World,20951,0,20951,2015.csv,2015,0.0,1.0
22275,The Sacrifice 2014 Re-release,20945,20945,0,2014.csv,2014,1.0,0.0
22276,Round of Your Life,20941,20941,0,2019.csv,2019,1.0,0.0
22277,Murder on the Orient Express 2017 Re-release,20941,0,20941,2017.csv,2017,0.0,1.0
22278,Ava,20940,20940,0,2018.csv,2018,1.0,0.0
22279,Themba,20937,0,20937,2010.csv,2010,0.0,1.0
22280,Fabulous,20932,0,20932,2020.csv,2020,0.0,1.0
22281,Black Cossack,20920,0,20920,2018.csv,2018,0.0,1.0
22282,Man Underground,20907,20907,0,2017.csv,2017,1.0,0.0
22283,"Anthony, Warrior of God 2010 Re-release",20904,0,20904,2010.csv,2010,0.0,1.0
22284,Poteryannyy ostrov,20902,0,20902,2019.csv,2019,0.0,1.0
22285,Chasing the Present,20891,0,20891,2020.csv,2020,0.0,1.0
22286,Camino Sinuoso,20889,0,20889,2018.csv,2018,0.0,1.0
22287,Paso a paso,20888,0,20888,2015.csv,2015,0.0,1.0
22288,National Theatre Live: Allelujah!,20884,0,20884,2019.csv,2019,0.0,1.0
22289,El Bella Vista,20877,0,20877,2013.csv,2013,0.0,1.0
22290,Gyvenimas pries akis,20875,0,20875,2017.csv,2017,0.0,1.0
22291,Lekar Hum Deewana Dil,20874,20874,0,2014.csv,2014,1.0,0.0
22292,Köksüz,20850,0,20850,2014.csv,2014,0.0,1.0
22293,Big Miracle 2021 Re-release,20846,0,20846,2021.csv,2021,0.0,1.0
22294,Cameraman: The Life and Work of Jack Cardiff,20840,20840,0,2011.csv,2011,1.0,0.0
22295,Tzarevna Scaling,20839,0,20839,2020.csv,2020,0.0,1.0
22296,La patria equivocada,20837,0,20837,2011.csv,2011,0.0,1.0
22297,Hunted,20829,0,20829,2015.csv,2015,0.0,1.0
22298,After School,20829,0,20829,2010.csv,2010,0.0,1.0
22299,Darkland,20827,0,20827,2017.csv,2017,0.0,1.0
22300,The Devil's Rock,20823,0,20823,2011.csv,2011,0.0,1.0
22301,"Worst Case, We Get Married",20818,0,20818,2019.csv,2019,0.0,1.0
22302,Submerged,20813,0,20813,2016.csv,2016,0.0,1.0
22303,Home from Home: Chronicle of a Vision 2015 Re-release,20807,0,20807,2015.csv,2015,0.0,1.0
22304,Time Changer 2016 Re-release,20797,20797,0,2016.csv,2016,1.0,0.0
22305,Night Bus to Lagos,20788,0,20788,2019.csv,2019,0.0,1.0
22306,Korporatsiya Ad Libitum,20779,0,20779,2021.csv,2021,0.0,1.0
22307,Jackboots on Whitehall,20776,0,20776,2010.csv,2010,0.0,1.0
22308,Lemon Tree Passage 2016 Re-release,20773,0,20773,2016.csv,2016,0.0,1.0
22309,Cafard,20771,0,20771,2015.csv,2015,0.0,1.0
22310,Did You Wonder Who Fired the Gun?,20765,20765,0,2018.csv,2018,1.0,0.0
22311,All These Sleepless Nights,20762,20762,0,2017.csv,2017,1.0,0.0
22312,Georg Baselitz,20760,0,20760,2013.csv,2013,0.0,1.0
22313,For Ellen,20746,12396,8350,2012.csv,2012,0.5975127735467078,0.4024872264532922
22314,What Keeps You Alive,20746,0,20746,2019.csv,2019,0.0,1.0
22315,Extracurricular,20745,0,20745,2019.csv,2019,0.0,1.0
22316,Caracremada,20735,0,20735,2010.csv,2010,0.0,1.0
22317,Pelmeni,20735,0,20735,2013.csv,2013,0.0,1.0
22318,"I, Dolours",20721,0,20721,2018.csv,2018,0.0,1.0
22319,The Ghosts in Our Machine,20709,20709,0,2013.csv,2013,1.0,0.0
22320,In the Crosswind,20705,0,20705,2016.csv,2016,0.0,1.0
22321,The African Queen 2011 Re-release,20705,0,20705,2011.csv,2011,0.0,1.0
22322,Jules and Jim 2019 Re-release,20704,0,20704,2019.csv,2019,0.0,1.0
22323,Bana Bir Ask Sarkisi Söyle,20698,0,20698,2019.csv,2019,0.0,1.0
22324,Tus padres volverán,20698,0,20698,2015.csv,2015,0.0,1.0
22325,The Great Flood,20694,20694,0,2014.csv,2014,1.0,0.0
22326,"AKA Shaman: Which Came First, the Toxic Chicken or the Poison Egg?",20687,0,20687,2016.csv,2016,0.0,1.0
22327,The Ice Dragon,20683,0,20683,2013.csv,2013,0.0,1.0
22328,Code Name Venus,20683,0,20683,2012.csv,2012,0.0,1.0
22329,Lady Driver,20682,0,20682,2020.csv,2020,0.0,1.0
22330,Morente,20676,0,20676,2011.csv,2011,0.0,1.0
22331,Song for turbulent youth,20676,0,20676,2019.csv,2019,0.0,1.0
22332,The Duel,20672,0,20672,2016.csv,2016,0.0,1.0
22333,Girls Always Happy,20671,0,20671,2019.csv,2019,0.0,1.0
22334,Jeunesse sauvage,20669,0,20669,2020.csv,2020,0.0,1.0
22335,The Power of Few 2014 Re-release,20659,0,20659,2014.csv,2014,0.0,1.0
22336,Freak Show,20657,19696,961,2018.csv,2018,0.9534782398218522,0.046521760178147846
22337,Majaneen Noskom,20656,0,20656,2010.csv,2010,0.0,1.0
22338,Exhibition on Screen: Raphael Revealed,20643,0,20643,2020.csv,2020,0.0,1.0
22339,Days of the Whale,20631,0,20631,2019.csv,2019,0.0,1.0
22340,Monsters.,20620,0,20620,2019.csv,2019,0.0,1.0
22341,Rakraek Rakther Raksudthai,20620,0,20620,2011.csv,2011,0.0,1.0
22342,Douchebag,20615,20615,0,2010.csv,2010,1.0,0.0
22343,Masha and the Bear 2020 Re-release,20600,0,20600,2020.csv,2020,0.0,1.0
22344,Zenitram,20600,0,20600,2010.csv,2010,0.0,1.0
22345,Kill Me Please 2012 Re-release,20594,0,20594,2012.csv,2012,0.0,1.0
22346,Marry a Perfect Man,20594,0,20594,2012.csv,2012,0.0,1.0
22347,Mehrunisa V Lub U,20587,0,20587,2017.csv,2017,0.0,1.0
22348,Our Nixon,20584,20584,0,2013.csv,2013,1.0,0.0
22349,To My Beloved,20584,0,20584,2016.csv,2016,0.0,1.0
22350,Las toninas van al Este,20582,0,20582,2016.csv,2016,0.0,1.0
22351,Seis días en la oscuridad 2015 Re-release,20578,0,20578,2015.csv,2015,0.0,1.0
22352,Jawaan,20571,0,20571,2017.csv,2017,0.0,1.0
22353,Fidelio: Alice's Odyssey,20571,3580,16991,2015.csv,2015,0.17403140343201595,0.825968596567984
22354,Coming Up Roses 2014 Re-release,20567,20567,0,2014.csv,2014,1.0,0.0
22355,Around the World in 50 Concerts,20563,0,20563,2014.csv,2014,0.0,1.0
22356,Band of Robbers,20555,20555,0,2016.csv,2016,1.0,0.0
22357,The Work,20554,5853,14701,2017.csv,2017,0.28476209010411596,0.715237909895884
22358,Ice Dragon: Legend of the Blue Daisies,20549,20549,0,2018.csv,2018,1.0,0.0
22359,Van Wilder: Freshman Year,20543,0,20543,2012.csv,2012,0.0,1.0
22360,Christmas with the Kranks 2017 Re-release,20538,0,20538,2017.csv,2017,0.0,1.0
22361,Brief Encounter 2010 Re-release,20535,0,20535,2010.csv,2010,0.0,1.0
22362,Sobral: O Homem Que Não Tinha Preço,20531,0,20531,2013.csv,2013,0.0,1.0
22363,Vaanam Kottattum,20524,0,20524,2020.csv,2020,0.0,1.0
22364,Twixt 2014 Re-release,20512,0,20512,2014.csv,2014,0.0,1.0
22365,The Furies 2020 Re-release,20510,0,20510,2020.csv,2020,0.0,1.0
22366,"Vecher shutov, ili Serezno s privetom",20510,0,20510,2020.csv,2020,0.0,1.0
22367,This Last Lonely Place,20507,20507,0,2016.csv,2016,1.0,0.0
22368,Make More Noise! Suffrafettes in Silent Film,20505,0,20505,2015.csv,2015,0.0,1.0
22369,Loser's Adventure,20502,0,20502,2018.csv,2018,0.0,1.0
22370,22 Yards,20497,0,20497,2019.csv,2019,0.0,1.0
22371,Jour de Fête,20496,0,20496,2013.csv,2013,0.0,1.0
22372,Consumed,20476,20476,0,2015.csv,2015,1.0,0.0
22373,Sister Brother Forever,20449,0,20449,2017.csv,2017,0.0,1.0
22374,The Devil and Father Amorth,20449,20449,0,2018.csv,2018,1.0,0.0
22375,Boy Meets Girl,20441,20441,0,2015.csv,2015,1.0,0.0
22376,The Night I Swam,20440,0,20440,2019.csv,2019,0.0,1.0
22377,Crypto,20440,0,20440,2019.csv,2019,0.0,1.0
22378,Burden,20437,18440,1997,2017.csv,2017,0.9022850711944023,0.09771492880559769
22379,Never,20431,20431,0,2016.csv,2016,1.0,0.0
22380,Zagreb Equinox,20427,0,20427,2020.csv,2020,0.0,1.0
22381,Roll Bounce 2020 Re-release,20424,0,20424,2020.csv,2020,0.0,1.0
22382,Soldiers Without Guns,20416,0,20416,2019.csv,2019,0.0,1.0
22383,Attention: A Life in Extremes,20410,0,20410,2014.csv,2014,0.0,1.0
22384,Super Toy,20410,0,20410,2016.csv,2016,0.0,1.0
22385,Eloise 2017 Re-release,20403,0,20403,2017.csv,2017,0.0,1.0
22386,The Unseen,20400,0,20400,2017.csv,2017,0.0,1.0
22387,Reunion,20394,0,20394,2020.csv,2020,0.0,1.0
22388,The Highest Pass,20386,20386,0,2012.csv,2012,1.0,0.0
22389,Shaket Dabous,20385,0,20385,2016.csv,2016,0.0,1.0
22390,Vegetarian,20380,0,20380,2010.csv,2010,0.0,1.0
22391,Linea di Konfine,20377,0,20377,2010.csv,2010,0.0,1.0
22392,July,20367,0,20367,2013.csv,2013,0.0,1.0
22393,The Boy from Ipanema,20356,0,20356,2010.csv,2010,0.0,1.0
22394,Thursday Till Sunday,20355,0,20355,2013.csv,2013,0.0,1.0
22395,Eisenstein in Guanajuato,20346,0,20346,2015.csv,2015,0.0,1.0
22396,Alcatraz,20342,0,20342,2019.csv,2019,0.0,1.0
22397,Vida Sobre Rodas,20342,0,20342,2010.csv,2010,0.0,1.0
22398,The Lawyer,20325,0,20325,2020.csv,2020,0.0,1.0
22399,The All Americans,20324,20324,0,2019.csv,2019,1.0,0.0
22400,Oblivion Island: Haruka and the Magic Mirror 2010 Re-release,20323,0,20323,2010.csv,2010,0.0,1.0
22401,Mazylio Nikolia atostogos,20322,0,20322,2014.csv,2014,0.0,1.0
22402,Arjun Suravaram,20317,0,20317,2019.csv,2019,0.0,1.0
22403,Rudolfa mantojums,20317,0,20317,2010.csv,2010,0.0,1.0
22404,xABo: Ksiadz Boniecki,20309,0,20309,2020.csv,2020,0.0,1.0
22405,Daivathinte Swantham Cleetus,20305,0,20305,2013.csv,2013,0.0,1.0
22406,Katie,20287,0,20287,2018.csv,2018,0.0,1.0
22407,Koroshiya 1 2017 Re-release,20285,20285,0,2017.csv,2017,1.0,0.0
22408,The Korean,20279,20279,0,2010.csv,2010,1.0,0.0
22409,Charleston,20270,0,20270,2018.csv,2018,0.0,1.0
22410,5 A.M.,20256,0,20256,2016.csv,2016,0.0,1.0
22411,Lanet: Uyanis,20228,0,20228,2016.csv,2016,0.0,1.0
22412,The Sleeping Voice 2013 Re-release,20228,0,20228,2013.csv,2013,0.0,1.0
22413,La Polinesia è sotto casa,20221,0,20221,2010.csv,2010,0.0,1.0
22414,Sagrada: The Mystery of Creation,20218,0,20218,2013.csv,2013,0.0,1.0
22415,Double Take,20218,20218,0,2010.csv,2010,1.0,0.0
22416,Amulet,20209,0,20209,2020.csv,2020,0.0,1.0
22417,Izzy Gets the F*ck Across Town,20208,20208,0,2018.csv,2018,1.0,0.0
22418,Sense from Siam,20208,0,20208,2016.csv,2016,0.0,1.0
22419,New World Order,20205,20205,0,2016.csv,2016,1.0,0.0
22420,It's Not Forever,20200,0,20200,2019.csv,2019,0.0,1.0
22421,Mamnoun Min El Ektirab,20195,0,20195,2017.csv,2017,0.0,1.0
22422,Courier,20192,0,20192,2020.csv,2020,0.0,1.0
22423,Jesus Henry Christ,20183,20183,0,2012.csv,2012,1.0,0.0
22424,Shoah,20175,20175,0,2010.csv,2010,1.0,0.0
22425,City of Gold 2018 Re-release,20173,0,20173,2018.csv,2018,0.0,1.0
22426,Hayati Tehlike,20162,0,20162,2016.csv,2016,0.0,1.0
22427,Friends and Romans,20136,20136,0,2015.csv,2015,1.0,0.0
22428,How to Grow a Band,20135,20135,0,2012.csv,2012,1.0,0.0
22429,Familia para armar,20126,0,20126,2011.csv,2011,0.0,1.0
22430,L'apôtre,20120,0,20120,2015.csv,2015,0.0,1.0
22431,My Grandmother Fanny Kaplan,20116,0,20116,2016.csv,2016,0.0,1.0
22432,"Dhaulagiri, ascenso a la montaña blanca",20111,0,20111,2017.csv,2017,0.0,1.0
22433,Kauwboy,20104,0,20104,2012.csv,2012,0.0,1.0
22434,The Man from Outer Space,20102,20102,0,2017.csv,2017,1.0,0.0
22435,Love Me True,20100,20100,0,2016.csv,2016,1.0,0.0
22436,Baba Yaga. The Beginning,20097,0,20097,2018.csv,2018,0.0,1.0
22437,Baba Nerdesin Kayboldum,20079,0,20079,2018.csv,2018,0.0,1.0
22438,Squat32,20077,0,20077,2019.csv,2019,0.0,1.0
22439,Kill Me Please,20065,0,20065,2016.csv,2016,0.0,1.0
22440,Joe Hua Tang Mo,20065,0,20065,2015.csv,2015,0.0,1.0
22441,The Other Side,20062,0,20062,2019.csv,2019,0.0,1.0
22442,Consequences,20056,0,20056,2018.csv,2018,0.0,1.0
22443,The Past Is a Grotesque Animal,20056,20056,0,2014.csv,2014,1.0,0.0
22444,Apocalypsis,20052,20052,0,2018.csv,2018,1.0,0.0
22445,Misión en Mocland - Una aventura super espacial 2011 Re-release,20049,0,20049,2011.csv,2011,0.0,1.0
22446,Maleika,20047,0,20047,2019.csv,2019,0.0,1.0
22447,General Magic,20046,20046,0,2019.csv,2019,1.0,0.0
22448,The Gospel of Eureka,20039,20039,0,2019.csv,2019,1.0,0.0
22449,"No Pay, Nudity",20017,20017,0,2016.csv,2016,1.0,0.0
22450,Our Family,20014,0,20014,2014.csv,2014,0.0,1.0
22451,Angel,20010,0,20010,2017.csv,2017,0.0,1.0
22452,Lore,20006,20006,0,2020.csv,2020,1.0,0.0
22453,Children of the Snow Land,20001,0,20001,2019.csv,2019,0.0,1.0
22454,The Bromley Boys,19996,0,19996,2018.csv,2018,0.0,1.0
22455,Arctic,19993,0,19993,2016.csv,2016,0.0,1.0
22456,Little Hero,19990,0,19990,2019.csv,2019,0.0,1.0
22457,Lazer Team 2,19988,0,19988,2017.csv,2017,0.0,1.0
22458,Eight Hours Don't Make a Day,19987,19987,0,2018.csv,2018,1.0,0.0
22459,Dream and Silence,19979,0,19979,2012.csv,2012,0.0,1.0
22460,Die Hummel,19970,0,19970,2010.csv,2010,0.0,1.0
22461,Spookers,19970,0,19970,2017.csv,2017,0.0,1.0
22462,Present Perfect Continuous Tense,19968,0,19968,2013.csv,2013,0.0,1.0
22463,Who Finds a Friend Finds a Treasure,19957,0,19957,2017.csv,2017,0.0,1.0
22464,Bhoot 2010 Re-release,19930,0,19930,2010.csv,2010,0.0,1.0
22465,Instant Love,19928,0,19928,2020.csv,2020,0.0,1.0
22466,Summer Rebels,19923,0,19923,2020.csv,2020,0.0,1.0
22467,"One Sings, the Other Doesn't",19919,19919,0,2018.csv,2018,1.0,0.0
22468,How to Win Enemies,19919,0,19919,2015.csv,2015,0.0,1.0
22469,Together We Ate,19908,0,19908,2018.csv,2018,0.0,1.0
22470,Wedding Palace,19908,19908,0,2013.csv,2013,1.0,0.0
22471,The Shine of Day,19893,0,19893,2013.csv,2013,0.0,1.0
22472,Forbidden Games,19889,19889,0,2015.csv,2015,1.0,0.0
22473,"Thelma, Louise et Chantal",19888,0,19888,2010.csv,2010,0.0,1.0
22474,Foster Boy,19873,19873,0,2020.csv,2020,1.0,0.0
22475,Idhu Namma Aalu,19873,0,19873,2016.csv,2016,0.0,1.0
22476,Active Measures,19862,19862,0,2018.csv,2018,1.0,0.0
22477,Heat and Dust 2017 Re-release,19856,19856,0,2017.csv,2017,1.0,0.0
22478,Dogs Don't Wear Pants,19855,0,19855,2019.csv,2019,0.0,1.0
22479,Visions chamaniques,19832,0,19832,2020.csv,2020,0.0,1.0
22480,La Grande Illusion,19821,0,19821,2012.csv,2012,0.0,1.0
22481,Wild Canaries,19777,19777,0,2015.csv,2015,1.0,0.0
22482,Coriolanus 2015 Re-release,19776,0,19776,2015.csv,2015,0.0,1.0
22483,Wretches,19772,0,19772,2018.csv,2018,0.0,1.0
22484,Beyond the Sky,19761,0,19761,2021.csv,2021,0.0,1.0
22485,Critical Thinking,19757,0,19757,2020.csv,2020,0.0,1.0
22486,The Trial,19753,19753,0,2010.csv,2010,1.0,0.0
22487,As Needed,19751,0,19751,2019.csv,2019,0.0,1.0
22488,Wonderful Summer,19746,0,19746,2011.csv,2011,0.0,1.0
22489,The Ice King,19743,0,19743,2018.csv,2018,0.0,1.0
22490,Un buen día,19733,0,19733,2010.csv,2010,0.0,1.0
22491,Another Story of the World,19729,0,19729,2017.csv,2017,0.0,1.0
22492,Bitter/Sweet,19727,0,19727,2010.csv,2010,0.0,1.0
22493,Lahon W Habs,19722,0,19722,2019.csv,2019,0.0,1.0
22494,Sol Posto,19717,0,19717,2020.csv,2020,0.0,1.0
22495,The Haunting of Sharon Tate,19717,0,19717,2019.csv,2019,0.0,1.0
22496,The Anderssons Hit the Road 2015 Re-release,19717,0,19717,2015.csv,2015,0.0,1.0
22497,Ippadai Vellum,19710,0,19710,2017.csv,2017,0.0,1.0
22498,Dream,19707,0,19707,2016.csv,2016,0.0,1.0
22499,The Romans,19705,19705,0,2016.csv,2016,1.0,0.0
22500,Monster,19705,0,19705,2019.csv,2019,0.0,1.0
22501,Trafficked,19698,19698,0,2017.csv,2017,1.0,0.0
22502,Dennis Skinner: Nature of the Beast,19694,0,19694,2017.csv,2017,0.0,1.0
22503,L'erede - The Heir,19691,0,19691,2011.csv,2011,0.0,1.0
22504,Mindo Taseeldarni,19679,0,19679,2019.csv,2019,0.0,1.0
22505,Junho: O Mês que Abalou o Brasil,19674,0,19674,2014.csv,2014,0.0,1.0
22506,Küçük günahlar,19665,0,19665,2011.csv,2011,0.0,1.0
22507,No Estoy Loca,19662,0,19662,2018.csv,2018,0.0,1.0
22508,Bou Oyoun,19657,0,19657,2018.csv,2018,0.0,1.0
22509,Lock,19652,0,19652,2016.csv,2016,0.0,1.0
22510,The Racer,19651,0,19651,2019.csv,2019,0.0,1.0
22511,Memories of a Dead End,19650,0,19650,2019.csv,2019,0.0,1.0
22512,Pirates of the Caribbean: Dead Men Tell No Tales 2020 Re-release,19648,0,19648,2020.csv,2020,0.0,1.0
22513,Teli and Toli,19640,0,19640,2016.csv,2016,0.0,1.0
22514,Amma und Appa,19635,0,19635,2014.csv,2014,0.0,1.0
22515,Toks gyvenimas,19635,0,19635,2017.csv,2017,0.0,1.0
22516,Misery Loves Comedy,19634,19634,0,2015.csv,2015,1.0,0.0
22517,The Cleaner,19630,0,19630,2013.csv,2013,0.0,1.0
22518,Kazdy ma swoje lato,19619,0,19619,2021.csv,2021,0.0,1.0
22519,Bad Milo,19613,19613,0,2013.csv,2013,1.0,0.0
22520,Mary's Land 2015 Re-release,19609,0,19609,2015.csv,2015,0.0,1.0
22521,We Are the Night 2012 Re-release,19606,0,19606,2012.csv,2012,0.0,1.0
22522,Art Bastard,19600,19600,0,2016.csv,2016,1.0,0.0
22523,Uzumasa Limelight,19597,19597,0,2014.csv,2014,1.0,0.0
22524,Piégé,19585,0,19585,2016.csv,2016,0.0,1.0
22525,Koali & Rice,19583,0,19583,2020.csv,2020,0.0,1.0
22526,Zoology,19572,0,19572,2016.csv,2016,0.0,1.0
22527,Time Lapse,19572,0,19572,2016.csv,2016,0.0,1.0
22528,Paradise,19565,0,19565,2013.csv,2013,0.0,1.0
22529,The Young with No Fear,19564,0,19564,2017.csv,2017,0.0,1.0
22530,My Pure Land,19559,0,19559,2017.csv,2017,0.0,1.0
22531,Maldito Seas Waterfall!,19552,0,19552,2016.csv,2016,0.0,1.0
22532,Some Like It Hot 2018 Re-release,19542,0,19542,2018.csv,2018,0.0,1.0
22533,Behead the King,19537,0,19537,2017.csv,2017,0.0,1.0
22534,Damascus Cover,19532,0,19532,2018.csv,2018,0.0,1.0
22535,Comet,19530,8623,10907,2014.csv,2014,0.4415258576548899,0.5584741423451101
22536,The Man Inside,19527,0,19527,2012.csv,2012,0.0,1.0
22537,Hannah: Buddhism's Untold Journey,19526,396,19130,2016.csv,2016,0.02028065143910683,0.9797193485608932
22538,The Super,19513,0,19513,2018.csv,2018,0.0,1.0
22539,Murders At The House Of Death,19505,0,19505,2020.csv,2020,0.0,1.0
22540,BOSTON: An American Running Story 2017 Re-release,19499,19499,0,2017.csv,2017,1.0,0.0
22541,Grassroots,19492,12356,7136,2012.csv,2012,0.6339010876256926,0.3660989123743074
22542,The Dragon Defense,19491,0,19491,2017.csv,2017,0.0,1.0
22543,Postcard from Nowhere,19486,0,19486,2015.csv,2015,0.0,1.0
22544,Abood Kandaishan,19483,0,19483,2015.csv,2015,0.0,1.0
22545,In Over My Head,19482,19482,0,2012.csv,2012,1.0,0.0
22546,Guardian Angel,19480,19480,0,2014.csv,2014,1.0,0.0
22547,A Picture of You,19480,19480,0,2014.csv,2014,1.0,0.0
22548,Lust,19477,0,19477,2017.csv,2017,0.0,1.0
22549,Whensday,19463,19463,0,2013.csv,2013,1.0,0.0
22550,Hunter Gatherer,19462,19462,0,2016.csv,2016,1.0,0.0
22551,Asees,19458,0,19458,2018.csv,2018,0.0,1.0
22552,The Legend of Halloween Jack,19438,0,19438,2020.csv,2020,0.0,1.0
22553,90 Ml,19437,0,19437,2019.csv,2019,0.0,1.0
22554,Property of the State,19434,0,19434,2017.csv,2017,0.0,1.0
22555,Kharms,19431,0,19431,2017.csv,2017,0.0,1.0
22556,Skateland,19411,19411,0,2011.csv,2011,1.0,0.0
22557,A Cambodian Spring,19405,0,19405,2018.csv,2018,0.0,1.0
22558,Curse of the Nun,19396,0,19396,2019.csv,2019,0.0,1.0
22559,Mansfield 66/67,19390,17930,1460,2017.csv,2017,0.9247034553893759,0.07529654461062403
22560,Gang,19384,0,19384,2020.csv,2020,0.0,1.0
22561,Tchoupitoulas,19375,19375,0,2012.csv,2012,1.0,0.0
22562,Napping Princess 2019 Re-release,19369,0,19369,2019.csv,2019,0.0,1.0
22563,Soren,19366,0,19366,2018.csv,2018,0.0,1.0
22564,Actress,19365,19365,0,2014.csv,2014,1.0,0.0
22565,House of Norway,19365,0,19365,2017.csv,2017,0.0,1.0
22566,Peter Brook: The Tightrope,19365,19365,0,2014.csv,2014,1.0,0.0
22567,Truth About Men 2012 Re-release,19364,0,19364,2012.csv,2012,0.0,1.0
22568,Mamma Mia! 2020 Re-release,19341,0,19341,2020.csv,2020,0.0,1.0
22569,Watchers of the Sky,19339,19339,0,2014.csv,2014,1.0,0.0
22570,Gabo: The Creation of Gabriel Garcia Marquez,19337,19337,0,2015.csv,2015,1.0,0.0
22571,High School Girls,19327,0,19327,2020.csv,2020,0.0,1.0
22572,Tenaliraman,19309,0,19309,2014.csv,2014,0.0,1.0
22573,Jackie & Ryan,19305,0,19305,2015.csv,2015,0.0,1.0
22574,Mahler on the Couch 2013 Re-release,19294,0,19294,2013.csv,2013,0.0,1.0
22575,Somewhere Connected,19291,0,19291,2016.csv,2016,0.0,1.0
22576,Reuniting the Rubins,19288,13569,5719,2011.csv,2011,0.703494400663625,0.29650559933637494
22577,Please Keep Away,19287,0,19287,2017.csv,2017,0.0,1.0
22578,The Tower 2014 Re-release,19278,0,19278,2014.csv,2014,0.0,1.0
22579,Romeos,19248,1081,18167,2011.csv,2011,0.056161679135494594,0.9438383208645054
22580,Neshoba,19245,19245,0,2010.csv,2010,1.0,0.0
22581,Doctor Ray and the Devils,19232,0,19232,2012.csv,2012,0.0,1.0
22582,Ristabbànna,19231,0,19231,2012.csv,2012,0.0,1.0
22583,Ignacio de Loyola,19227,0,19227,2018.csv,2018,0.0,1.0
22584,Code Blue,19224,0,19224,2012.csv,2012,0.0,1.0
22585,South of New York,19224,0,19224,2011.csv,2011,0.0,1.0
22586,Cops and Robbers,19224,0,19224,2018.csv,2018,0.0,1.0
22587,Cin Çesmesi,19216,0,19216,2018.csv,2018,0.0,1.0
22588,Tut Yüregimden Anne,19210,0,19210,2018.csv,2018,0.0,1.0
22589,Nankana,19190,0,19190,2018.csv,2018,0.0,1.0
22590,ChickLit,19180,0,19180,2016.csv,2016,0.0,1.0
22591,Riocorrente,19178,0,19178,2014.csv,2014,0.0,1.0
22592,Summer 2012 Re-release,19175,0,19175,2012.csv,2012,0.0,1.0
22593,Grace and Goliath,19164,0,19164,2018.csv,2018,0.0,1.0
22594,Mon Mon Mon Monsters,19160,0,19160,2018.csv,2018,0.0,1.0
22595,Weekends,19154,0,19154,2016.csv,2016,0.0,1.0
22596,Border Run,19152,0,19152,2014.csv,2014,0.0,1.0
22597,Nobody's Died Laughing,19144,0,19144,2016.csv,2016,0.0,1.0
22598,The People I've Slept With,19137,19137,0,2010.csv,2010,1.0,0.0
22599,Cave 2018 Re-release,19136,0,19136,2018.csv,2018,0.0,1.0
22600,"The Rolling Stones Olé, Olé, Olé!: A Trip Across Latin America",19132,0,19132,2017.csv,2017,0.0,1.0
22601,Who We Are Now,19128,19128,0,2018.csv,2018,1.0,0.0
22602,Breathe In 2015 Re-release,19128,0,19128,2015.csv,2015,0.0,1.0
22603,That Most Important Thing: Love,19120,19120,0,2017.csv,2017,1.0,0.0
22604,Chikku Bukku,19116,0,19116,2010.csv,2010,0.0,1.0
22605,3X Trouble,19114,0,19114,2012.csv,2012,0.0,1.0
22606,Revelation: Dawn of Global Government,19107,19107,0,2016.csv,2016,1.0,0.0
22607,Revolution: New Art For A New World,19103,0,19103,2016.csv,2016,0.0,1.0
22608,The Curse of Robert the Doll,19096,0,19096,2017.csv,2017,0.0,1.0
22609,Korotkie volny,19089,0,19089,2019.csv,2019,0.0,1.0
22610,Gedo Mashakel,19088,0,19088,2020.csv,2020,0.0,1.0
22611,Make Believe,19085,19085,0,2011.csv,2011,1.0,0.0
22612,November,19084,19084,0,2018.csv,2018,1.0,0.0
22613,Goli Soda 2,19072,0,19072,2018.csv,2018,0.0,1.0
22614,The Ballad of Genesis and Lady Jaye,19069,0,19069,2011.csv,2011,0.0,1.0
22615,H0us3,19049,0,19049,2019.csv,2019,0.0,1.0
22616,Messenger,19037,0,19037,2010.csv,2010,0.0,1.0
22617,Empire of Silver,19036,0,19036,2010.csv,2010,0.0,1.0
22618,Search Engines,19033,19033,0,2016.csv,2016,1.0,0.0
22619,El dolo,19031,0,19031,2017.csv,2017,0.0,1.0
22620,Adam Resurrected 2012 Re-release,19007,0,19007,2012.csv,2012,0.0,1.0
22621,The Challenger,19003,19003,0,2015.csv,2015,1.0,0.0
22622,Güzel Adam Süreyya,19002,0,19002,2018.csv,2018,0.0,1.0
22623,The Color Wheel,19001,19001,0,2012.csv,2012,1.0,0.0
22624,Nejvetsi z Cechu,19000,0,19000,2010.csv,2010,0.0,1.0
22625,My Ghost Partner,18994,0,18994,2012.csv,2012,0.0,1.0
22626,Imposed Piece,18993,0,18993,2019.csv,2019,0.0,1.0
22627,About the Pink Sky,18993,0,18993,2013.csv,2013,0.0,1.0
22628,The Kill Team,18983,18983,0,2014.csv,2014,1.0,0.0
22629,Tres mentiras,18978,0,18978,2014.csv,2014,0.0,1.0
22630,Evaporated,18973,0,18973,2020.csv,2020,0.0,1.0
22631,We Are Still Here,18970,0,18970,2015.csv,2015,0.0,1.0
22632,Horses,18961,0,18961,2011.csv,2011,0.0,1.0
22633,7X: This is Our Kids,18948,0,18948,2010.csv,2010,0.0,1.0
22634,Rupinder Gandhi 2: The Robin Hood,18947,0,18947,2017.csv,2017,0.0,1.0
22635,Sophomore,18945,18945,0,2012.csv,2012,1.0,0.0
22636,Micke & Veronica,18942,0,18942,2015.csv,2015,0.0,1.0
22637,Smash & Grab: The Story of the Pink Panthers,18938,18938,0,2013.csv,2013,1.0,0.0
22638,Andres Doesn't Want to Take a Nap,18926,0,18926,2010.csv,2010,0.0,1.0
22639,Malú: ni un paso atrás,18918,0,18918,2016.csv,2016,0.0,1.0
22640,Foam Party!,18892,0,18892,2017.csv,2017,0.0,1.0
22641,My Adventures with Santa,18879,0,18879,2020.csv,2020,0.0,1.0
22642,Secret,18876,0,18876,2015.csv,2015,0.0,1.0
22643,Ktown Cowboys,18863,18863,0,2016.csv,2016,1.0,0.0
22644,Door in the Woods,18861,0,18861,2019.csv,2019,0.0,1.0
22645,In the Quarry,18860,0,18860,2019.csv,2019,0.0,1.0
22646,Dreamfactory 2021 Re-release,18854,0,18854,2021.csv,2021,0.0,1.0
22647,Last Winter,18851,0,18851,2012.csv,2012,0.0,1.0
22648,48 Hours to Live,18847,0,18847,2016.csv,2016,0.0,1.0
22649,Nostalgia,18846,18846,0,2013.csv,2013,1.0,0.0
22650,Shylock,18840,0,18840,2020.csv,2020,0.0,1.0
22651,Illegitimate,18840,0,18840,2016.csv,2016,0.0,1.0
22652,Ánima Buenos Aires,18834,0,18834,2012.csv,2012,0.0,1.0
22653,Paco and the Magical Book 2010 Re-release,18834,0,18834,2010.csv,2010,0.0,1.0
22654,Frank and Ava,18829,18829,0,2018.csv,2018,1.0,0.0
22655,Catch The King,18824,0,18824,2018.csv,2018,0.0,1.0
22656,Test,18823,18823,0,2014.csv,2014,1.0,0.0
22657,Best Horror Shorts,18821,0,18821,2020.csv,2020,0.0,1.0
22658,I Am Bolt,18821,0,18821,2016.csv,2016,0.0,1.0
22659,Akira 2011 Re-release,18813,0,18813,2011.csv,2011,0.0,1.0
22660,Crazy Journey,18801,0,18801,2017.csv,2017,0.0,1.0
22661,Bodyguards and Assassins 2011 Re-release,18800,0,18800,2011.csv,2011,0.0,1.0
22662,The Soup,18799,0,18799,2018.csv,2018,0.0,1.0
22663,Battle of the Dream,18788,0,18788,2019.csv,2019,0.0,1.0
22664,The Secret of the Snow Queen,18782,0,18782,2016.csv,2016,0.0,1.0
22665,Drive Me Home,18781,0,18781,2019.csv,2019,0.0,1.0
22666,The Spy Who Dumped Me 2020 Re-release,18779,0,18779,2020.csv,2020,0.0,1.0
22667,Rambleras,18772,0,18772,2013.csv,2013,0.0,1.0
22668,My Days of Mercy,18766,0,18766,2019.csv,2019,0.0,1.0
22669,The Sorcerer and the White Snake 2013 Re-release,18759,18759,0,2013.csv,2013,1.0,0.0
22670,Scandalous: The True Story of the National Enquirer,18759,18759,0,2019.csv,2019,1.0,0.0
22671,Cuchillos en el cielo,18759,0,18759,2013.csv,2013,0.0,1.0
22672,An Ordinary Man,18754,0,18754,2017.csv,2017,0.0,1.0
22673,Laimingas bilietas,18742,0,18742,2017.csv,2017,0.0,1.0
22674,Smotri moyu lyubov,18737,0,18737,2019.csv,2019,0.0,1.0
22675,Jumpman,18734,0,18734,2018.csv,2018,0.0,1.0
22676,Before Stonewall,18724,18724,0,2019.csv,2019,1.0,0.0
22677,Wake Up,18695,0,18695,2020.csv,2020,0.0,1.0
22678,The Illusionauts 2017 Re-release,18689,0,18689,2017.csv,2017,0.0,1.0
22679,Hotel Edelveys,18686,0,18686,2019.csv,2019,0.0,1.0
22680,One Night,18671,0,18671,2016.csv,2016,0.0,1.0
22681,Seoul Searching,18654,18654,0,2016.csv,2016,1.0,0.0
22682,The Silence of the Sky,18650,0,18650,2016.csv,2016,0.0,1.0
22683,Crime + Punishment,18644,18644,0,2018.csv,2018,1.0,0.0
22684,A Single Shot,18642,18642,0,2013.csv,2013,1.0,0.0
22685,Rift,18622,0,18622,2017.csv,2017,0.0,1.0
22686,Wish Me Away,18618,18618,0,2012.csv,2012,1.0,0.0
22687,Standing Ovation 2013 Re-release,18612,0,18612,2013.csv,2013,0.0,1.0
22688,Elephants Can Play Football,18611,0,18611,2018.csv,2018,0.0,1.0
22689,Deep End 2011 Re-release,18603,0,18603,2011.csv,2011,0.0,1.0
22690,The Return of Martin Guerre 2019 Re-release,18603,18603,0,2019.csv,2019,1.0,0.0
22691,The Pagan King: The Battle of Death,18598,0,18598,2018.csv,2018,0.0,1.0
22692,A Friend of Mine,18591,0,18591,2011.csv,2011,0.0,1.0
22693,The After Date,18585,0,18585,2019.csv,2019,0.0,1.0
22694,Non è mai troppo tardi,18583,0,18583,2015.csv,2015,0.0,1.0
22695,Tuya,18582,0,18582,2015.csv,2015,0.0,1.0
22696,Rock Bottom,18580,0,18580,2013.csv,2013,0.0,1.0
22697,The Human Resources Manager 2013 Re-release,18579,0,18579,2013.csv,2013,0.0,1.0
22698,Bobbi Jene,18579,18579,0,2017.csv,2017,1.0,0.0
22699,Love Song of West River,18568,0,18568,2019.csv,2019,0.0,1.0
22700,It All Started at the End,18562,0,18562,2016.csv,2016,0.0,1.0
22701,La Camioneta: The Journey of One American School Bus,18558,18558,0,2013.csv,2013,1.0,0.0
22702,"El Inca, la boba y el hijo del ladrón",18556,0,18556,2011.csv,2011,0.0,1.0
22703,Anbanavan Asaradhavan Adangadhavan,18552,0,18552,2017.csv,2017,0.0,1.0
22704,Sal,18545,0,18545,2018.csv,2018,0.0,1.0
22705,"Hospitalarios, las manos de la Virgen",18537,0,18537,2019.csv,2019,0.0,1.0
22706,Mignon Mossie van Wyk,18532,0,18532,2016.csv,2016,0.0,1.0
22707,Moana 2020 Re-release,18531,0,18531,2020.csv,2020,0.0,1.0
22708,Let My People Go!,18529,18529,0,2013.csv,2013,1.0,0.0
22709,30 Years and 15 Minutes,18528,0,18528,2020.csv,2020,0.0,1.0
22710,Undulant Fever,18528,0,18528,2015.csv,2015,0.0,1.0
22711,Allegiance to Broadway,18527,18527,0,2018.csv,2018,1.0,0.0
22712,Sun Flower,18516,0,18516,2018.csv,2018,0.0,1.0
22713,Kaiser: The Greatest Footballer Never To Play Football,18512,0,18512,2018.csv,2018,0.0,1.0
22714,Mosquito,18511,0,18511,2020.csv,2020,0.0,1.0
22715,Desolation,18490,18490,0,2018.csv,2018,1.0,0.0
22716,All the Rage,18489,18489,0,2017.csv,2017,1.0,0.0
22717,No. 1 Villa,18487,0,18487,2018.csv,2018,0.0,1.0
22718,Gothic Harvest,18479,0,18479,2020.csv,2020,0.0,1.0
22719,Hello Love,18466,0,18466,2019.csv,2019,0.0,1.0
22720,El ummar,18460,0,18460,2018.csv,2018,0.0,1.0
22721,The Ghoul,18459,2032,16427,2017.csv,2017,0.11008180291456741,0.8899181970854326
22722,A Beautiful Star,18441,0,18441,2018.csv,2018,0.0,1.0
22723,Teambuilding,18433,0,18433,2018.csv,2018,0.0,1.0
22724,Pots and Pans,18414,0,18414,2012.csv,2012,0.0,1.0
22725,Na Quadrada Das Aguas Perdidas,18399,0,18399,2013.csv,2013,0.0,1.0
22726,306 Hollywood,18399,18399,0,2018.csv,2018,1.0,0.0
22727,Bad Luck,18392,0,18392,2015.csv,2015,0.0,1.0
22728,Mga mumunting lihim,18391,0,18391,2012.csv,2012,0.0,1.0
22729,The Stone Eater,18378,0,18378,2019.csv,2019,0.0,1.0
22730,Chelovek s bulvara Kaputsinok,18378,0,18378,2010.csv,2010,0.0,1.0
22731,Shithouse,18370,18370,0,2020.csv,2020,1.0,0.0
22732,Oka!,18364,18364,0,2011.csv,2011,1.0,0.0
22733,Ponto Zero,18361,0,18361,2016.csv,2016,0.0,1.0
22734,A tökéletes gyilkos,18360,0,18360,2017.csv,2017,0.0,1.0
22735,Old-Timers,18357,0,18357,2019.csv,2019,0.0,1.0
22736,"Phoenix, Oregon",18356,18356,0,2019.csv,2019,1.0,0.0
22737,Eto ne navsegda,18350,0,18350,2019.csv,2019,0.0,1.0
22738,Market Street,18350,0,18350,2010.csv,2010,0.0,1.0
22739,"Intent to Destroy: Death, Denial & Depiction 2017 Re-release",18340,18340,0,2017.csv,2017,1.0,0.0
22740,Rus'un Oyunu,18340,0,18340,2016.csv,2016,0.0,1.0
22741,White Jungle,18337,0,18337,2011.csv,2011,0.0,1.0
22742,Tomorrow,18333,0,18333,2019.csv,2019,0.0,1.0
22743,Balanta,18332,0,18332,2020.csv,2020,0.0,1.0
22744,Stand Off,18332,0,18332,2013.csv,2013,0.0,1.0
22745,"Love, Lust & Lies",18323,0,18323,2010.csv,2010,0.0,1.0
22746,The Channel,18319,18319,0,2016.csv,2016,1.0,0.0
22747,Tous les soleils 2013 Re-release,18312,0,18312,2013.csv,2013,0.0,1.0
22748,Vanthaan Vendraan,18303,0,18303,2011.csv,2011,0.0,1.0
22749,Ranarangam,18297,0,18297,2019.csv,2019,0.0,1.0
22750,Four Bags Full,18297,18297,0,2013.csv,2013,1.0,0.0
22751,Los Ajenos Futbol Club,18296,0,18296,2019.csv,2019,0.0,1.0
22752,SHOT! The Psycho-Spiritual Mantra of Rock,18295,15157,3138,2017.csv,2017,0.8284777261546871,0.17152227384531293
22753,Pixi Post & the Gift Bringers,18292,0,18292,2016.csv,2016,0.0,1.0
22754,Maradona,18288,0,18288,2018.csv,2018,0.0,1.0
22755,Doble,18287,0,18287,2018.csv,2018,0.0,1.0
22756,Postcards from the 48%,18271,0,18271,2018.csv,2018,0.0,1.0
22757,"The Follower, Ok Han-heum 2: Discipleship",18262,0,18262,2016.csv,2016,0.0,1.0
22758,Off and Running,18262,18262,0,2010.csv,2010,1.0,0.0
22759,Magic Paris,18245,0,18245,2010.csv,2010,0.0,1.0
22760,Les profs 2016 Re-release,18240,0,18240,2016.csv,2016,0.0,1.0
22761,Buitres: No es un día más,18237,0,18237,2017.csv,2017,0.0,1.0
22762,Tosca's Kiss,18236,18236,0,2014.csv,2014,1.0,0.0
22763,Patrolman Baoyin,18216,0,18216,2018.csv,2018,0.0,1.0
22764,Era of Dance,18205,0,18205,2017.csv,2017,0.0,1.0
22765,Torn,18202,18202,0,2013.csv,2013,1.0,0.0
22766,Marcelino Pan y Vino 2012 Re-release,18193,18193,0,2012.csv,2012,1.0,0.0
22767,Moffie,18191,14007,4184,2020.csv,2020,0.7699961519432686,0.23000384805673135
22768,Who is Dayani Cristal?,18190,18190,0,2014.csv,2014,1.0,0.0
22769,Sadness in Beauty,18181,0,18181,2010.csv,2010,0.0,1.0
22770,The Lion in Winter 2016 Re-release,18177,18177,0,2016.csv,2016,1.0,0.0
22771,Wushu Orphan,18176,0,18176,2019.csv,2019,0.0,1.0
22772,Mangren Anmo,18162,0,18162,2015.csv,2015,0.0,1.0
22773,The Metropolitan Opera HD Live: Cilea: Adriana Lecouvreur,18157,0,18157,2019.csv,2019,0.0,1.0
22774,Naal,18145,0,18145,2018.csv,2018,0.0,1.0
22775,King Liar,18144,0,18144,2016.csv,2016,0.0,1.0
22776,Immortal Combat: The Code,18142,0,18142,2020.csv,2020,0.0,1.0
22777,Coming Through the Rye,18137,18137,0,2016.csv,2016,1.0,0.0
22778,King of Hearts,18130,17646,484,2018.csv,2018,0.973303916161059,0.02669608383894098
22779,Love in the City,18126,0,18126,2017.csv,2017,0.0,1.0
22780,Peter and the Farm,18123,18123,0,2016.csv,2016,1.0,0.0
22781,Inspector Bellamy 2012 Re-release,18116,0,18116,2012.csv,2012,0.0,1.0
22782,Harry Benson: Shoot First,18092,18092,0,2016.csv,2016,1.0,0.0
22783,Jean Paul Gaultier: Freak and Chic,18092,0,18092,2020.csv,2020,0.0,1.0
22784,Posthumous,18091,0,18091,2015.csv,2015,0.0,1.0
22785,The Flowers of Kirkuk 2012 Re-release,18090,0,18090,2012.csv,2012,0.0,1.0
22786,A Bit of Bad Luck,18089,18089,0,2016.csv,2016,1.0,0.0
22787,Los Hijos de San Luis,18088,0,18088,2020.csv,2020,0.0,1.0
22788,Total Recall 2012 Re-release,18081,18081,0,2012.csv,2012,1.0,0.0
22789,Nanu Ki Jaanu,18065,0,18065,2018.csv,2018,0.0,1.0
22790,Goodbye Boy,18060,0,18060,2011.csv,2011,0.0,1.0
22791,Holy Hell,18051,18051,0,2016.csv,2016,1.0,0.0
22792,Maledimiele,18048,0,18048,2012.csv,2012,0.0,1.0
22793,Alcan Highway,18038,0,18038,2013.csv,2013,0.0,1.0
22794,Türk Pasaportu,18034,0,18034,2011.csv,2011,0.0,1.0
22795,Love in Transit,18031,0,18031,2010.csv,2010,0.0,1.0
22796,On Tour with Pina Bausch,18016,18016,0,2014.csv,2014,1.0,0.0
22797,Dead Reckoning,18016,0,18016,2021.csv,2021,0.0,1.0
22798,Thou Shalt Not Kill,18013,0,18013,2019.csv,2019,0.0,1.0
22799,I Knew Her Well,18010,18010,0,2016.csv,2016,1.0,0.0
22800,Men Go to Battle,18006,18006,0,2016.csv,2016,1.0,0.0
22801,Hunter's Moon,18004,0,18004,2020.csv,2020,0.0,1.0
22802,Battle for Brooklyn,18000,18000,0,2011.csv,2011,1.0,0.0
22803,Eastern Business,17994,0,17994,2016.csv,2016,0.0,1.0
22804,Overclockers,17993,0,17993,2020.csv,2020,0.0,1.0
22805,Jamel Shabazz Street Photographer,17992,17992,0,2013.csv,2013,1.0,0.0
22806,Daniel Isn't Real,17990,0,17990,2019.csv,2019,0.0,1.0
22807,Isa Pa with Feelings,17987,0,17987,2019.csv,2019,0.0,1.0
22808,Speed Angels,17982,0,17982,2012.csv,2012,0.0,1.0
22809,Chicama,17979,0,17979,2013.csv,2013,0.0,1.0
22810,Payback,17979,17979,0,2012.csv,2012,1.0,0.0
22811,Cook County,17977,17977,0,2011.csv,2011,1.0,0.0
22812,Frankenstein 04155,17976,0,17976,2015.csv,2015,0.0,1.0
22813,Three Sisters,17971,0,17971,2017.csv,2017,0.0,1.0
22814,Love,17971,0,17971,2020.csv,2020,0.0,1.0
22815,Andre Rieu Live at Maastricht 2012,17968,0,17968,2012.csv,2012,0.0,1.0
22816,Amazon Jack 2010 Re-release,17935,0,17935,2010.csv,2010,0.0,1.0
22817,A Mysterious Tribe in China,17934,0,17934,2018.csv,2018,0.0,1.0
22818,Sagu & Pagu: Büyük Define,17927,0,17927,2018.csv,2018,0.0,1.0
22819,The Cranes Are Flying,17923,17923,0,2019.csv,2019,1.0,0.0
22820,The Great Dictator 2018 Re-release,17922,0,17922,2018.csv,2018,0.0,1.0
22821,Great Directors,17921,17921,0,2010.csv,2010,1.0,0.0
22822,Ilo Ilo 2015 Re-release,17919,0,17919,2015.csv,2015,0.0,1.0
22823,Dealin' with Idiots,17909,17909,0,2013.csv,2013,1.0,0.0
22824,Harry Potter and the Prisoner of Azkaban 2016 Re-release,17889,0,17889,2016.csv,2016,0.0,1.0
22825,She's from Another Planet,17869,0,17869,2016.csv,2016,0.0,1.0
22826,Li'l Quinquin,17868,7192,10676,2015.csv,2015,0.4025072755764495,0.5974927244235505
22827,Baaji,17867,0,17867,2019.csv,2019,0.0,1.0
22828,The Winter,17862,0,17862,2016.csv,2016,0.0,1.0
22829,The Thorn in the Heart,17849,7376,10473,2010.csv,2010,0.41324443946439576,0.5867555605356042
22830,Groundhog Dave,17846,0,17846,2019.csv,2019,0.0,1.0
22831,The Last Shaman,17844,17844,0,2017.csv,2017,1.0,0.0
22832,Made in Hong Kong,17843,17843,0,2020.csv,2020,1.0,0.0
22833,Powder Blue 2012 Re-release,17835,0,17835,2012.csv,2012,0.0,1.0
22834,David,17828,0,17828,2013.csv,2013,0.0,1.0
22835,Batman: Mask of the Phantasm 2018 Re-release,17813,17813,0,2018.csv,2018,1.0,0.0
22836,Interlude City,17812,0,17812,2017.csv,2017,0.0,1.0
22837,Singham,17810,0,17810,2019.csv,2019,0.0,1.0
22838,Prick Up Your Ears 2017 Re-release,17801,0,17801,2017.csv,2017,0.0,1.0
22839,"Oh Yeah, She Performs!",17795,0,17795,2012.csv,2012,0.0,1.0
22840,Escapes,17778,17778,0,2017.csv,2017,1.0,0.0
22841,Dust on the Tongue,17777,0,17777,2014.csv,2014,0.0,1.0
22842,Kes 2011 Re-release,17776,0,17776,2011.csv,2011,0.0,1.0
22843,Axilas,17759,0,17759,2016.csv,2016,0.0,1.0
22844,Guru,17750,0,17750,2017.csv,2017,0.0,1.0
22845,Sacred,17740,17740,0,2017.csv,2017,1.0,0.0
22846,Little Birds,17739,17739,0,2012.csv,2012,1.0,0.0
22847,Manhattan 2017 Re-release,17736,0,17736,2017.csv,2017,0.0,1.0
22848,Bagrovyy tsvet snegopada,17734,0,17734,2012.csv,2012,0.0,1.0
22849,Aoki Hagane no Arpeggio: Ars Nova DC,17732,0,17732,2016.csv,2016,0.0,1.0
22850,Parked,17729,0,17729,2011.csv,2011,0.0,1.0
22851,The Other One,17727,17727,0,2015.csv,2015,1.0,0.0
22852,Asleep in the Sun,17723,0,17723,2012.csv,2012,0.0,1.0
22853,Bogan,17717,0,17717,2017.csv,2017,0.0,1.0
22854,Nuit #1,17716,0,17716,2012.csv,2012,0.0,1.0
22855,"10,000 Nights Nowhere",17709,0,17709,2014.csv,2014,0.0,1.0
22856,Kelly & Cal,17702,17702,0,2014.csv,2014,1.0,0.0
22857,The Rocky Horror Picture Show 2011 Re-release,17701,0,17701,2011.csv,2011,0.0,1.0
22858,Raluca,17700,0,17700,2014.csv,2014,0.0,1.0
22859,Winter at Westbeth,17689,0,17689,2017.csv,2017,0.0,1.0
22860,Bad Grandmas,17688,17688,0,2017.csv,2017,1.0,0.0
22861,American Vagabond,17687,0,17687,2013.csv,2013,0.0,1.0
22862,The Man in the Hat,17681,0,17681,2020.csv,2020,0.0,1.0
22863,Heaven's Hell,17674,0,17674,2019.csv,2019,0.0,1.0
22864,Beyond the Boundary Movie: I'll Be Here - Mirai-hen,17668,0,17668,2015.csv,2015,0.0,1.0
22865,Perde: Ayn-i Cin,17667,0,17667,2017.csv,2017,0.0,1.0
22866,Just Do It: A Tale of Modern-day Outlaws,17663,0,17663,2011.csv,2011,0.0,1.0
22867,Let Me Go,17653,0,17653,2017.csv,2017,0.0,1.0
22868,The Last Match,17647,0,17647,2014.csv,2014,0.0,1.0
22869,The History of Future Folk,17646,17646,0,2013.csv,2013,1.0,0.0
22870,Sodoma... L'altra faccia di Gomorra,17633,0,17633,2013.csv,2013,0.0,1.0
22871,El Piedra,17626,0,17626,2019.csv,2019,0.0,1.0
22872,Lock Charmer,17624,0,17624,2014.csv,2014,0.0,1.0
22873,La flor de la vida,17621,0,17621,2018.csv,2018,0.0,1.0
22874,Blue 2017 Re-release,17621,0,17621,2017.csv,2017,0.0,1.0
22875,Gold Statue,17617,0,17617,2019.csv,2019,0.0,1.0
22876,When A City Rises,17607,0,17607,2020.csv,2020,0.0,1.0
22877,Sukkar Barrah,17596,0,17596,2017.csv,2017,0.0,1.0
22878,Kills On Wheels 2016 Re-release,17595,15898,1697,2017.csv,2017,0.9035521454958795,0.0964478545041205
22879,8 Tiros,17591,0,17591,2015.csv,2015,0.0,1.0
22880,Suspiria 2017 Re-release,17587,0,17587,2017.csv,2017,0.0,1.0
22881,Villegas,17584,0,17584,2013.csv,2013,0.0,1.0
22882,The Return,17578,0,17578,2014.csv,2014,0.0,1.0
22883,How He Fell in Love,17575,17575,0,2016.csv,2016,1.0,0.0
22884,Blackburn,17570,0,17570,2016.csv,2016,0.0,1.0
22885,Bloody Date,17569,0,17569,2013.csv,2013,0.0,1.0
22886,El Regalo 2010 Re-release,17568,0,17568,2010.csv,2010,0.0,1.0
22887,Al Fundok,17566,0,17566,2018.csv,2018,0.0,1.0
22888,Sakka Podu Podu Raja,17564,0,17564,2017.csv,2017,0.0,1.0
22889,Body Complete,17560,0,17560,2013.csv,2013,0.0,1.0
22890,An Act of Defiance 2018 Re-release,17556,0,17556,2018.csv,2018,0.0,1.0
22891,"Las mil y una noches: Vol.1, El inquieto",17553,0,17553,2016.csv,2016,0.0,1.0
22892,Apartment 143 2015 Re-release,17553,0,17553,2015.csv,2015,0.0,1.0
22893,Mademoiselle Paradis,17545,0,17545,2019.csv,2019,0.0,1.0
22894,Zolotaya rybka v gorode N,17543,0,17543,2011.csv,2011,0.0,1.0
22895,The Chronicle of Anna Magdalena Bach,17527,17527,0,2018.csv,2018,1.0,0.0
22896,Eza3et Hob,17526,0,17526,2011.csv,2011,0.0,1.0
22897,Within the Whirlwind,17517,0,17517,2011.csv,2011,0.0,1.0
22898,The Punk Voyage,17517,0,17517,2017.csv,2017,0.0,1.0
22899,Vallahi Hortladi,17512,0,17512,2018.csv,2018,0.0,1.0
22900,Streit's: Matzo and the American Dream,17506,17506,0,2016.csv,2016,1.0,0.0
22901,Butterfly Girl,17503,17503,0,2015.csv,2015,1.0,0.0
22902,Saadey CM Saab,17489,0,17489,2016.csv,2016,0.0,1.0
22903,Ma folie,17485,0,17485,2015.csv,2015,0.0,1.0
22904,And Here's What's Happening to Me,17459,0,17459,2012.csv,2012,0.0,1.0
22905,Giallo 2011 Re-release,17458,0,17458,2011.csv,2011,0.0,1.0
22906,Widow's Point,17451,0,17451,2020.csv,2020,0.0,1.0
22907,El día de la cabra,17440,0,17440,2017.csv,2017,0.0,1.0
22908,Chained for Life,17431,17431,0,2019.csv,2019,1.0,0.0
22909,Love Ni Bhavai,17426,0,17426,2017.csv,2017,0.0,1.0
22910,Echo,17422,0,17422,2019.csv,2019,0.0,1.0
22911,Global Baba,17410,0,17410,2013.csv,2013,0.0,1.0
22912,Pattinapakkam,17409,0,17409,2018.csv,2018,0.0,1.0
22913,Pandora and the Flying Dutchman 2020 Re-release,17401,17401,0,2020.csv,2020,1.0,0.0
22914,Ghost Writer,17395,0,17395,2020.csv,2020,0.0,1.0
22915,The Drunkard,17390,0,17390,2010.csv,2010,0.0,1.0
22916,Harry Potter and the Chamber of Secrets 2016 Re-release,17389,0,17389,2016.csv,2016,0.0,1.0
22917,The Law,17351,17351,0,2010.csv,2010,1.0,0.0
22918,Smotri Kak Ya,17346,0,17346,2020.csv,2020,0.0,1.0
22919,"Christmas, Again",17341,0,17341,2016.csv,2016,0.0,1.0
22920,Chasing the Wind 2014 Re-release,17338,0,17338,2014.csv,2014,0.0,1.0
22921,Northern Lights: A Journey to Love,17337,0,17337,2017.csv,2017,0.0,1.0
22922,Australia Day,17333,0,17333,2017.csv,2017,0.0,1.0
22923,"A Bread Factory, Part One/A Bread Factory, Part Two",17325,17325,0,2018.csv,2018,1.0,0.0
22924,Lashtam Pashtam,17322,0,17322,2018.csv,2018,0.0,1.0
22925,Mystery of the Kingdom of God,17316,17316,0,2021.csv,2021,1.0,0.0
22926,Teen Patti,17311,0,17311,2010.csv,2010,0.0,1.0
22927,Littlerock,17309,17309,0,2011.csv,2011,1.0,0.0
22928,The Homestretch,17306,17306,0,2014.csv,2014,1.0,0.0
22929,Undermined - Tales from the Kimberley,17287,0,17287,2019.csv,2019,0.0,1.0
22930,Stand Clear of the Closing Doors,17282,17282,0,2014.csv,2014,1.0,0.0
22931,Archie's Final Project,17282,17282,0,2011.csv,2011,1.0,0.0
22932,Nasil Yani,17280,0,17280,2016.csv,2016,0.0,1.0
22933,Commitment,17276,0,17276,2019.csv,2019,0.0,1.0
22934,Revival,17252,17252,0,2018.csv,2018,1.0,0.0
22935,Reykjavík,17250,0,17250,2016.csv,2016,0.0,1.0
22936,"Hana, dul, sed ...",17248,0,17248,2011.csv,2011,0.0,1.0
22937,Scarred Love,17247,0,17247,2019.csv,2019,0.0,1.0
22938,Hospital de pobres,17236,0,17236,2018.csv,2018,0.0,1.0
22939,Loggerheads,17220,0,17220,2012.csv,2012,0.0,1.0
22940,A Perfect Getaway 2012 Re-release,17215,0,17215,2012.csv,2012,0.0,1.0
22941,The Secret Scandal,17214,0,17214,2013.csv,2013,0.0,1.0
22942,Kyky Ryky a pár vajec,17214,0,17214,2015.csv,2015,0.0,1.0
22943,Landfill Harmonic,17205,17205,0,2016.csv,2016,1.0,0.0
22944,Aporia,17198,0,17198,2019.csv,2019,0.0,1.0
22945,Melina - Con rabbia e con sapere,17196,0,17196,2012.csv,2012,0.0,1.0
22946,Dark Lies the Island,17188,0,17188,2019.csv,2019,0.0,1.0
22947,Albüm,17187,0,17187,2016.csv,2016,0.0,1.0
22948,"Goodbye, Pyeongyang",17185,0,17185,2011.csv,2011,0.0,1.0
22949,Cats Don't Come When You Call,17184,0,17184,2016.csv,2016,0.0,1.0
22950,Food Evolution,17181,17181,0,2017.csv,2017,1.0,0.0
22951,Rise of the Footsoldier 3: The Pat Tate Story,17181,0,17181,2017.csv,2017,0.0,1.0
22952,The 5th Dimension,17177,0,17177,2018.csv,2018,0.0,1.0
22953,Botticelli Inferno,17175,0,17175,2016.csv,2016,0.0,1.0
22954,Girl with a Pearl Earring: And Other Treasures from the Mauritshuis,17173,0,17173,2015.csv,2015,0.0,1.0
22955,Sonita,17168,0,17168,2016.csv,2016,0.0,1.0
22956,Accident 2014 Re-release,17161,17161,0,2014.csv,2014,1.0,0.0
22957,El cuadro,17159,0,17159,2019.csv,2019,0.0,1.0
22958,The Great Dictator 2019 Re-release,17147,0,17147,2019.csv,2019,0.0,1.0
22959,Truce,17138,0,17138,2010.csv,2010,0.0,1.0
22960,The Passenger 2019 Re-release,17137,0,17137,2019.csv,2019,0.0,1.0
22961,"Balance, Not Symmetry",17136,0,17136,2019.csv,2019,0.0,1.0
22962,The Drifting Red Balloon,17134,0,17134,2018.csv,2018,0.0,1.0
22963,Autumn Sonata,17124,0,17124,2017.csv,2017,0.0,1.0
22964,Le Pont du Nord,17110,17110,0,2013.csv,2013,1.0,0.0
22965,Obstetric Boys,17106,0,17106,2018.csv,2018,0.0,1.0
22966,The Barber,17104,0,17104,2015.csv,2015,0.0,1.0
22967,The Fire,17103,0,17103,2015.csv,2015,0.0,1.0
22968,Always Shine,17102,17102,0,2016.csv,2016,1.0,0.0
22969,On the Map,17099,17099,0,2016.csv,2016,1.0,0.0
22970,Everything - The Real Thing Story,17097,0,17097,2020.csv,2020,0.0,1.0
22971,"Thanatos, Drunk",17096,0,17096,2016.csv,2016,0.0,1.0
22972,Crossfire Hurricane,17079,0,17079,2012.csv,2012,0.0,1.0
22973,Grandmaster,17077,17077,0,2012.csv,2012,1.0,0.0
22974,Happy Family 2014 Re-release,17071,0,17071,2014.csv,2014,0.0,1.0
22975,No One,17071,0,17071,2017.csv,2017,0.0,1.0
22976,Zoo Wars 2,17064,0,17064,2019.csv,2019,0.0,1.0
22977,The Understudy,17036,17036,0,2012.csv,2012,1.0,0.0
22978,Liberating a Continent: John Paul II and the Fall of Communism,17036,0,17036,2018.csv,2018,0.0,1.0
22979,Göttliche Lage - Eine Stadt erfindet sich neu,17029,0,17029,2014.csv,2014,0.0,1.0
22980,Uriyadi 2,17027,0,17027,2019.csv,2019,0.0,1.0
22981,An Ordinary Love Story,17020,0,17020,2012.csv,2012,0.0,1.0
22982,Mircin,17015,0,17015,2019.csv,2019,0.0,1.0
22983,Frummaourinn,17010,0,17010,2015.csv,2015,0.0,1.0
22984,A Luneta do Tempo,17009,0,17009,2016.csv,2016,0.0,1.0
22985,The Forgotten Space,17006,0,17006,2012.csv,2012,0.0,1.0
22986,Sulphur and White,17004,0,17004,2020.csv,2020,0.0,1.0
22987,Al Moshtaba,16994,0,16994,2010.csv,2010,0.0,1.0
22988,Tracking Edith,16990,0,16990,2018.csv,2018,0.0,1.0
22989,Goodbye to All That,16986,16986,0,2014.csv,2014,1.0,0.0
22990,What the Waters Left Behind,16984,0,16984,2018.csv,2018,0.0,1.0
22991,The Prophet's Son,16983,16983,0,2012.csv,2012,1.0,0.0
22992,Igualita a mi 2013 Re-release,16977,0,16977,2013.csv,2013,0.0,1.0
22993,Jesucristo Vive,16977,0,16977,2019.csv,2019,0.0,1.0
22994,The Second Coming 2015 Re-release,16972,0,16972,2015.csv,2015,0.0,1.0
22995,Joseph Pulitzer: Voice of the People,16970,16970,0,2019.csv,2019,1.0,0.0
22996,Jugadores con Patente,16958,0,16958,2013.csv,2013,0.0,1.0
22997,Reset,16953,0,16953,2017.csv,2017,0.0,1.0
22998,Khalepa na 5 Baksiv,16947,0,16947,2019.csv,2019,0.0,1.0
22999,Advocate,16942,16942,0,2020.csv,2020,1.0,0.0
23000,Brownian Movement,16942,0,16942,2012.csv,2012,0.0,1.0
23001,Crash and Burn,16932,0,16932,2016.csv,2016,0.0,1.0
23002,Kin'iro mozaiku: Pretty Days,16925,0,16925,2017.csv,2017,0.0,1.0
23003,1982,16922,0,16922,2020.csv,2020,0.0,1.0
23004,Forgetting Space,16919,0,16919,2017.csv,2017,0.0,1.0
23005,Pretty Guardian Sailor Moon: The Musical,16918,0,16918,2018.csv,2018,0.0,1.0
23006,Hello Beijing,16915,0,16915,2019.csv,2019,0.0,1.0
23007,Carbon Nation,16901,16901,0,2010.csv,2010,1.0,0.0
23008,Yanoosak,16895,0,16895,2010.csv,2010,0.0,1.0
23009,Return,16886,16124,762,2012.csv,2012,0.9548738600023688,0.045126139997631175
23010,Hank and Asha,16878,16878,0,2014.csv,2014,1.0,0.0
23011,Her Job,16875,0,16875,2019.csv,2019,0.0,1.0
23012,"Slovenija, Avstralija in jutri ves svet",16874,0,16874,2017.csv,2017,0.0,1.0
23013,Reaper,16873,0,16873,2014.csv,2014,0.0,1.0
23014,Blow Horn,16868,0,16868,2010.csv,2010,0.0,1.0
23015,Federico Fellini Retrospective,16838,0,16838,2010.csv,2010,0.0,1.0
23016,Adalet Oyunu,16835,0,16835,2011.csv,2011,0.0,1.0
23017,Dobara Phir Se,16818,0,16818,2016.csv,2016,0.0,1.0
23018,The Fast and the Furious 2020 Re-release,16804,0,16804,2020.csv,2020,0.0,1.0
23019,Breakfast at Tiffany's 2011 Re-release,16802,0,16802,2011.csv,2011,0.0,1.0
23020,The Neighbor Zombie,16783,0,16783,2010.csv,2010,0.0,1.0
23021,Swim Team,16783,16783,0,2017.csv,2017,1.0,0.0
23022,Mare chiuso,16779,0,16779,2012.csv,2012,0.0,1.0
23023,Night Across the Street,16778,16778,0,2013.csv,2013,1.0,0.0
23024,Barefoot at Dawn,16751,0,16751,2019.csv,2019,0.0,1.0
23025,The Unforgiving,16743,0,16743,2010.csv,2010,0.0,1.0
23026,Eva 2015 Re-release,16738,16738,0,2015.csv,2015,1.0,0.0
23027,Heartless 2012 Re-release,16738,0,16738,2012.csv,2012,0.0,1.0
23028,Inventing Our Life: The Kibbutz Experiment,16734,16734,0,2012.csv,2012,1.0,0.0
23029,Ishkq in Paris,16726,0,16726,2013.csv,2013,0.0,1.0
23030,Size Zero,16726,0,16726,2015.csv,2015,0.0,1.0
23031,Muj bájecný rozvod,16717,0,16717,2018.csv,2018,0.0,1.0
23032,"Rome, Open City",16712,0,16712,2018.csv,2018,0.0,1.0
23033,Sargi,16711,0,16711,2017.csv,2017,0.0,1.0
23034,Di Di Hollywood 2012 Re-release,16708,0,16708,2012.csv,2012,0.0,1.0
23035,Taranta on the road,16702,0,16702,2017.csv,2017,0.0,1.0
23036,This Changes Everything,16692,16692,0,2015.csv,2015,1.0,0.0
23037,The Legend of the Ugly King,16682,0,16682,2018.csv,2018,0.0,1.0
23038,National Theatre Live: Medea,16681,0,16681,2014.csv,2014,0.0,1.0
23039,No One Knows About Persian Cats 2014 Re-release,16675,0,16675,2014.csv,2014,0.0,1.0
23040,DOGG,16672,0,16672,2017.csv,2017,0.0,1.0
23041,Lovelorn 399 Years,16664,0,16664,2017.csv,2017,0.0,1.0
23042,Oblepikhovoe leto,16661,0,16661,2018.csv,2018,0.0,1.0
23043,My Killer,16653,0,16653,2016.csv,2016,0.0,1.0
23044,Il delitto Mattarella,16653,0,16653,2020.csv,2020,0.0,1.0
23045,The Year of the Tiger,16653,0,16653,2012.csv,2012,0.0,1.0
23046,Happy to Catch a Thief,16652,0,16652,2019.csv,2019,0.0,1.0
23047,Jiri Suchy - Tackling Life with Ease,16650,0,16650,2019.csv,2019,0.0,1.0
23048,Amaro amore,16649,0,16649,2013.csv,2013,0.0,1.0
23049,Samka,16643,0,16643,2011.csv,2011,0.0,1.0
23050,Dawson Isla 10 2011 Re-release,16640,0,16640,2011.csv,2011,0.0,1.0
23051,B.E.D.,16631,0,16631,2013.csv,2013,0.0,1.0
23052,The World of Kanako 2015 Re-release,16627,16627,0,2015.csv,2015,1.0,0.0
23053,Anonyma - Eine Frau in Berlin 2010 Re-release,16617,0,16617,2010.csv,2010,0.0,1.0
23054,The Freebie,16613,16613,0,2010.csv,2010,1.0,0.0
23055,The Freedom to Marry,16611,16611,0,2017.csv,2017,1.0,0.0
23056,Portrait of My Mother,16610,0,16610,2017.csv,2017,0.0,1.0
23057,Bear Summer,16602,0,16602,2016.csv,2016,0.0,1.0
23058,The Piano 2020 Re-release,16600,0,16600,2020.csv,2020,0.0,1.0
23059,Who Took Johnny,16595,16595,0,2015.csv,2015,1.0,0.0
23060,Me Two 2010 Re-release,16592,0,16592,2010.csv,2010,0.0,1.0
23061,Biznesmeny,16584,0,16584,2019.csv,2019,0.0,1.0
23062,100 Years Together,16582,0,16582,2018.csv,2018,0.0,1.0
23063,Captain Morten and the Spider Queen,16576,0,16576,2019.csv,2019,0.0,1.0
23064,Haikara-San: Here Comes Miss Modern,16572,16572,0,2018.csv,2018,1.0,0.0
23065,Put Seylere,16565,0,16565,2018.csv,2018,0.0,1.0
23066,Life in a Walk,16557,16557,0,2015.csv,2015,1.0,0.0
23067,This Giant Papier-Mâché Boulder Is Actually Really Heavy,16557,0,16557,2016.csv,2016,0.0,1.0
23068,Keyla,16556,0,16556,2017.csv,2017,0.0,1.0
23069,Amilaren Secketua,16555,0,16555,2015.csv,2015,0.0,1.0
23070,JT LeRoy 2021 Re-release,16549,0,16549,2021.csv,2021,0.0,1.0
23071,Showdown in Manila 2018 Re-release,16549,0,16549,2018.csv,2018,0.0,1.0
23072,Songs for While I'm Away,16544,0,16544,2020.csv,2020,0.0,1.0
23073,Brave New Jersey,16544,16544,0,2017.csv,2017,1.0,0.0
23074,Senior Moment,16543,16543,0,2021.csv,2021,1.0,0.0
23075,Fritz Lang,16538,0,16538,2016.csv,2016,0.0,1.0
23076,Websterovci,16533,0,16533,2018.csv,2018,0.0,1.0
23077,33 & Beyond: The Royal Art of Freemasonry,16533,16533,0,2017.csv,2017,1.0,0.0
23078,Blood Pressure,16532,0,16532,2013.csv,2013,0.0,1.0
23079,The Fifth Commandment 2013 Re-release,16530,0,16530,2013.csv,2013,0.0,1.0
23080,The Fraulein and the Sandman 2012 Re-release,16524,0,16524,2012.csv,2012,0.0,1.0
23081,Baikonur,16522,0,16522,2011.csv,2011,0.0,1.0
23082,Bhoot Returns,16522,0,16522,2012.csv,2012,0.0,1.0
23083,Home for the Weekend 2014 Re-release,16518,0,16518,2014.csv,2014,0.0,1.0
23084,Partners in Crime,16517,0,16517,2015.csv,2015,0.0,1.0
23085,Dawning,16504,0,16504,2018.csv,2018,0.0,1.0
23086,Breaking News,16489,0,16489,2017.csv,2017,0.0,1.0
23087,Mejor Estar Solo,16486,0,16486,2014.csv,2014,0.0,1.0
23088,Olhar Contestado,16482,0,16482,2012.csv,2012,0.0,1.0
23089,Aazaan,16476,0,16476,2011.csv,2011,0.0,1.0
23090,Zagros,16472,0,16472,2018.csv,2018,0.0,1.0
23091,Between Maybes,16468,0,16468,2019.csv,2019,0.0,1.0
23092,Shiraz,16467,0,16467,2018.csv,2018,0.0,1.0
23093,The Girl in the Park 2010 Re-release,16461,0,16461,2010.csv,2010,0.0,1.0
23094,Fish N Chips: The Movie 2019 Re-release,16449,0,16449,2019.csv,2019,0.0,1.0
23095,El espejo de los otros 2016 Re-release,16431,0,16431,2016.csv,2016,0.0,1.0
23096,The Quest of Alain Ducasse 2019 Re-release,16429,0,16429,2019.csv,2019,0.0,1.0
23097,La braconne,16413,0,16413,2014.csv,2014,0.0,1.0
23098,Pécsi szál,16408,0,16408,2019.csv,2019,0.0,1.0
23099,The Flying Machine,16407,0,16407,2012.csv,2012,0.0,1.0
23100,Mission Control: The Unsung Heroes of Apollo,16405,16405,0,2017.csv,2017,1.0,0.0
23101,Kick Off,16402,0,16402,2010.csv,2010,0.0,1.0
23102,Magician: The Astonishing Life and Work of Orson Welles,16400,16400,0,2014.csv,2014,1.0,0.0
23103,Dying to Know: Ram Dass & Timothy Leary,16397,16397,0,2017.csv,2017,1.0,0.0
23104,Design Is One: The Vignellis,16386,16386,0,2013.csv,2013,1.0,0.0
23105,Rupture 2018 Re-release,16374,0,16374,2018.csv,2018,0.0,1.0
23106,"Journey to my boy, New Project",16374,0,16374,2017.csv,2017,0.0,1.0
23107,Thank You for Bombing,16370,0,16370,2016.csv,2016,0.0,1.0
23108,Love Next Door 2,16355,0,16355,2015.csv,2015,0.0,1.0
23109,One Flew Over the Cuckoo's Nest 2017 Re-release,16354,0,16354,2017.csv,2017,0.0,1.0
23110,Chemsex,16354,0,16354,2015.csv,2015,0.0,1.0
23111,Bernie The Dolphin,16340,0,16340,2018.csv,2018,0.0,1.0
23112,Ukradnutý Stát,16335,0,16335,2019.csv,2019,0.0,1.0
23113,Philips and the Monkey Pen,16332,0,16332,2013.csv,2013,0.0,1.0
23114,Bes Sehir,16329,0,16329,2010.csv,2010,0.0,1.0
23115,VS.,16323,0,16323,2018.csv,2018,0.0,1.0
23116,Lost Souls,16320,0,16320,2014.csv,2014,0.0,1.0
23117,Morning Star,16299,0,16299,2015.csv,2015,0.0,1.0
23118,After the Summer,16270,0,16270,2018.csv,2018,0.0,1.0
23119,I Can Quit Whenever I Want: Masterclass 2018 Re-release,16265,0,16265,2018.csv,2018,0.0,1.0
23120,A Fistful of Dollars 2018 Re-release,16248,0,16248,2018.csv,2018,0.0,1.0
23121,Who's Gonna Love Me Now?,16242,0,16242,2017.csv,2017,0.0,1.0
23122,"Stockholm, My Love",16241,0,16241,2017.csv,2017,0.0,1.0
23123,UKE,16234,0,16234,2020.csv,2020,0.0,1.0
23124,"Garden, zoological",16233,0,16233,2019.csv,2019,0.0,1.0
23125,I Melt with You,16232,6361,9871,2011.csv,2011,0.3918802365697388,0.6081197634302612
23126,Jian Bing Man 2017 Re-release,16232,0,16232,2017.csv,2017,0.0,1.0
23127,Porto 2019 Re-release,16213,0,16213,2019.csv,2019,0.0,1.0
23128,Soul Boy,16211,0,16211,2010.csv,2010,0.0,1.0
23129,Come As You Are,16209,0,16209,2020.csv,2020,0.0,1.0
23130,Janamaithri,16208,0,16208,2019.csv,2019,0.0,1.0
23131,Vidas pequeñas,16202,0,16202,2011.csv,2011,0.0,1.0
23132,Pelucas y Rokanrol,16193,0,16193,2018.csv,2018,0.0,1.0
23133,Her Husband & His Wife,16185,0,16185,2018.csv,2018,0.0,1.0
23134,The Human Centipede III (Final Sequence),16184,16184,0,2015.csv,2015,1.0,0.0
23135,This is Our Land,16182,11567,4615,2017.csv,2017,0.7148065752070202,0.2851934247929799
23136,All the Queen's Horses,16172,16172,0,2017.csv,2017,1.0,0.0
23137,Detour,16172,16172,0,2018.csv,2018,1.0,0.0
23138,Sumarbörn,16164,0,16164,2017.csv,2017,0.0,1.0
23139,The Metropolitan Opera Presents,16159,0,16159,2010.csv,2010,0.0,1.0
23140,Clara and the Secret of the Bears,16158,0,16158,2013.csv,2013,0.0,1.0
23141,Contempt 2016 Re-release,16158,0,16158,2016.csv,2016,0.0,1.0
23142,Harodim,16155,0,16155,2012.csv,2012,0.0,1.0
23143,SaroyanLand,16154,0,16154,2013.csv,2013,0.0,1.0
23144,Myth Kill Joke,16152,0,16152,2017.csv,2017,0.0,1.0
23145,Sadness and Joy in the Life of Giraffes,16151,0,16151,2019.csv,2019,0.0,1.0
23146,Charlie Noades R.I.P,16146,0,16146,2011.csv,2011,0.0,1.0
23147,"Bu y Bu, una aventura interdimensional",16145,0,16145,2019.csv,2019,0.0,1.0
23148,Invasion Planet Earth,16135,0,16135,2020.csv,2020,0.0,1.0
23149,1BR,16125,0,16125,2020.csv,2020,0.0,1.0
23150,Loot,16121,0,16121,2011.csv,2011,0.0,1.0
23151,Virginia Minnesota,16118,16118,0,2019.csv,2019,1.0,0.0
23152,Oxidan,16109,0,16109,2017.csv,2017,0.0,1.0
23153,"National Theatre Live: One Man, Two Guvnors",16097,0,16097,2011.csv,2011,0.0,1.0
23154,Levitated Mass,16086,16086,0,2014.csv,2014,1.0,0.0
23155,Hélio Oiticica,16081,0,16081,2014.csv,2014,0.0,1.0
23156,Straight Up,16080,16080,0,2020.csv,2020,1.0,0.0
23157,América,16079,0,16079,2011.csv,2011,0.0,1.0
23158,1920 London,16077,0,16077,2016.csv,2016,0.0,1.0
23159,Towelhead 2011 Re-release,16071,0,16071,2011.csv,2011,0.0,1.0
23160,Kissebaaz,16065,0,16065,2019.csv,2019,0.0,1.0
23161,Günter Wallraff - Schwarz auf weiß,16065,0,16065,2010.csv,2010,0.0,1.0
23162,Out of the Clear Blue Sky,16050,16050,0,2013.csv,2013,1.0,0.0
23163,Fish & Hook,16049,0,16049,2018.csv,2018,0.0,1.0
23164,Sweet Home 2017 Re-release,16049,0,16049,2017.csv,2017,0.0,1.0
23165,Action,16033,0,16033,2020.csv,2020,0.0,1.0
23166,Volver a Boedo,16032,0,16032,2018.csv,2018,0.0,1.0
23167,The Cross,16029,0,16029,2012.csv,2012,0.0,1.0
23168,Instructions Not Included 2016 Re-release,16022,0,16022,2016.csv,2016,0.0,1.0
23169,The Piano Teacher 2018 Re-release,16020,0,16020,2018.csv,2018,0.0,1.0
23170,Light in Darkness: The Return of Red Light Bandit,16014,0,16014,2012.csv,2012,0.0,1.0
23171,Long Shot: The Kevin Laue Story,16011,16011,0,2012.csv,2012,1.0,0.0
23172,Familystrip,16006,0,16006,2010.csv,2010,0.0,1.0
23173,The Sharks,16004,0,16004,2019.csv,2019,0.0,1.0
23174,Planet of Snail,16002,13957,2045,2012.csv,2012,0.8722034745656793,0.1277965254343207
23175,Supercapitalist,16000,16000,0,2012.csv,2012,1.0,0.0
23176,Kaly,16000,0,16000,2018.csv,2018,0.0,1.0
23177,Ronnie's,15996,0,15996,2020.csv,2020,0.0,1.0
23178,Boundless,15994,0,15994,2014.csv,2014,0.0,1.0
23179,Yuvaya Dönüs,15977,0,15977,2019.csv,2019,0.0,1.0
23180,In Heaven Underground: The Weissensee Jewish Cemetery,15958,0,15958,2011.csv,2011,0.0,1.0
23181,The Islands and the Whales,15946,0,15946,2018.csv,2018,0.0,1.0
23182,Kennedy Club,15936,0,15936,2019.csv,2019,0.0,1.0
23183,Lifelong,15930,0,15930,2013.csv,2013,0.0,1.0
23184,Charged: The Eduardo Garcia Story,15920,15920,0,2017.csv,2017,1.0,0.0
23185,The Choice 2018 Re-release,15917,0,15917,2018.csv,2018,0.0,1.0
23186,Seeking Happiness,15910,0,15910,2011.csv,2011,0.0,1.0
23187,Can You Dig This,15909,15909,0,2015.csv,2015,1.0,0.0
23188,El Kiosco,15903,0,15903,2019.csv,2019,0.0,1.0
23189,Tez: 13. Gece,15897,0,15897,2019.csv,2019,0.0,1.0
23190,Padi Padi Leche Manasu,15877,0,15877,2018.csv,2018,0.0,1.0
23191,This Binary Universe,15875,15875,0,2012.csv,2012,1.0,0.0
23192,Kako si?,15874,0,15874,2010.csv,2010,0.0,1.0
23193,Saem,15866,0,15866,2018.csv,2018,0.0,1.0
23194,Sanctuary,15864,0,15864,2015.csv,2015,0.0,1.0
23195,Murderous Trance,15863,0,15863,2018.csv,2018,0.0,1.0
23196,Isoken,15851,0,15851,2017.csv,2017,0.0,1.0
23197,Maui's Hook,15851,0,15851,2018.csv,2018,0.0,1.0
23198,National Theatre Live: A Disappearing Number,15850,0,15850,2010.csv,2010,0.0,1.0
23199,Starfish,15849,15849,0,2019.csv,2019,1.0,0.0
23200,The Lebanese Rocket Society,15843,0,15843,2013.csv,2013,0.0,1.0
23201,Private Universe,15840,0,15840,2012.csv,2012,0.0,1.0
23202,Sir Billi,15838,0,15838,2013.csv,2013,0.0,1.0
23203,La despedida 2012 Re-release,15833,0,15833,2012.csv,2012,0.0,1.0
23204,Tra due donne,15825,0,15825,2011.csv,2011,0.0,1.0
23205,"Mori, the Artist's Habitat",15818,0,15818,2020.csv,2020,0.0,1.0
23206,Les amigues de l'Àgata,15803,0,15803,2016.csv,2016,0.0,1.0
23207,My Great Grandfather,15800,0,15800,2019.csv,2019,0.0,1.0
23208,Pojdi z menoj,15793,0,15793,2016.csv,2016,0.0,1.0
23209,Beautiful Voice,15792,0,15792,2019.csv,2019,0.0,1.0
23210,A Reason,15792,15792,0,2015.csv,2015,1.0,0.0
23211,Defining Hope,15788,15788,0,2017.csv,2017,1.0,0.0
23212,Labyrinth 2020 Re-release,15779,0,15779,2020.csv,2020,0.0,1.0
23213,Salt Bridge,15777,0,15777,2017.csv,2017,0.0,1.0
23214,"The Gangs, the Oscars, and the Walking Dead",15769,0,15769,2020.csv,2020,0.0,1.0
23215,Griffen: Auf Den Spuren Von Peter Handke,15765,0,15765,2012.csv,2012,0.0,1.0
23216,Take Me Home,15760,15760,0,2012.csv,2012,1.0,0.0
23217,Eylül,15747,0,15747,2011.csv,2011,0.0,1.0
23218,Last Shelter,15738,0,15738,2015.csv,2015,0.0,1.0
23219,The Meg 2020 Re-release,15731,0,15731,2020.csv,2020,0.0,1.0
23220,El Duende,15727,0,15727,2019.csv,2019,0.0,1.0
23221,Full Moon in Paris,15726,15726,0,2015.csv,2015,1.0,0.0
23222,Destinos,15723,0,15723,2016.csv,2016,0.0,1.0
23223,Color of the Ocean,15720,0,15720,2012.csv,2012,0.0,1.0
23224,Trinity Seven The Movie 2: Heavens Library & Crimson Lord,15712,15712,0,2019.csv,2019,1.0,0.0
23225,Poor Cow,15709,0,15709,2016.csv,2016,0.0,1.0
23226,Colo,15701,0,15701,2018.csv,2018,0.0,1.0
23227,Pursuit,15688,0,15688,2017.csv,2017,0.0,1.0
23228,Yom men el-Ayyam,15688,0,15688,2017.csv,2017,0.0,1.0
23229,Sandik,15686,0,15686,2018.csv,2018,0.0,1.0
23230,Norberto's Deadline 2012 Re-release,15685,0,15685,2012.csv,2012,0.0,1.0
23231,The Dirty War on the National Health Service,15682,0,15682,2019.csv,2019,0.0,1.0
23232,Içimde Akan Nehir,15680,0,15680,2015.csv,2015,0.0,1.0
23233,Winter Song,15677,0,15677,2016.csv,2016,0.0,1.0
23234,Ricky 2011 Re-release,15673,0,15673,2011.csv,2011,0.0,1.0
23235,Mission to Lars,15671,0,15671,2012.csv,2012,0.0,1.0
23236,The Oscar Nominated Short Films 2017: Animation,15644,0,15644,2017.csv,2017,0.0,1.0
23237,Mayamohini,15631,0,15631,2012.csv,2012,0.0,1.0
23238,Breakdance Academy,15628,15628,0,2010.csv,2010,1.0,0.0
23239,Dreams Rewired,15626,11843,3783,2015.csv,2015,0.7579034941763727,0.2420965058236273
23240,As I Fall,15623,0,15623,2018.csv,2018,0.0,1.0
23241,Out on Stage,15623,15623,0,2018.csv,2018,1.0,0.0
23242,The Competition 2019 Re-release,15622,15622,0,2019.csv,2019,1.0,0.0
23243,Bloody Innocent,15621,0,15621,2010.csv,2010,0.0,1.0
23244,Pumpkin and Mayonnaise,15619,0,15619,2018.csv,2018,0.0,1.0
23245,Gueros 2016 Re-release,15618,0,15618,2016.csv,2016,0.0,1.0
23246,Basmati Blues,15605,0,15605,2017.csv,2017,0.0,1.0
23247,X500,15590,0,15590,2017.csv,2017,0.0,1.0
23248,Five Nights in Maine,15587,15587,0,2016.csv,2016,1.0,0.0
23249,Bob le Flambeur,15586,15586,0,2018.csv,2018,1.0,0.0
23250,Uma Vida à Espera,15584,0,15584,2017.csv,2017,0.0,1.0
23251,Level 16,15575,0,15575,2020.csv,2020,0.0,1.0
23252,Benidorm mon amour,15568,0,15568,2016.csv,2016,0.0,1.0
23253,My Good Hans,15565,0,15565,2016.csv,2016,0.0,1.0
23254,Beaufort 2012 Re-release,15560,0,15560,2012.csv,2012,0.0,1.0
23255,Vsio O Muzcynach,15559,0,15559,2016.csv,2016,0.0,1.0
23256,When You Read This Letter,15552,15552,0,2018.csv,2018,1.0,0.0
23257,Lamentos,15551,0,15551,2016.csv,2016,0.0,1.0
23258,Lost and Beautiful,15550,0,15550,2016.csv,2016,0.0,1.0
23259,Postcards from London,15548,5312,10236,2018.csv,2018,0.3416516593774119,0.6583483406225881
23260,A Fistful of Grapes 2017 Re-release,15542,0,15542,2017.csv,2017,0.0,1.0
23261,Celestial Wives of the Meadow Mari,15537,0,15537,2013.csv,2013,0.0,1.0
23262,Stuffed,15532,15532,0,2019.csv,2019,1.0,0.0
23263,Jindua,15526,0,15526,2017.csv,2017,0.0,1.0
23264,Facing Ali,15524,0,15524,2010.csv,2010,0.0,1.0
23265,The Hanged Man 2011 Re-release,15520,0,15520,2011.csv,2011,0.0,1.0
23266,Kathanayagan,15515,0,15515,2017.csv,2017,0.0,1.0
23267,Dreamkiller,15514,15514,0,2010.csv,2010,1.0,0.0
23268,Main Teri Tu Mera,15496,0,15496,2016.csv,2016,0.0,1.0
23269,Bombairiya,15496,0,15496,2019.csv,2019,0.0,1.0
23270,The British Guide to Showing Off,15496,0,15496,2011.csv,2011,0.0,1.0
23271,Tom of Finland 2018 Re-release,15483,3314,12169,2018.csv,2018,0.21404120648453143,0.7859587935154686
23272,Agter Die Ligte,15477,0,15477,2012.csv,2012,0.0,1.0
23273,"Mujer, casos de la vida real: Salud lejana",15476,0,15476,2011.csv,2011,0.0,1.0
23274,Escape from Patagonia,15475,0,15475,2016.csv,2016,0.0,1.0
23275,Kaland,15468,0,15468,2011.csv,2011,0.0,1.0
23276,Die Ontwaking,15462,0,15462,2016.csv,2016,0.0,1.0
23277,Leaves of Grass 2013 Re-release,15461,0,15461,2013.csv,2013,0.0,1.0
23278,Sow the Wind,15460,0,15460,2020.csv,2020,0.0,1.0
23279,They Will Have to Kill Us First: Malian Music In Exile,15453,7516,7937,2015.csv,2015,0.48637804956966285,0.5136219504303372
23280,Eva and Lola,15452,0,15452,2010.csv,2010,0.0,1.0
23281,Bachelors 2017 Re-release,15446,0,15446,2017.csv,2017,0.0,1.0
23282,The Perfect Weapon,15436,0,15436,2016.csv,2016,0.0,1.0
23283,Wolf Children 2014 Re-release,15433,0,15433,2014.csv,2014,0.0,1.0
23284,Il sesso aggiunto,15433,0,15433,2011.csv,2011,0.0,1.0
23285,California Solo,15433,15433,0,2012.csv,2012,1.0,0.0
23286,Revolt 2018 Re-release,15430,0,15430,2018.csv,2018,0.0,1.0
23287,Screaming Men,15427,0,15427,2011.csv,2011,0.0,1.0
23288,Sekerat Son,15412,0,15412,2016.csv,2016,0.0,1.0
23289,Dating Times,15410,0,15410,2019.csv,2019,0.0,1.0
23290,Paraiso: Tatlong kwento ng pag-asa 2010 Re-release,15406,0,15406,2010.csv,2010,0.0,1.0
23291,Be Somebody,15395,15395,0,2016.csv,2016,1.0,0.0
23292,José and Pilar,15392,0,15392,2011.csv,2011,0.0,1.0
23293,Vince & Kath & James,15388,0,15388,2016.csv,2016,0.0,1.0
23294,Between the Lines,15383,15383,0,2019.csv,2019,1.0,0.0
23295,Gece Gelen: Cin Bebek,15381,0,15381,2020.csv,2020,0.0,1.0
23296,Dumbstruck,15379,15379,0,2011.csv,2011,1.0,0.0
23297,18 Years Later,15365,0,15365,2010.csv,2010,0.0,1.0
23298,The Adderall Diaries,15364,13191,2173,2016.csv,2016,0.8585654777401718,0.14143452225982817
23299,Ronal the Barbarian 2013 Re-release,15364,0,15364,2013.csv,2013,0.0,1.0
23300,Best Comedy Shorts,15360,0,15360,2020.csv,2020,0.0,1.0
23301,A Long Journey,15350,0,15350,2012.csv,2012,0.0,1.0
23302,Masha And The Bear: Masha's Songs,15348,0,15348,2020.csv,2020,0.0,1.0
23303,My Amazing Funeral,15344,0,15344,2019.csv,2019,0.0,1.0
23304,The President,15338,7578,7760,2016.csv,2016,0.4940670230799322,0.5059329769200678
23305,The Assignment 2018 Re-release,15334,0,15334,2018.csv,2018,0.0,1.0
23306,Narcissister Organ Player,15334,15334,0,2018.csv,2018,1.0,0.0
23307,Cindy Does Not Love Me,15328,0,15328,2010.csv,2010,0.0,1.0
23308,Anoche,15322,0,15322,2019.csv,2019,0.0,1.0
23309,Submarino 2012 Re-release,15317,0,15317,2012.csv,2012,0.0,1.0
23310,Only the Young,15312,15312,0,2012.csv,2012,1.0,0.0
23311,El extraordinario viaje de Lucius Dumb,15306,0,15306,2013.csv,2013,0.0,1.0
23312,Contemporary Color,15305,15305,0,2017.csv,2017,1.0,0.0
23313,Blue Bird,15298,0,15298,2013.csv,2013,0.0,1.0
23314,Warren Miller's Timeless,15297,0,15297,2020.csv,2020,0.0,1.0
23315,They Reach,15289,0,15289,2020.csv,2020,0.0,1.0
23316,When We Talk About KGB,15289,0,15289,2016.csv,2016,0.0,1.0
23317,Seefood,15287,0,15287,2017.csv,2017,0.0,1.0
23318,Hungry Hearts 2018 Re-release,15274,0,15274,2018.csv,2018,0.0,1.0
23319,Henry V 2016 Re-release,15271,0,15271,2016.csv,2016,0.0,1.0
23320,American Deep State,15269,15269,0,2020.csv,2020,1.0,0.0
23321,Remember Me? 2015 Re-release,15266,0,15266,2015.csv,2015,0.0,1.0
23322,Night Flight,15264,0,15264,2015.csv,2015,0.0,1.0
23323,Starcrossed,15263,15263,0,2016.csv,2016,1.0,0.0
23324,Dolores,15254,0,15254,2016.csv,2016,0.0,1.0
23325,Arabian Nights: Volume 2 - The Desolate One,15245,6398,8847,2015.csv,2015,0.4196785831420138,0.5803214168579862
23326,Halj már meg!,15245,0,15245,2016.csv,2016,0.0,1.0
23327,Las tetas de mi madre,15245,0,15245,2015.csv,2015,0.0,1.0
23328,People's Republic of Desire,15241,15241,0,2018.csv,2018,1.0,0.0
23329,"Lord, Give Me Patience 2018 Re-release",15239,0,15239,2018.csv,2018,0.0,1.0
23330,Rocky 2020 Re-release,15235,0,15235,2020.csv,2020,0.0,1.0
23331,Pinamar,15225,0,15225,2016.csv,2016,0.0,1.0
23332,The Samaritan,15220,2521,12699,2012.csv,2012,0.16563731931668857,0.8343626806833114
23333,Ruler,15213,0,15213,2019.csv,2019,0.0,1.0
23334,Marhulový ostrov,15211,0,15211,2011.csv,2011,0.0,1.0
23335,Los Fabulosos 7,15195,0,15195,2013.csv,2013,0.0,1.0
23336,Permette? Alberto Sordi,15194,0,15194,2020.csv,2020,0.0,1.0
23337,Vesvese: Cin Tuzagi,15193,0,15193,2015.csv,2015,0.0,1.0
23338,When Geek Meets Serial Killer,15189,0,15189,2015.csv,2015,0.0,1.0
23339,Very Smart Very Lucky,15174,0,15174,2019.csv,2019,0.0,1.0
23340,The Extraordinary Tale,15174,0,15174,2014.csv,2014,0.0,1.0
23341,Ring Master,15159,0,15159,2014.csv,2014,0.0,1.0
23342,A Summer in Genoa 2011 Re-release,15158,0,15158,2011.csv,2011,0.0,1.0
23343,Funan,15152,15152,0,2019.csv,2019,1.0,0.0
23344,Cloudburst,15151,0,15151,2013.csv,2013,0.0,1.0
23345,Omar Al Azrak,15127,0,15127,2017.csv,2017,0.0,1.0
23346,Corazon De Caracas,15124,0,15124,2013.csv,2013,0.0,1.0
23347,The Olivia Experiment,15122,15122,0,2014.csv,2014,1.0,0.0
23348,Kung Fu Joe,15120,15120,0,2012.csv,2012,1.0,0.0
23349,We Are the Robbers,15115,0,15115,2015.csv,2015,0.0,1.0
23350,Indrajith,15092,0,15092,2017.csv,2017,0.0,1.0
23351,Trade of Innocents,15091,15091,0,2012.csv,2012,1.0,0.0
23352,Rebels on Pointe,15088,15088,0,2017.csv,2017,1.0,0.0
23353,Cheatin',15077,15077,0,2015.csv,2015,1.0,0.0
23354,Barefoot,15071,15071,0,2014.csv,2014,1.0,0.0
23355,Tian Lai Meng Xiang,15069,0,15069,2018.csv,2018,0.0,1.0
23356,She Loves Me,15063,0,15063,2017.csv,2017,0.0,1.0
23357,ATM,15056,0,15056,2016.csv,2016,0.0,1.0
23358,Sense sostre,15052,0,15052,2019.csv,2019,0.0,1.0
23359,Sin fin,15045,0,15045,2019.csv,2019,0.0,1.0
23360,Wolf Hunters,15044,0,15044,2017.csv,2017,0.0,1.0
23361,Gorilla,15035,0,15035,2019.csv,2019,0.0,1.0
23362,Scarecrows,15035,0,15035,2018.csv,2018,0.0,1.0
23363,Caught in the Web,15033,1067,13966,2012.csv,2012,0.07097718352956828,0.9290228164704317
23364,I am Charlie,15031,0,15031,2015.csv,2015,0.0,1.0
23365,Tomorrow Will Be Better,15031,0,15031,2012.csv,2012,0.0,1.0
23366,Next to Me,15015,0,15015,2015.csv,2015,0.0,1.0
23367,Agathe Cléry 2010 Re-release,15012,0,15012,2010.csv,2010,0.0,1.0
23368,Concrete Clouds,15007,0,15007,2014.csv,2014,0.0,1.0
23369,I'm Not Jesus Mommy,15005,15005,0,2011.csv,2011,1.0,0.0
23370,The Tenant,15003,15003,0,2011.csv,2011,1.0,0.0
23371,Tammisunnuntai 1918,14998,0,14998,2018.csv,2018,0.0,1.0
23372,Prosta historia o milosci,14962,0,14962,2010.csv,2010,0.0,1.0
23373,Anadolu Atesi,14958,0,14958,2012.csv,2012,0.0,1.0
23374,The Great Guys,14955,0,14955,2017.csv,2017,0.0,1.0
23375,"Mary, Marry Me",14952,0,14952,2019.csv,2019,0.0,1.0
23376,Wrinkles the Clown,14938,14938,0,2019.csv,2019,1.0,0.0
23377,Cat City,14937,0,14937,2018.csv,2018,0.0,1.0
23378,Domingo de ramos,14936,0,14936,2012.csv,2012,0.0,1.0
23379,AUN: The Beginning and the End of All Things,14934,0,14934,2011.csv,2011,0.0,1.0
23380,I Declare War,14928,14928,0,2013.csv,2013,1.0,0.0
23381,Ivan's Childhood 2016 Re-release,14918,0,14918,2016.csv,2016,0.0,1.0
23382,Funcionário do Mês,14915,0,14915,2016.csv,2016,0.0,1.0
23383,I Have a Date with Spring,14912,0,14912,2018.csv,2018,0.0,1.0
23384,Fake Tattoos,14907,0,14907,2018.csv,2018,0.0,1.0
23385,"A Guy from Hollywood, or the Unusual Adventures of Veni Vesunchik",14905,0,14905,2018.csv,2018,0.0,1.0
23386,La Maison de la radio,14905,8095,6810,2013.csv,2013,0.5431063401543106,0.45689365984568936
23387,Trust Machine: The Story of Blockchain,14905,14905,0,2018.csv,2018,1.0,0.0
23388,Wings of Desire 2017 Re-release,14905,0,14905,2017.csv,2017,0.0,1.0
23389,Dear Vs Bear,14902,0,14902,2014.csv,2014,0.0,1.0
23390,Corralón,14901,0,14901,2017.csv,2017,0.0,1.0
23391,Penguin Rescue,14892,0,14892,2018.csv,2018,0.0,1.0
23392,Together,14880,0,14880,2018.csv,2018,0.0,1.0
23393,ZZ Top: That Little Ol' Band from Texas,14879,14879,0,2019.csv,2019,1.0,0.0
23394,Vorogayt,14877,0,14877,2016.csv,2016,0.0,1.0
23395,Happy New Year,14874,0,14874,2011.csv,2011,0.0,1.0
23396,Rupture,14864,0,14864,2016.csv,2016,0.0,1.0
23397,Motherland,14854,0,14854,2015.csv,2015,0.0,1.0
23398,Keep Watch the Lifetime,14853,0,14853,2018.csv,2018,0.0,1.0
23399,Last Night 2017 Re-release,14846,0,14846,2017.csv,2017,0.0,1.0
23400,Toys in the Attic 2010 Re-release,14844,0,14844,2010.csv,2010,0.0,1.0
23401,Our Big Time,14841,0,14841,2013.csv,2013,0.0,1.0
23402,The Divide 2014 Re-release,14837,0,14837,2014.csv,2014,0.0,1.0
23403,The Edge of Love 2011 Re-release,14837,0,14837,2011.csv,2011,0.0,1.0
23404,Dear Grandma,14830,0,14830,2016.csv,2016,0.0,1.0
23405,Horses of God 2014 Re-release,14817,14817,0,2014.csv,2014,1.0,0.0
23406,El limonero real,14814,0,14814,2016.csv,2016,0.0,1.0
23407,La última isla,14809,0,14809,2013.csv,2013,0.0,1.0
23408,Vince Giordano: There's a Future in the Past,14807,14807,0,2017.csv,2017,1.0,0.0
23409,Buddha Collapsed Out of Shame 2010 Re-release,14806,0,14806,2010.csv,2010,0.0,1.0
23410,Rey's Education,14805,0,14805,2019.csv,2019,0.0,1.0
23411,The 727 Days Without Karamo,14804,0,14804,2013.csv,2013,0.0,1.0
23412,Depeche Mode: Live in Berlin,14796,0,14796,2017.csv,2017,0.0,1.0
23413,Another Heart,14793,0,14793,2012.csv,2012,0.0,1.0
23414,New Town Utopia,14793,0,14793,2018.csv,2018,0.0,1.0
23415,Love Is Not What It Used to Be,14792,0,14792,2014.csv,2014,0.0,1.0
23416,Kapitalism: Our Improved Formula,14786,0,14786,2010.csv,2010,0.0,1.0
23417,Ja-jeon-cha-wang Eom-bok-dong,14782,0,14782,2019.csv,2019,0.0,1.0
23418,The Manson Family Massacre,14782,0,14782,2020.csv,2020,0.0,1.0
23419,Le trip à trois,14780,0,14780,2019.csv,2019,0.0,1.0
23420,Wyrmwood: Road of the Dead 2016 Re-release,14769,0,14769,2016.csv,2016,0.0,1.0
23421,The Metropolitan Opera HD Live: Handel: Agrippina,14766,0,14766,2020.csv,2020,0.0,1.0
23422,The Sound of Music 2020 Re-release,14755,0,14755,2020.csv,2020,0.0,1.0
23423,Kiss of the Damned,14752,14752,0,2013.csv,2013,1.0,0.0
23424,The Merger 2017 Re-release,14742,0,14742,2017.csv,2017,0.0,1.0
23425,The Prey 2012 Re-release,14738,13959,779,2012.csv,2012,0.9471434387298141,0.05285656127018591
23426,Just Kids 2020 Re-release,14726,0,14726,2020.csv,2020,0.0,1.0
23427,Sweet Virginia,14725,11753,2972,2017.csv,2017,0.7981663837011884,0.20183361629881155
23428,A Stranger,14707,0,14707,2013.csv,2013,0.0,1.0
23429,Gloria,14701,14701,0,2015.csv,2015,1.0,0.0
23430,30 Beats,14693,14693,0,2012.csv,2012,1.0,0.0
23431,Da3doush,14690,0,14690,2017.csv,2017,0.0,1.0
23432,Charlie Chaplin 2,14678,0,14678,2019.csv,2019,0.0,1.0
23433,The Trip 2015 Re-release,14676,0,14676,2015.csv,2015,0.0,1.0
23434,Martin Margiela: In His Own Words,14673,0,14673,2020.csv,2020,0.0,1.0
23435,Show Me Your Love,14667,0,14667,2017.csv,2017,0.0,1.0
23436,Maigret and the St. Fiacre Case,14666,0,14666,2019.csv,2019,0.0,1.0
23437,It Begins with the End 2012 Re-release,14649,0,14649,2012.csv,2012,0.0,1.0
23438,Groove City,14646,0,14646,2016.csv,2016,0.0,1.0
23439,Last Men in Aleppo,14637,14637,0,2017.csv,2017,1.0,0.0
23440,Dakini,14633,0,14633,2018.csv,2018,0.0,1.0
23441,Zwischen Himmel und Erde. Anthroposophie heute,14620,0,14620,2010.csv,2010,0.0,1.0
23442,Meat Grinder 2010 Re-release,14620,0,14620,2010.csv,2010,0.0,1.0
23443,A Perfect Day to Fly,14618,0,14618,2015.csv,2015,0.0,1.0
23444,10 Days in a Madhouse,14616,14616,0,2015.csv,2015,1.0,0.0
23445,Unraveled,14615,14615,0,2012.csv,2012,1.0,0.0
23446,A Man's Story,14612,0,14612,2012.csv,2012,0.0,1.0
23447,Litigante,14603,0,14603,2019.csv,2019,0.0,1.0
23448,Themis 2013 Re-release,14592,0,14592,2013.csv,2013,0.0,1.0
23449,Buzzard,14591,14591,0,2015.csv,2015,1.0,0.0
23450,Eraserhead 2017 Re-release,14590,0,14590,2017.csv,2017,0.0,1.0
23451,Third Star,14586,0,14586,2011.csv,2011,0.0,1.0
23452,Miau,14586,0,14586,2018.csv,2018,0.0,1.0
23453,Tristana,14586,14586,0,2012.csv,2012,1.0,0.0
23454,The Young Victoria 2011 Re-release,14580,0,14580,2011.csv,2011,0.0,1.0
23455,The Libertines: There Are No Innocent Bystanders,14572,0,14572,2012.csv,2012,0.0,1.0
23456,"White as Milk, Red as Blood 2014 Re-release",14557,0,14557,2014.csv,2014,0.0,1.0
23457,Hile yolu,14545,0,14545,2013.csv,2013,0.0,1.0
23458,El Encuentro de Guayaquil,14542,0,14542,2016.csv,2016,0.0,1.0
23459,Across the Sea,14527,0,14527,2014.csv,2014,0.0,1.0
23460,Girls of the Sun 2020 Re-release,14525,0,14525,2020.csv,2020,0.0,1.0
23461,Wild Strawberries 2017 Re-release,14524,0,14524,2017.csv,2017,0.0,1.0
23462,Kobi,14524,0,14524,2018.csv,2018,0.0,1.0
23463,Ferrante Fever,14518,11137,3381,2018.csv,2018,0.7671166827386693,0.23288331726133077
23464,Ein Augenblick Leben,14516,0,14516,2014.csv,2014,0.0,1.0
23465,Swagger of Thieves,14507,0,14507,2018.csv,2018,0.0,1.0
23466,Siembra,14503,0,14503,2016.csv,2016,0.0,1.0
23467,When Ge Sanghua Opened,14496,0,14496,2018.csv,2018,0.0,1.0
23468,Can Tertip,14495,0,14495,2015.csv,2015,0.0,1.0
23469,Im Bazar der Geschlechter 2011 Re-release,14494,0,14494,2011.csv,2011,0.0,1.0
23470,The Wanderers 2016 Re-release,14492,14492,0,2016.csv,2016,1.0,0.0
23471,The Testament,14489,0,14489,2018.csv,2018,0.0,1.0
23472,Amor Fati,14489,0,14489,2020.csv,2020,0.0,1.0
23473,Hellions,14485,0,14485,2016.csv,2016,0.0,1.0
23474,Atlantic.,14484,0,14484,2015.csv,2015,0.0,1.0
23475,Romantic Warrior,14484,0,14484,2017.csv,2017,0.0,1.0
23476,Be Pure. Be Vigilant. Behave.,14483,0,14483,2019.csv,2019,0.0,1.0
23477,Svengali,14482,0,14482,2014.csv,2014,0.0,1.0
23478,Dersu Uzala,14480,0,14480,2016.csv,2016,0.0,1.0
23479,Någon annanstans i Sverige,14479,0,14479,2011.csv,2011,0.0,1.0
23480,Antarctica: Ice and Sky 2017 Re-release,14475,14475,0,2017.csv,2017,1.0,0.0
23481,Dollhouse,14469,0,14469,2012.csv,2012,0.0,1.0
23482,Kauwboy 2013 Re-release,14468,0,14468,2013.csv,2013,0.0,1.0
23483,The Salesman,14467,0,14467,2012.csv,2012,0.0,1.0
23484,Life Is Peachy,14466,0,14466,2011.csv,2011,0.0,1.0
23485,Dead,14465,0,14465,2020.csv,2020,0.0,1.0
23486,The Public Image is Rotten,14464,11293,3171,2018.csv,2018,0.7807660398230089,0.21923396017699115
23487,¡Vivan las Antipodas!,14463,0,14463,2012.csv,2012,0.0,1.0
23488,The Two Escobars,14457,14457,0,2010.csv,2010,1.0,0.0
23489,Lu xing gong lue,14454,0,14454,2019.csv,2019,0.0,1.0
23490,My Son 2019 Re-release,14450,14450,0,2019.csv,2019,1.0,0.0
23491,El Fin de una Guerra,14444,0,14444,2017.csv,2017,0.0,1.0
23492,Easter in Art,14442,0,14442,2021.csv,2021,0.0,1.0
23493,Pestrye sumerki,14434,0,14434,2010.csv,2010,0.0,1.0
23494,Måste gitt,14430,0,14430,2017.csv,2017,0.0,1.0
23495,Judge Singh LLB,14428,0,14428,2015.csv,2015,0.0,1.0
23496,Newton,14426,0,14426,2018.csv,2018,0.0,1.0
23497,Overflow,14414,0,14414,2011.csv,2011,0.0,1.0
23498,The Little Gangster 2016 Re-release,14412,0,14412,2016.csv,2016,0.0,1.0
23499,Swirl,14411,0,14411,2012.csv,2012,0.0,1.0
23500,Tom Meets Zizou: Kein Sommermärchen,14410,0,14410,2011.csv,2011,0.0,1.0
23501,The Last Movie Star,14410,14410,0,2018.csv,2018,1.0,0.0
23502,Ringu 2019 Re-release,14403,0,14403,2019.csv,2019,0.0,1.0
23503,Vermilion,14402,0,14402,2018.csv,2018,0.0,1.0
23504,The Unbelievers,14400,14400,0,2013.csv,2013,1.0,0.0
23505,The Uncondemned,14393,14393,0,2016.csv,2016,1.0,0.0
23506,Roslik y el pueblo de las caras sospechosamente rusas,14393,0,14393,2017.csv,2017,0.0,1.0
23507,Exhibition,14378,14344,34,2014.csv,2014,0.9976352761162888,0.0023647238837112253
23508,The Princess Bride 2019 Re-release,14376,0,14376,2013.csv,2013,0.0,1.0
23509,Nenu Local,14372,0,14372,2017.csv,2017,0.0,1.0
23510,The Last Summer of La Boyita,14368,0,14368,2010.csv,2010,0.0,1.0
23511,Nobody's Watching 2018 Re-release,14364,0,14364,2018.csv,2018,0.0,1.0
23512,Justice Is Mind,14360,14360,0,2013.csv,2013,1.0,0.0
23513,Gone Doggy Gone,14354,14354,0,2015.csv,2015,1.0,0.0
23514,Peep World,14351,14351,0,2011.csv,2011,1.0,0.0
23515,The Nun 2013 Re-release,14349,0,14349,2013.csv,2013,0.0,1.0
23516,"It's Not Me, I Swear!",14345,0,14345,2010.csv,2010,0.0,1.0
23517,Awaking from a Dream,14340,0,14340,2010.csv,2010,0.0,1.0
23518,Destiny Among the Mountains,14335,0,14335,2017.csv,2017,0.0,1.0
23519,Days of European Films,14334,0,14334,2010.csv,2010,0.0,1.0
23520,Machines,14331,9710,4621,2017.csv,2017,0.6775521596538971,0.32244784034610285
23521,Tierra arrasada,14329,0,14329,2019.csv,2019,0.0,1.0
23522,When the Trees Fall,14318,0,14318,2018.csv,2018,0.0,1.0
23523,Summer with Monika,14316,0,14316,2017.csv,2017,0.0,1.0
23524,Farming Boys,14315,0,14315,2017.csv,2017,0.0,1.0
23525,Budapest 2011 Re-release,14313,0,14313,2011.csv,2011,0.0,1.0
23526,Hermosa juventud 2015 Re-release,14311,0,14311,2015.csv,2015,0.0,1.0
23527,Simple Simon 2011 Re-release,14299,0,14299,2011.csv,2011,0.0,1.0
23528,A Driver for Vera 2010 Re-release,14294,0,14294,2010.csv,2010,0.0,1.0
23529,Pescadores,14286,0,14286,2017.csv,2017,0.0,1.0
23530,Becoming,14285,0,14285,2020.csv,2020,0.0,1.0
23531,Feast of Varanasi,14282,0,14282,2016.csv,2016,0.0,1.0
23532,Never Stand Still,14272,14272,0,2012.csv,2012,1.0,0.0
23533,Brothers,14262,0,14262,2011.csv,2011,0.0,1.0
23534,Rouhgneck,14259,0,14259,2014.csv,2014,0.0,1.0
23535,Nostalgia 2016 Re-release,14255,0,14255,2016.csv,2016,0.0,1.0
23536,Abstinent,14251,0,14251,2019.csv,2019,0.0,1.0
23537,Love Opera,14244,0,14244,2020.csv,2020,0.0,1.0
23538,Combat Obscura,14242,14242,0,2019.csv,2019,1.0,0.0
23539,Little Love,14235,0,14235,2019.csv,2019,0.0,1.0
23540,Saheb Biwi Aur Gangster,14231,14231,0,2011.csv,2011,1.0,0.0
23541,M-8,14223,0,14223,2020.csv,2020,0.0,1.0
23542,Elevator,14221,0,14221,2012.csv,2012,0.0,1.0
23543,Total Recall 2020 Re-release,14219,0,14219,2020.csv,2020,0.0,1.0
23544,Guruldayan Kalpler,14218,0,14218,2015.csv,2015,0.0,1.0
23545,Listen Up Philip 2016 Re-release,14218,0,14218,2016.csv,2016,0.0,1.0
23546,Await the Dawn,14218,0,14218,2020.csv,2020,0.0,1.0
23547,Brother Nature,14218,14218,0,2016.csv,2016,1.0,0.0
23548,Love Punch,14213,0,14213,2017.csv,2017,0.0,1.0
23549,Yaar Anmulle,14203,0,14203,2011.csv,2011,0.0,1.0
23550,My Best Friend,14193,0,14193,2018.csv,2018,0.0,1.0
23551,Dear Other Self,14185,0,14185,2017.csv,2017,0.0,1.0
23552,The Sex Trip,14178,0,14178,2017.csv,2017,0.0,1.0
23553,My Name Is Emily,14177,0,14177,2016.csv,2016,0.0,1.0
23554,Sinners,14174,0,14174,2019.csv,2019,0.0,1.0
23555,The Snatch Thief,14170,0,14170,2018.csv,2018,0.0,1.0
23556,Actores S.A.,14150,0,14150,2013.csv,2013,0.0,1.0
23557,A Perfect Man,14147,7117,7030,2013.csv,2013,0.5030748568601117,0.49692514313988834
23558,Iphigénie en Tauride,14139,0,14139,2011.csv,2011,0.0,1.0
23559,Lampedusa in Winter,14135,0,14135,2015.csv,2015,0.0,1.0
23560,Self-Portrait of a Dutiful Daughter,14130,0,14130,2015.csv,2015,0.0,1.0
23561,Bajarí: Gypsy Barcelona,14126,0,14126,2013.csv,2013,0.0,1.0
23562,Newtown,14109,14109,0,2016.csv,2016,1.0,0.0
23563,We Won't Grow Old Together,14104,14104,0,2012.csv,2012,1.0,0.0
23564,Radius,14097,0,14097,2018.csv,2018,0.0,1.0
23565,Ac kapiyi cok fenayim,14092,0,14092,2017.csv,2017,0.0,1.0
23566,My Wife and I,14087,0,14087,2017.csv,2017,0.0,1.0
23567,Alla Wadaka,14084,0,14084,2017.csv,2017,0.0,1.0
23568,"I Was at Home, But...",14078,14078,0,2020.csv,2020,1.0,0.0
23569,The White King,14074,0,14074,2017.csv,2017,0.0,1.0
23570,Shangri-La Suite,14073,14073,0,2016.csv,2016,1.0,0.0
23571,Jurassic Bark,14070,0,14070,2019.csv,2019,0.0,1.0
23572,Smoorverliefd 2013 Re-release,14064,0,14064,2013.csv,2013,0.0,1.0
23573,Phoenix Valley,14064,0,14064,2016.csv,2016,0.0,1.0
23574,Never Too Old to Meow,14064,0,14064,2014.csv,2014,0.0,1.0
23575,Gayby,14062,14062,0,2012.csv,2012,1.0,0.0
23576,6 Month Rule,14057,14057,0,2012.csv,2012,1.0,0.0
23577,Head Games,14056,14056,0,2012.csv,2012,1.0,0.0
23578,Harry Potter and the Half-Blood Prince 2016 Re-release,14048,0,14048,2016.csv,2016,0.0,1.0
23579,Spaceship,14044,0,14044,2017.csv,2017,0.0,1.0
23580,Ghetto Physics,14034,14034,0,2010.csv,2010,1.0,0.0
23581,The Artist 2011 Re-release,14033,0,14033,2011.csv,2011,0.0,1.0
23582,Rio Que Nos Atraviesa,14031,0,14031,2014.csv,2014,0.0,1.0
23583,Chasing the Blues,14030,14030,0,2018.csv,2018,1.0,0.0
23584,The Magnetic Tree,14026,0,14026,2014.csv,2014,0.0,1.0
23585,Rules of Single Life,14024,0,14024,2011.csv,2011,0.0,1.0
23586,Bobby 2010 Re-release,14017,0,14017,2010.csv,2010,0.0,1.0
23587,Tangerine 2018 Re-release,14006,0,14006,2018.csv,2018,0.0,1.0
23588,Pepperminta,14004,0,14004,2010.csv,2010,0.0,1.0
23589,Il Futuro,14001,14001,0,2013.csv,2013,1.0,0.0
23590,The Girl on the Bridge,13998,0,13998,2020.csv,2020,0.0,1.0
23591,The 2nd,13996,0,13996,2020.csv,2020,0.0,1.0
23592,Florianópolis Dream,13991,0,13991,2019.csv,2019,0.0,1.0
23593,Manny,13974,0,13974,2014.csv,2014,0.0,1.0
23594,Passerby #3,13967,0,13967,2010.csv,2010,0.0,1.0
23595,Screwball,13967,13967,0,2019.csv,2019,1.0,0.0
23596,Menina,13964,0,13964,2019.csv,2019,0.0,1.0
23597,Colosio 2013 Re-release,13962,0,13962,2013.csv,2013,0.0,1.0
23598,T-Guardians 2019 Re-release,13962,0,13962,2019.csv,2019,0.0,1.0
23599,Calm at Sea,13956,0,13956,2013.csv,2013,0.0,1.0
23600,Petromax,13955,0,13955,2019.csv,2019,0.0,1.0
23601,Kirmizi,13951,0,13951,2015.csv,2015,0.0,1.0
23602,"Sara Baras, All Her Voices",13943,0,13943,2018.csv,2018,0.0,1.0
23603,Stephen Fry Live: More Fool Me,13940,0,13940,2014.csv,2014,0.0,1.0
23604,A Russian Youth,13939,0,13939,2020.csv,2020,0.0,1.0
23605,Yosemite,13931,13931,0,2016.csv,2016,1.0,0.0
23606,Lighting Dindin 2019 Re-release,13931,0,13931,2019.csv,2019,0.0,1.0
23607,Weed the People,13926,13926,0,2018.csv,2018,1.0,0.0
23608,Rayskie kushchi,13926,0,13926,2015.csv,2015,0.0,1.0
23609,Volcano,13925,0,13925,2019.csv,2019,0.0,1.0
23610,Qatrat Dam,13925,0,13925,2016.csv,2016,0.0,1.0
23611,My Rembrandt,13896,0,13896,2020.csv,2020,0.0,1.0
23612,Ellie & Abbie (& Ellie's Dead Aunt),13893,0,13893,2020.csv,2020,0.0,1.0
23613,The Albanian,13889,0,13889,2011.csv,2011,0.0,1.0
23614,This Is Martin Bonner,13888,13888,0,2013.csv,2013,1.0,0.0
23615,The Ghost of Monk's Island,13886,0,13886,2017.csv,2017,0.0,1.0
23616,Falling Away,13869,13869,0,2012.csv,2012,1.0,0.0
23617,"I Love You, Hater",13866,0,13866,2018.csv,2018,0.0,1.0
23618,Hunting Season,13859,0,13859,2017.csv,2017,0.0,1.0
23619,Genesis,13856,6784,7072,2019.csv,2019,0.4896073903002309,0.5103926096997691
23620,The Unvanished Vapour,13854,0,13854,2016.csv,2016,0.0,1.0
23621,Backcountry,13848,13848,0,2015.csv,2015,1.0,0.0
23622,Scarred Hearts,13847,0,13847,2016.csv,2016,0.0,1.0
23623,Kattappanayile Rithwik Roshan,13845,0,13845,2016.csv,2016,0.0,1.0
23624,Sound of Nomad: Koryo Arirang,13844,0,13844,2017.csv,2017,0.0,1.0
23625,Bilched,13841,0,13841,2019.csv,2019,0.0,1.0
23626,Thirst,13827,0,13827,2016.csv,2016,0.0,1.0
23627,Sympathy for Delicious,13826,13826,0,2011.csv,2011,1.0,0.0
23628,Las olas,13824,0,13824,2012.csv,2012,0.0,1.0
23629,The Show of Shows,13824,0,13824,2015.csv,2015,0.0,1.0
23630,A Dark Song 2019 Re-release,13823,0,13823,2019.csv,2019,0.0,1.0
23631,Parayi Bulduk,13820,0,13820,2017.csv,2017,0.0,1.0
23632,Dert Bende,13819,0,13819,2019.csv,2019,0.0,1.0
23633,Barry Lyndon 2019 Re-release,13814,0,13814,2019.csv,2019,0.0,1.0
23634,My Name Is Hmmm...,13805,0,13805,2014.csv,2014,0.0,1.0
23635,Dofus - Livre 1: Julith,13804,0,13804,2016.csv,2016,0.0,1.0
23636,The Lion Roars 2,13803,0,13803,2012.csv,2012,0.0,1.0
23637,Alexia,13801,0,13801,2011.csv,2011,0.0,1.0
23638,Don't Tell Her 2018 Re-release,13794,0,13794,2018.csv,2018,0.0,1.0
23639,Stavisky...,13793,13793,0,2018.csv,2018,1.0,0.0
23640,Harry Potter and the Order of the Phoenix 2016 Re-release,13791,0,13791,2016.csv,2016,0.0,1.0
23641,Retribution,13780,0,13780,2011.csv,2011,0.0,1.0
23642,The Pretty One,13769,13769,0,2014.csv,2014,1.0,0.0
23643,Podhuvaga En Manasu Thangam,13761,0,13761,2017.csv,2017,0.0,1.0
23644,Evelyn,13759,0,13759,2012.csv,2012,0.0,1.0
23645,Vladenie 18,13743,0,13743,2014.csv,2014,0.0,1.0
23646,Vikadakumaran,13740,0,13740,2018.csv,2018,0.0,1.0
23647,A Space Program,13739,13739,0,2016.csv,2016,1.0,0.0
23648,The Eighth Day of the Week,13739,0,13739,2017.csv,2017,0.0,1.0
23649,Madmast Barkhaa,13738,0,13738,2015.csv,2015,0.0,1.0
23650,Dorfman in Love,13737,13737,0,2013.csv,2013,1.0,0.0
23651,Hide and Seek,13729,0,13729,2018.csv,2018,0.0,1.0
23652,Dolfje Weerwolfje 2013 Re-release,13726,0,13726,2013.csv,2013,0.0,1.0
23653,Discarnate,13723,0,13723,2019.csv,2019,0.0,1.0
23654,Don McKay,13722,13722,0,2010.csv,2010,1.0,0.0
23655,The Magic Flute,13710,0,13710,2017.csv,2017,0.0,1.0
23656,Time to Die,13707,13707,0,2017.csv,2017,1.0,0.0
23657,The Strange Case of Angelica 2013 Re-release,13703,0,13703,2013.csv,2013,0.0,1.0
23658,Daisies,13692,13692,0,2012.csv,2012,1.0,0.0
23659,Kaptan feza,13688,0,13688,2010.csv,2010,0.0,1.0
23660,This One's for the Ladies,13688,13688,0,2019.csv,2019,1.0,0.0
23661,The Law in These Parts,13683,13683,0,2012.csv,2012,1.0,0.0
23662,Tikkun,13671,13671,0,2016.csv,2016,1.0,0.0
23663,Red Trees,13666,13666,0,2017.csv,2017,1.0,0.0
23664,Oculus 2017 Re-release,13664,0,13664,2017.csv,2017,0.0,1.0
23665,Saber Crecer,13660,0,13660,2017.csv,2017,0.0,1.0
23666,Troublers,13651,0,13651,2017.csv,2017,0.0,1.0
23667,Knight of the Rose,13649,0,13649,2010.csv,2010,0.0,1.0
23668,National Theatre Live: Jane Eyre,13639,0,13639,2016.csv,2016,0.0,1.0
23669,Sub-zero Wind,13632,0,13632,2019.csv,2019,0.0,1.0
23670,Afterlov,13627,0,13627,2017.csv,2017,0.0,1.0
23671,Madonna and the Breakfast Club,13622,0,13622,2019.csv,2019,0.0,1.0
23672,You Don't Mess with Little Bugs 2021 Re-release,13621,0,13621,2021.csv,2021,0.0,1.0
23673,The Seventh Seal 2017 Re-release,13619,0,13619,2017.csv,2017,0.0,1.0
23674,Fifi Howls from Happiness,13614,13614,0,2014.csv,2014,1.0,0.0
23675,A Quiet Place 2020 Re-release,13610,0,13610,2020.csv,2020,0.0,1.0
23676,Dildariyaan,13606,0,13606,2015.csv,2015,0.0,1.0
23677,Serseriler,13599,0,13599,2019.csv,2019,0.0,1.0
23678,When the Iron Bird Flies: Tibetan Buddhism Arrives in the West,13598,13598,0,2012.csv,2012,1.0,0.0
23679,Berlin Calling 2010 Re-release,13596,0,13596,2010.csv,2010,0.0,1.0
23680,Neka ostane medju nama,13593,0,13593,2012.csv,2012,0.0,1.0
23681,A Passage to India 2011 Re-release,13591,0,13591,2011.csv,2011,0.0,1.0
23682,Algunos días sin música,13582,0,13582,2014.csv,2014,0.0,1.0
23683,Kolej Havasi,13574,0,13574,2019.csv,2019,0.0,1.0
23684,Stray Dogs,13573,10433,3140,2014.csv,2014,0.7686583658734252,0.23134163412657482
23685,The Lightkeepers,13567,0,13567,2010.csv,2010,0.0,1.0
23686,Yom Lel Settat,13559,0,13559,2016.csv,2016,0.0,1.0
23687,Eli,13547,13547,0,2015.csv,2015,1.0,0.0
23688,Dysfunctional Friends,13546,13546,0,2012.csv,2012,1.0,0.0
23689,From Paris with Love 2012 Re-release,13545,0,13545,2012.csv,2012,0.0,1.0
23690,Matariki,13545,0,13545,2010.csv,2010,0.0,1.0
23691,If You Were Me,13542,0,13542,2016.csv,2016,0.0,1.0
23692,Prey,13541,0,13541,2020.csv,2020,0.0,1.0
23693,Jattu Engineer,13533,0,13533,2017.csv,2017,0.0,1.0
23694,After Spring,13529,0,13529,2018.csv,2018,0.0,1.0
23695,The Forlorned,13522,0,13522,2018.csv,2018,0.0,1.0
23696,Paper Man,13514,13514,0,2010.csv,2010,1.0,0.0
23697,The Doors - 50th Anniversary Celebration,13509,0,13509,2019.csv,2019,0.0,1.0
23698,A Christmas Story 2010 Re-release,13508,0,13508,2010.csv,2010,0.0,1.0
23699,The Hitman's Bodyguard 2020 Re-release,13506,0,13506,2020.csv,2020,0.0,1.0
23700,Handsome Harry,13500,13500,0,2010.csv,2010,1.0,0.0
23701,Shadowman,13498,13498,0,2017.csv,2017,1.0,0.0
23702,Penance/Penance (Part 2),13497,0,13497,2012.csv,2012,0.0,1.0
23703,Tomorrow 2019 Re-release,13490,0,13490,2019.csv,2019,0.0,1.0
23704,Ezra 2017 Re-release,13488,0,13488,2017.csv,2017,0.0,1.0
23705,Last and First Men,13475,0,13475,2020.csv,2020,0.0,1.0
23706,Body Brokers,13472,0,13472,2021.csv,2021,0.0,1.0
23707,La noche más fría,13472,0,13472,2017.csv,2017,0.0,1.0
23708,The Alter Date,13471,0,13471,2019.csv,2019,0.0,1.0
23709,Good Fellas: Ongals and the Stranger,13471,0,13471,2019.csv,2019,0.0,1.0
23710,Village at the End of the World,13471,0,13471,2013.csv,2013,0.0,1.0
23711,Belgian Disaster,13465,0,13465,2015.csv,2015,0.0,1.0
23712,Spices of Liberty,13463,13463,0,2016.csv,2016,1.0,0.0
23713,First Born,13463,0,13463,2018.csv,2018,0.0,1.0
23714,Ping Pong,13459,0,13459,2012.csv,2012,0.0,1.0
23715,A River Below,13456,0,13456,2018.csv,2018,0.0,1.0
23716,Into the Darkness,13454,0,13454,2020.csv,2020,0.0,1.0
23717,Kojot,13453,0,13453,2017.csv,2017,0.0,1.0
23718,Philophobia,13451,0,13451,2020.csv,2020,0.0,1.0
23719,Samurai,13451,0,13451,2013.csv,2013,0.0,1.0
23720,Black Bread 2014 Re-release,13448,0,13448,2014.csv,2014,0.0,1.0
23721,The Metropolitan Opera HD Live: Berg: Lulu,13446,0,13446,2016.csv,2016,0.0,1.0
23722,Teatro Alla Scala: The Temple of Wonders,13441,0,13441,2016.csv,2016,0.0,1.0
23723,Danur 2: Maddah,13432,0,13432,2019.csv,2019,0.0,1.0
23724,Neruppu Da,13429,0,13429,2017.csv,2017,0.0,1.0
23725,Stray,13428,13325,103,2021.csv,2021,0.9923294608281203,0.007670539171879654
23726,Monsieur Hulot's Holiday 2016 Re-release,13426,0,13426,2016.csv,2016,0.0,1.0
23727,Dalavere,13424,0,13424,2019.csv,2019,0.0,1.0
23728,Houroub Moufajee,13413,0,13413,2018.csv,2018,0.0,1.0
23729,Itsi Bitsi 2019 Re-release,13410,0,13410,2019.csv,2019,0.0,1.0
23730,Sacrilege,13407,0,13407,2020.csv,2020,0.0,1.0
23731,Harry Potter and the Goblet of Fire 2016 Re-release,13407,0,13407,2016.csv,2016,0.0,1.0
23732,The Lion King 2018 Re-release,13406,0,13406,2018.csv,2018,0.0,1.0
23733,Ted Sieger's Molly Monster 2018 Re-release,13405,0,13405,2018.csv,2018,0.0,1.0
23734,From Prada to Nada 2012 Re-release,13404,0,13404,2012.csv,2012,0.0,1.0
23735,The Bell,13401,0,13401,2011.csv,2011,0.0,1.0
23736,Trampas De Tu Lado Oscuro,13390,0,13390,2013.csv,2013,0.0,1.0
23737,For Good Old Times,13389,0,13389,2019.csv,2019,0.0,1.0
23738,"La bani, la cap, la oase",13389,0,13389,2011.csv,2011,0.0,1.0
23739,Battle of Hip Hopera,13386,0,13386,2018.csv,2018,0.0,1.0
23740,War of the Worlds: Goliath,13385,13385,0,2014.csv,2014,1.0,0.0
23741,3 Lives,13378,0,13378,2019.csv,2019,0.0,1.0
23742,My Lai Four,13376,0,13376,2010.csv,2010,0.0,1.0
23743,Black Tape,13360,0,13360,2015.csv,2015,0.0,1.0
23744,Blood Brothers,13357,0,13357,2013.csv,2013,0.0,1.0
23745,Week-ends 2015 Re-release,13353,0,13353,2015.csv,2015,0.0,1.0
23746,Yves Saint Laurent: The Last Collections,13352,0,13352,2019.csv,2019,0.0,1.0
23747,Solaris 2017 Re-release,13352,0,13352,2017.csv,2017,0.0,1.0
23748,The Goonies 2010 Re-release,13346,0,13346,2010.csv,2010,0.0,1.0
23749,Khanet El Yek,13328,0,13328,2016.csv,2016,0.0,1.0
23750,Portrait of the Fighter as a Young Man,13314,0,13314,2010.csv,2010,0.0,1.0
23751,The Conjuring,13307,0,13307,2020.csv,2020,0.0,1.0
23752,Violet Tendencies,13304,13304,0,2010.csv,2010,1.0,0.0
23753,Never Let Me Go 2012 Re-release,13298,0,13298,2012.csv,2012,0.0,1.0
23754,Kiss the Water,13295,0,13295,2014.csv,2014,0.0,1.0
23755,Rapid Response,13294,13294,0,2019.csv,2019,1.0,0.0
23756,Anton's Right Here,13286,0,13286,2012.csv,2012,0.0,1.0
23757,Killer Raccoons! 2! Dark Christmas in the Dark!,13282,13282,0,2020.csv,2020,1.0,0.0
23758,The Lion of St. Mark,13274,0,13274,2013.csv,2013,0.0,1.0
23759,Lotte and the Lost Dragons,13269,0,13269,2020.csv,2020,0.0,1.0
23760,Iraivi,13263,0,13263,2016.csv,2016,0.0,1.0
23761,April Apocalypse,13261,0,13261,2015.csv,2015,0.0,1.0
23762,Dos Mujeres y una Vaca,13260,0,13260,2016.csv,2016,0.0,1.0
23763,Interview 2010 Re-release,13258,0,13258,2010.csv,2010,0.0,1.0
23764,Late Spring,13254,13254,0,2016.csv,2016,1.0,0.0
23765,Kaddisch für einen Freund,13251,0,13251,2012.csv,2012,0.0,1.0
23766,Oldu mu simdi?,13250,0,13250,2016.csv,2016,0.0,1.0
23767,The Sleepwalkers,13249,0,13249,2019.csv,2019,0.0,1.0
23768,Doctor Zhivago 2011 Re-release,13246,0,13246,2011.csv,2011,0.0,1.0
23769,Days and Nights,13243,13243,0,2014.csv,2014,1.0,0.0
23770,Blood of My Blood 2010 Re-release,13240,0,13240,2010.csv,2010,0.0,1.0
23771,The Free Man,13238,0,13238,2017.csv,2017,0.0,1.0
23772,Na Lune,13235,0,13235,2020.csv,2020,0.0,1.0
23773,Sindhubaadh,13220,0,13220,2019.csv,2019,0.0,1.0
23774,Sons of Denmark,13219,0,13219,2019.csv,2019,0.0,1.0
23775,23 segundos,13215,0,13215,2014.csv,2014,0.0,1.0
23776,Our Blood is Wine,13210,13210,0,2018.csv,2018,1.0,0.0
23777,The Big Lebowski 2020 Re-release,13203,0,13203,2020.csv,2020,0.0,1.0
23778,Lobos,13201,0,13201,2019.csv,2019,0.0,1.0
23779,Mendilim Kekik Kokuyor,13200,0,13200,2020.csv,2020,0.0,1.0
23780,Dadas,13200,0,13200,2016.csv,2016,0.0,1.0
23781,"Intent to Destroy: Death, Denial & Depiction",13194,13194,0,2017.csv,2017,1.0,0.0
23782,Hypnotisören 2014 Re-release,13167,0,13167,2014.csv,2014,0.0,1.0
23783,Ashore,13163,0,13163,2019.csv,2019,0.0,1.0
23784,Daraa,13162,0,13162,2018.csv,2018,0.0,1.0
23785,Maborosi 2019 Re-release,13161,0,13161,2019.csv,2019,0.0,1.0
23786,Grands reportages: Belmondo par Belmondo,13148,0,13148,2016.csv,2016,0.0,1.0
23787,Sol LeWitt,13146,13146,0,2014.csv,2014,1.0,0.0
23788,"Clara, no es nombre de mujer",13146,0,13146,2013.csv,2013,0.0,1.0
23789,Super Nada,13146,0,13146,2013.csv,2013,0.0,1.0
23790,O'Horten 2012 Re-release,13146,0,13146,2012.csv,2012,0.0,1.0
23791,Masallardan Geriye Kalan,13142,0,13142,2020.csv,2020,0.0,1.0
23792,The Pleasures of Being Out of Step,13137,13137,0,2014.csv,2014,1.0,0.0
23793,Rest in Peace 2013 Re-release,13134,0,13134,2013.csv,2013,0.0,1.0
23794,The Last Picture Show 2011 Re-release,13131,0,13131,2011.csv,2011,0.0,1.0
23795,Jaya Janaki Nayaka,13125,0,13125,2017.csv,2017,0.0,1.0
23796,Atçali Kel Mehmet,13122,0,13122,2017.csv,2017,0.0,1.0
23797,"Sex, Party & Lies 2010 Re-release",13117,0,13117,2010.csv,2010,0.0,1.0
23798,The Breakfast Club 2020 Re-release,13115,0,13115,2020.csv,2020,0.0,1.0
23799,Lady Bloodfight,13109,0,13109,2017.csv,2017,0.0,1.0
23800,Arbaa Kotchina,13105,0,13105,2015.csv,2015,0.0,1.0
23801,Blame,13104,0,13104,2011.csv,2011,0.0,1.0
23802,The Trouble with Bliss,13093,13093,0,2012.csv,2012,1.0,0.0
23803,Valentino y el clan del can 2010 Re-release,13092,0,13092,2010.csv,2010,0.0,1.0
23804,La noche que no se repite,13087,0,13087,2018.csv,2018,0.0,1.0
23805,We Were There: True Love 2013 Re-release,13080,0,13080,2013.csv,2013,0.0,1.0
23806,Under the Boardwalk: The Monopoly Story,13080,13080,0,2011.csv,2011,1.0,0.0
23807,Golden Voices,13078,0,13078,2020.csv,2020,0.0,1.0
23808,Döndüm Ben,13071,0,13071,2019.csv,2019,0.0,1.0
23809,Ellipsis,13067,0,13067,2018.csv,2018,0.0,1.0
23810,The Salesman 2013 Re-release,13065,0,13065,2013.csv,2013,0.0,1.0
23811,Nothing But a Man,13063,13063,0,2012.csv,2012,1.0,0.0
23812,Twin Flower,13062,0,13062,2019.csv,2019,0.0,1.0
23813,Dragon Blade 2017 Re-release,13035,0,13035,2017.csv,2017,0.0,1.0
23814,Cría Cuervos,13029,0,13029,2011.csv,2011,0.0,1.0
23815,MSG: The Messenger of God,13025,0,13025,2015.csv,2015,0.0,1.0
23816,The Lady Eve 2019 Re-release,13020,0,13020,2019.csv,2019,0.0,1.0
23817,"How Much Does Your Building Weigh, Mr Foster? 2012 Re-release",13013,13013,0,2012.csv,2012,1.0,0.0
23818,Agnes Varda Retrospective,13008,0,13008,2010.csv,2010,0.0,1.0
23819,Rings of Peace,13007,0,13007,2016.csv,2016,0.0,1.0
23820,Jim,13000,13000,0,2010.csv,2010,1.0,0.0
23821,Mark of an Angel 2011 Re-release,12996,0,12996,2011.csv,2011,0.0,1.0
23822,Tale 52 2010 Re-release,12995,0,12995,2010.csv,2010,0.0,1.0
23823,Spain in a Day,12989,0,12989,2016.csv,2016,0.0,1.0
23824,North by Northwest 2019 Re-release,12973,0,12973,2019.csv,2019,0.0,1.0
23825,Bloodworth,12971,12971,0,2011.csv,2011,1.0,0.0
23826,Eugenia,12971,0,12971,2018.csv,2018,0.0,1.0
23827,Tryggo,12969,0,12969,2019.csv,2019,0.0,1.0
23828,Wrath,12968,0,12968,2017.csv,2017,0.0,1.0
23829,Eden 2019 Re-release,12965,0,12965,2019.csv,2019,0.0,1.0
23830,Like Me,12965,12965,0,2018.csv,2018,1.0,0.0
23831,Voyage,12965,0,12965,2014.csv,2014,0.0,1.0
23832,Duet for Cannibals 2019 re-release,12962,12962,0,2019.csv,2019,1.0,0.0
23833,K2: Siren of the Himalayas,12959,12959,0,2014.csv,2014,1.0,0.0
23834,XY Chelsea,12959,0,12959,2019.csv,2019,0.0,1.0
23835,The Constitution,12954,0,12954,2016.csv,2016,0.0,1.0
23836,The Last Rampage,12944,6294,6650,2017.csv,2017,0.48624845488257107,0.5137515451174289
23837,A Story of Children and Film,12943,0,12943,2014.csv,2014,0.0,1.0
23838,Alpha,12939,0,12939,2013.csv,2013,0.0,1.0
23839,Muertos de amor,12939,0,12939,2013.csv,2013,0.0,1.0
23840,Bobby,12931,0,12931,2016.csv,2016,0.0,1.0
23841,Fughe e approdi,12925,0,12925,2011.csv,2011,0.0,1.0
23842,Rewind,12916,0,12916,2011.csv,2011,0.0,1.0
23843,A Green Story,12901,12901,0,2013.csv,2013,1.0,0.0
23844,Ravage,12900,0,12900,2020.csv,2020,0.0,1.0
23845,Taipei Story,12897,12897,0,2017.csv,2017,1.0,0.0
23846,Fela,12896,0,12896,2011.csv,2011,0.0,1.0
23847,"Bir Gevrek, Bir Boyoz, Iki de Kumru",12891,0,12891,2013.csv,2013,0.0,1.0
23848,Nauja drauge,12888,0,12888,2015.csv,2015,0.0,1.0
23849,Write or Dance,12875,0,12875,2017.csv,2017,0.0,1.0
23850,Krazzy Tabbar,12874,0,12874,2017.csv,2017,0.0,1.0
23851,Sequin in a Blue Room,12872,0,12872,2020.csv,2020,0.0,1.0
23852,Boy 23 - The Forgotten Boys of Brazil,12869,0,12869,2016.csv,2016,0.0,1.0
23853,The Discreet Charm of the Bourgeoisie 2012 Re-release,12862,0,12862,2012.csv,2012,0.0,1.0
23854,Kanne Kalaimane,12855,0,12855,2019.csv,2019,0.0,1.0
23855,Permanent,12847,12847,0,2017.csv,2017,1.0,0.0
23856,The Taqwacores,12839,11445,1394,2010.csv,2010,0.8914245657761508,0.10857543422384922
23857,Empatía,12815,0,12815,2017.csv,2017,0.0,1.0
23858,Nhma,12810,0,12810,2017.csv,2017,0.0,1.0
23859,The Shock Doctrine,12810,0,12810,2010.csv,2010,0.0,1.0
23860,Ada for Mayor,12799,0,12799,2016.csv,2016,0.0,1.0
23861,My 10 Million,12796,0,12796,2016.csv,2016,0.0,1.0
23862,Junction 48,12795,12795,0,2017.csv,2017,1.0,0.0
23863,Storie sospese,12793,0,12793,2015.csv,2015,0.0,1.0
23864,Boxing Day,12792,0,12792,2012.csv,2012,0.0,1.0
23865,American Hunt,12792,0,12792,2020.csv,2020,0.0,1.0
23866,Mühr-ü Cin,12789,0,12789,2020.csv,2020,0.0,1.0
23867,Kill Chain,12787,0,12787,2020.csv,2020,0.0,1.0
23868,Capitan Basilico 2 - I Fantastici 4+4,12782,0,12782,2011.csv,2011,0.0,1.0
23869,The Man Who Wanted to Fly,12781,0,12781,2019.csv,2019,0.0,1.0
23870,The Unknown Woman 2010 Re-release,12780,0,12780,2010.csv,2010,0.0,1.0
23871,Voin.com,12778,0,12778,2012.csv,2012,0.0,1.0
23872,Förtroligheten,12774,0,12774,2013.csv,2013,0.0,1.0
23873,The Story of Film: An Odyssey,12766,0,12766,2013.csv,2013,0.0,1.0
23874,Yakuza Apocalypse,12756,12756,0,2015.csv,2015,1.0,0.0
23875,A Sublime Life,12751,0,12751,2018.csv,2018,0.0,1.0
23876,A Genius Professor,12751,0,12751,2018.csv,2018,0.0,1.0
23877,Alice in the Cities 2017 Re-release,12751,0,12751,2017.csv,2017,0.0,1.0
23878,Erased,12748,0,12748,2019.csv,2019,0.0,1.0
23879,Life for Sale 2015 Re-release,12742,0,12742,2015.csv,2015,0.0,1.0
23880,One Small Hitch,12735,0,12735,2013.csv,2013,0.0,1.0
23881,"Moi, Michel G., milliardaire, maître du monde",12730,0,12730,2011.csv,2011,0.0,1.0
23882,Virginia,12728,12728,0,2012.csv,2012,1.0,0.0
23883,Accomplices 2012 Re-release,12726,0,12726,2012.csv,2012,0.0,1.0
23884,Love and Redemption,12726,0,12726,2017.csv,2017,0.0,1.0
23885,A Call Girl 2012 Re-release,12724,0,12724,2012.csv,2012,0.0,1.0
23886,MAX Atlantos 2,12717,0,12717,2016.csv,2016,0.0,1.0
23887,Breakdance Academy 2013 Re-release,12708,12708,0,2013.csv,2013,1.0,0.0
23888,The Shop Around the Corner 2010 Re-release,12706,0,12706,2010.csv,2010,0.0,1.0
23889,Way Beyond Weight,12703,0,12703,2012.csv,2012,0.0,1.0
23890,Rammbock: Berlin Undead,12699,0,12699,2010.csv,2010,0.0,1.0
23891,Road to Wacken,12689,0,12689,2011.csv,2011,0.0,1.0
23892,Bigfoot,12685,0,12685,2019.csv,2019,0.0,1.0
23893,Winter Brothers,12685,0,12685,2018.csv,2018,0.0,1.0
23894,Iblisin Oglu 13. Vahset,12682,0,12682,2013.csv,2013,0.0,1.0
23895,Concerning Violence,12680,12680,0,2014.csv,2014,1.0,0.0
23896,Kaththi Sandai,12670,0,12670,2016.csv,2016,0.0,1.0
23897,Heal,12668,12668,0,2017.csv,2017,1.0,0.0
23898,Lipstick Under My Burkha,12657,0,12657,2017.csv,2017,0.0,1.0
23899,Onde O Coruja Dorme,12652,0,12652,2012.csv,2012,0.0,1.0
23900,The Goose Goes South,12650,0,12650,2018.csv,2018,0.0,1.0
23901,Munda Hi Chahida,12633,0,12633,2019.csv,2019,0.0,1.0
23902,Ivan,12633,0,12633,2017.csv,2017,0.0,1.0
23903,Bhopal: A Prayer for Rain,12628,12628,0,2014.csv,2014,1.0,0.0
23904,The Matrix 2020 Re-release,12627,0,12627,2020.csv,2020,0.0,1.0
23905,Kangaroo,12626,4547,8079,2018.csv,2018,0.3601298907017266,0.6398701092982734
23906,Eat Locals,12620,0,12620,2017.csv,2017,0.0,1.0
23907,Sethupathi,12617,0,12617,2016.csv,2016,0.0,1.0
23908,American Socialist: The Life and Times of Eugene Victor Debs,12609,12609,0,2018.csv,2018,1.0,0.0
23909,The Soft Skin,12609,0,12609,2011.csv,2011,0.0,1.0
23910,Bitter Years,12607,0,12607,2020.csv,2020,0.0,1.0
23911,Women Are Heroes,12604,0,12604,2011.csv,2011,0.0,1.0
23912,The Elephant Man 2020 Re-release,12597,0,12597,2020.csv,2020,0.0,1.0
23913,Boy Meets Girl,12589,12589,0,2014.csv,2014,1.0,0.0
23914,Husbands in Goa,12588,10135,2453,2012.csv,2012,0.8051318716237686,0.19486812837623133
23915,Le jour J,12585,0,12585,2017.csv,2017,0.0,1.0
23916,Bedways,12580,0,12580,2010.csv,2010,0.0,1.0
23917,Acid Forest,12579,0,12579,2019.csv,2019,0.0,1.0
23918,Of Fathers and Sons,12579,12579,0,2018.csv,2018,1.0,0.0
23919,Around June,12578,12578,0,2012.csv,2012,1.0,0.0
23920,Huellas,12577,0,12577,2017.csv,2017,0.0,1.0
23921,The Caller 2016 Re-release,12574,0,12574,2016.csv,2016,0.0,1.0
23922,May I Kill U?,12571,0,12571,2013.csv,2013,0.0,1.0
23923,Botanical Books 2018 Re-release,12569,0,12569,2018.csv,2018,0.0,1.0
23924,No Me Digas Solterona,12564,0,12564,2018.csv,2018,0.0,1.0
23925,Super Model,12561,0,12561,2016.csv,2016,0.0,1.0
23926,5x Pacificação,12559,0,12559,2012.csv,2012,0.0,1.0
23927,My Art,12554,12554,0,2018.csv,2018,1.0,0.0
23928,Sorelle Mai 2013 Re-release,12550,0,12550,2013.csv,2013,0.0,1.0
23929,Off Season,12544,12544,0,2019.csv,2019,1.0,0.0
23930,Voice Over,12543,0,12543,2012.csv,2012,0.0,1.0
23931,THE MASTER,12536,0,12536,2017.csv,2017,0.0,1.0
23932,Another Way,12516,0,12516,2017.csv,2017,0.0,1.0
23933,City of Women,12516,12516,0,2016.csv,2016,1.0,0.0
23934,Vjeshte e nxhete e '41,12516,0,12516,2016.csv,2016,0.0,1.0
23935,Rest in Peace,12511,0,12511,2010.csv,2010,0.0,1.0
23936,Jinna: Karabasan,12510,0,12510,2019.csv,2019,0.0,1.0
23937,The Umbrellas of Cherbourg 2017 Re-release,12508,0,12508,2017.csv,2017,0.0,1.0
23938,Dad is pretty,12502,0,12502,2019.csv,2019,0.0,1.0
23939,Here I Am,12500,0,12500,2011.csv,2011,0.0,1.0
23940,Diabolique 2011 Re-release,12498,0,12498,2011.csv,2011,0.0,1.0
23941,Punk Never Ends!,12497,0,12497,2020.csv,2020,0.0,1.0
23942,The Time Guardians,12495,0,12495,2020.csv,2020,0.0,1.0
23943,Phee Chai,12491,0,12491,2015.csv,2015,0.0,1.0
23944,Happiness of Shunde Family,12488,0,12488,2017.csv,2017,0.0,1.0
23945,"Chatô, O Rei do Brasil",12487,0,12487,2015.csv,2015,0.0,1.0
23946,Garantía personal,12485,0,12485,2017.csv,2017,0.0,1.0
23947,El silencio,12483,0,12483,2017.csv,2017,0.0,1.0
23948,Fanny and Alexander 2017 Re-release,12467,0,12467,2017.csv,2017,0.0,1.0
23949,Locman,12463,0,12463,2018.csv,2018,0.0,1.0
23950,Modern Times 2019 Re-release,12462,0,12462,2019.csv,2019,0.0,1.0
23951,Dukhtar,12452,0,12452,2016.csv,2016,0.0,1.0
23952,Ramiro,12445,0,12445,2018.csv,2018,0.0,1.0
23953,Anton Srholec,12434,0,12434,2015.csv,2015,0.0,1.0
23954,Pop Star,12434,0,12434,2010.csv,2010,0.0,1.0
23955,Country Far Away,12432,0,12432,2019.csv,2019,0.0,1.0
23956,Two Stupid Men,12432,0,12432,2019.csv,2019,0.0,1.0
23957,The Forbidden Kingdom 2010 Re-release,12429,0,12429,2010.csv,2010,0.0,1.0
23958,Bell Bottom,12419,0,12419,2019.csv,2019,0.0,1.0
23959,Kenny,12415,0,12415,2017.csv,2017,0.0,1.0
23960,Alien Addiction,12412,0,12412,2018.csv,2018,0.0,1.0
23961,Seven Beauties,12408,12408,0,2017.csv,2017,1.0,0.0
23962,The Switch 2013 Re-release,12404,0,12404,2013.csv,2013,0.0,1.0
23963,Cold Harbour,12402,0,12402,2014.csv,2014,0.0,1.0
23964,The Young Offenders,12402,0,12402,2016.csv,2016,0.0,1.0
23965,Restless Love,12388,0,12388,2016.csv,2016,0.0,1.0
23966,Back of the Net,12381,0,12381,2019.csv,2019,0.0,1.0
23967,Gholam,12378,0,12378,2018.csv,2018,0.0,1.0
23968,Second Hand Wedding 2010 Re-release,12376,0,12376,2010.csv,2010,0.0,1.0
23969,American Chaos,12368,12368,0,2018.csv,2018,1.0,0.0
23970,America the Beautiful 2: The Thin Commandments,12366,12366,0,2011.csv,2011,1.0,0.0
23971,Il Volo Con Placido Domingo,12366,0,12366,2017.csv,2017,0.0,1.0
23972,Rebirth,12358,12358,0,2011.csv,2011,1.0,0.0
23973,Por Que Você Partiu?,12338,0,12338,2013.csv,2013,0.0,1.0
23974,Black Sabbath: The End Of The End 2018 Re-release,12332,0,12332,2018.csv,2018,0.0,1.0
23975,Motherland Hotel,12328,0,12328,2017.csv,2017,0.0,1.0
23976,Karnaval,12323,0,12323,2013.csv,2013,0.0,1.0
23977,Dr. No 2020 Re-release,12322,0,12322,2020.csv,2020,0.0,1.0
23978,The 12th Man 2019 Re-release,12318,0,12318,2019.csv,2019,0.0,1.0
23979,L'héritage de la chouette,12316,12316,0,2018.csv,2018,1.0,0.0
23980,Sari sicak,12313,0,12313,2017.csv,2017,0.0,1.0
23981,El notificador,12308,0,12308,2012.csv,2012,0.0,1.0
23982,Rockstar Avilés,12300,0,12300,2016.csv,2016,0.0,1.0
23983,Kiss Rocks Vegas,12299,0,12299,2016.csv,2016,0.0,1.0
23984,Chambaili,12296,0,12296,2014.csv,2014,0.0,1.0
23985,Seytan Geçidi Enhara,12292,0,12292,2018.csv,2018,0.0,1.0
23986,Industria Argentina,12280,0,12280,2012.csv,2012,0.0,1.0
23987,Gamlinginn 2,12279,0,12279,2017.csv,2017,0.0,1.0
23988,4 Days in France,12273,12273,0,2017.csv,2017,1.0,0.0
23989,The Armor of Light,12267,12267,0,2015.csv,2015,1.0,0.0
23990,The Lady Of The Camellias - Bolshoi Ballet,12252,0,12252,2020.csv,2020,0.0,1.0
23991,Bir Annenin Feryadi,12247,0,12247,2017.csv,2017,0.0,1.0
23992,Wa-shoku Dream: Beyond Sushi,12240,12240,0,2015.csv,2015,1.0,0.0
23993,The Living Wake,12232,12232,0,2010.csv,2010,1.0,0.0
23994,Sealed Cargo,12232,0,12232,2016.csv,2016,0.0,1.0
23995,Enlightenment Film,12226,0,12226,2010.csv,2010,0.0,1.0
23996,Mulholland Dr. 2017 Re-release,12218,0,12218,2017.csv,2017,0.0,1.0
23997,Barça Dreams,12215,0,12215,2016.csv,2016,0.0,1.0
23998,Clash of Empires,12211,0,12211,2015.csv,2015,0.0,1.0
23999,Bricked,12201,12201,0,2019.csv,2019,1.0,0.0
24000,Darkness Rising,12198,0,12198,2017.csv,2017,0.0,1.0
24001,Wolfy the Incredible Secret 2015 Re-release,12196,0,12196,2015.csv,2015,0.0,1.0
24002,Kirik Party,12195,0,12195,2017.csv,2017,0.0,1.0
24003,18% Grey,12192,0,12192,2020.csv,2020,0.0,1.0
24004,Ve Panayir Köyden Gider,12190,0,12190,2016.csv,2016,0.0,1.0
24005,Battle of Ao Lun Prague,12185,0,12185,2019.csv,2019,0.0,1.0
24006,Yardy,12181,0,12181,2020.csv,2020,0.0,1.0
24007,Dhaka Attack,12181,0,12181,2017.csv,2017,0.0,1.0
24008,Saving Goola,12176,0,12176,2015.csv,2015,0.0,1.0
24009,Elstree 1976,12173,12173,0,2016.csv,2016,1.0,0.0
24010,Avanti popolo,12159,0,12159,2014.csv,2014,0.0,1.0
24011,Touch the Wall,12156,12156,0,2014.csv,2014,1.0,0.0
24012,Destiny,12156,12156,0,2016.csv,2016,1.0,0.0
24013,Greetings from Tim Buckley,12155,11157,998,2013.csv,2013,0.9178938708350473,0.08210612916495269
24014,I Wish I Knew 2012 Re-release,12154,0,12154,2012.csv,2012,0.0,1.0
24015,Splinter 2012 Re-release,12139,0,12139,2012.csv,2012,0.0,1.0
24016,Back Door Channels: The Price of Peace,12139,12139,0,2011.csv,2011,1.0,0.0
24017,Manta Ray,12135,0,12135,2019.csv,2019,0.0,1.0
24018,In No Great Hurry: 13 Lessons in Life with Saul Leiter,12133,12133,0,2014.csv,2014,1.0,0.0
24019,The Most Unknown,12119,12119,0,2018.csv,2018,1.0,0.0
24020,Call Me Kuchu,12110,9124,2986,2012.csv,2012,0.7534269199009084,0.24657308009909165
24021,Zen for Nothing,12107,12107,0,2019.csv,2019,1.0,0.0
24022,The Joneses 2012 Re-release,12106,0,12106,2012.csv,2012,0.0,1.0
24023,Hot Water,12101,12101,0,2016.csv,2016,1.0,0.0
24024,Earth's Women,12099,0,12099,2010.csv,2010,0.0,1.0
24025,Son-nim-1 Cheo-beon-jjae I-ya-gi,12098,0,12098,2010.csv,2010,0.0,1.0
24026,The Kids Grow Up,12095,12095,0,2010.csv,2010,1.0,0.0
24027,Return to Ithaca 2016 Re-release,12094,0,12094,2016.csv,2016,0.0,1.0
24028,Aliens 2015 Re-release,12093,0,12093,2015.csv,2015,0.0,1.0
24029,Passannante,12091,0,12091,2011.csv,2011,0.0,1.0
24030,A Murder in the Park,12088,12088,0,2015.csv,2015,1.0,0.0
24031,When Two Worlds Collide,12080,12080,0,2016.csv,2016,1.0,0.0
24032,Seotaiji Live Tour Zero,12080,0,12080,2011.csv,2011,0.0,1.0
24033,Maker Brother,12079,0,12079,2019.csv,2019,0.0,1.0
24034,Nemilosrdní,12077,0,12077,2015.csv,2015,0.0,1.0
24035,Little England 2015 Re-release,12077,12077,0,2015.csv,2015,1.0,0.0
24036,Zakhmi,12072,0,12072,2020.csv,2020,0.0,1.0
24037,Amphibious Creature of the Deep 2014 Re-release,12066,0,12066,2014.csv,2014,0.0,1.0
24038,Time,12061,0,12061,2020.csv,2020,0.0,1.0
24039,Legacy,12059,0,12059,2020.csv,2020,0.0,1.0
24040,Coconut Hero,12058,0,12058,2015.csv,2015,0.0,1.0
24041,Euthanizer,12057,0,12057,2017.csv,2017,0.0,1.0
24042,So Long Enthusiasm,12052,0,12052,2018.csv,2018,0.0,1.0
24043,Imprisoned,12050,12050,0,2019.csv,2019,1.0,0.0
24044,The Last Man,12047,0,12047,2018.csv,2018,0.0,1.0
24045,Quartet,12042,12042,0,2019.csv,2019,1.0,0.0
24046,Sem par nechistykh,12029,0,12029,2018.csv,2018,0.0,1.0
24047,Bring the Soul: The Movie 2020 Re-release,12028,0,12028,2020.csv,2020,0.0,1.0
24048,Lost Angels: Skid Row Is My Home,12025,12025,0,2012.csv,2012,1.0,0.0
24049,Senlikname: Bir Istanbul Masali,12024,0,12024,2010.csv,2010,0.0,1.0
24050,Çakallarla Dans 3: Sifir Sikinti,12024,0,12024,2014.csv,2014,0.0,1.0
24051,È per il tuo bene,12023,0,12023,2021.csv,2021,0.0,1.0
24052,Author: The JT LeRoy Story 2019 Re-release,12022,0,12022,2019.csv,2019,0.0,1.0
24053,Cereyan,12008,0,12008,2017.csv,2017,0.0,1.0
24054,The Devil Below,12008,0,12008,2021.csv,2021,0.0,1.0
24055,Student Services,12006,0,12006,2011.csv,2011,0.0,1.0
24056,Queen Margot 2014 Re-release,12005,12005,0,2014.csv,2014,1.0,0.0
24057,The Sun of Gnosis,12005,0,12005,2020.csv,2020,0.0,1.0
24058,Loup 2010 Re-release,11996,0,11996,2010.csv,2010,0.0,1.0
24059,A Useful Life 2012 Re-release,11989,0,11989,2012.csv,2012,0.0,1.0
24060,Rembrandt's J'Accuse,11987,0,11987,2010.csv,2010,0.0,1.0
24061,Mantaka Mahzoura,11985,0,11985,2017.csv,2017,0.0,1.0
24062,Christmas All Over Again,11972,0,11972,2017.csv,2017,0.0,1.0
24063,O Homem Que Não Dormia,11971,0,11971,2012.csv,2012,0.0,1.0
24064,Amour 2014 Re-release,11960,0,11960,2014.csv,2014,0.0,1.0
24065,El Sur,11959,0,11959,2016.csv,2016,0.0,1.0
24066,Autumn Sonata 2017 Re-release,11959,0,11959,2017.csv,2017,0.0,1.0
24067,Pet Departures,11958,0,11958,2018.csv,2018,0.0,1.0
24068,The Strange Little Cat,11956,5885,6071,2014.csv,2014,0.4922214787554366,0.5077785212445634
24069,In House,11955,0,11955,2012.csv,2012,0.0,1.0
24070,Dance with Me,11955,0,11955,2016.csv,2016,0.0,1.0
24071,In a Rush,11953,0,11953,2013.csv,2013,0.0,1.0
24072,Jasper Jones,11951,0,11951,2017.csv,2017,0.0,1.0
24073,The Last Race,11947,11947,0,2018.csv,2018,1.0,0.0
24074,A Stormy Summer Night,11947,0,11947,2015.csv,2015,0.0,1.0
24075,Road to the Sky,11933,0,11933,2017.csv,2017,0.0,1.0
24076,Frank Serpico,11925,11925,0,2017.csv,2017,1.0,0.0
24077,Antisocial 2,11924,0,11924,2018.csv,2018,0.0,1.0
24078,Rosa,11923,0,11923,2019.csv,2019,0.0,1.0
24079,Shakeela,11919,0,11919,2020.csv,2020,0.0,1.0
24080,The True Cost,11902,0,11902,2015.csv,2015,0.0,1.0
24081,"Cassandro, The Exotico!",11897,11897,0,2019.csv,2019,1.0,0.0
24082,Un fueguito. La historia de César Milstein,11892,0,11892,2010.csv,2010,0.0,1.0
24083,All This Panic,11891,0,11891,2017.csv,2017,0.0,1.0
24084,Hollywould,11888,11888,0,2019.csv,2019,1.0,0.0
24085,Noche herida,11881,0,11881,2017.csv,2017,0.0,1.0
24086,Once Upon a Time in Bihar,11880,0,11880,2015.csv,2015,0.0,1.0
24087,Rush,11878,0,11878,2012.csv,2012,0.0,1.0
24088,Motor Mitraan Di,11878,0,11878,2016.csv,2016,0.0,1.0
24089,Mevsim çiçek açti,11866,0,11866,2012.csv,2012,0.0,1.0
24090,Shut Up and Play the Piano,11864,0,11864,2019.csv,2019,0.0,1.0
24091,Revenge of the Mekons,11861,11861,0,2014.csv,2014,1.0,0.0
24092,Harry Potter and the Deathly Hallows: Part 1 2016 Re-release,11852,0,11852,2016.csv,2016,0.0,1.0
24093,Caught in the Crossfire,11850,0,11850,2013.csv,2013,0.0,1.0
24094,Impossible Crimes,11849,0,11849,2019.csv,2019,0.0,1.0
24095,Zuzula,11845,0,11845,2016.csv,2016,0.0,1.0
24096,Egg 2011 Re-release,11841,0,11841,2011.csv,2011,0.0,1.0
24097,Second Act 2020 Re-release,11839,0,11839,2020.csv,2020,0.0,1.0
24098,Exit,11834,0,11834,2017.csv,2017,0.0,1.0
24099,Setup 2014 Re-release,11832,0,11832,2014.csv,2014,0.0,1.0
24100,Upside Down,11831,0,11831,2016.csv,2016,0.0,1.0
24101,Ali 2013 Re-release,11823,0,11823,2013.csv,2013,0.0,1.0
24102,Passengers 2012 Re-release,11822,0,11822,2012.csv,2012,0.0,1.0
24103,Les Parents Terribles,11818,11818,0,2018.csv,2018,1.0,0.0
24104,Emptying the Skies,11811,11811,0,2015.csv,2015,1.0,0.0
24105,Hi-eo-ro,11799,0,11799,2010.csv,2010,0.0,1.0
24106,Pokkiri Raja,11794,0,11794,2016.csv,2016,0.0,1.0
24107,Tokyo Park,11785,0,11785,2012.csv,2012,0.0,1.0
24108,La Sargento Matacho,11781,0,11781,2017.csv,2017,0.0,1.0
24109,The Dry Land,11777,11777,0,2010.csv,2010,1.0,0.0
24110,Sangre de Campeones,11776,0,11776,2018.csv,2018,0.0,1.0
24111,The Perception,11769,0,11769,2019.csv,2019,0.0,1.0
24112,National Theatre Live: Everyman,11767,0,11767,2015.csv,2015,0.0,1.0
24113,Pattabhiraman,11760,0,11760,2019.csv,2019,0.0,1.0
24114,"Murder Me, Monster",11759,0,11759,2019.csv,2019,0.0,1.0
24115,Vuelo nocturno: La leyenda de las princesitas argentinas,11758,0,11758,2017.csv,2017,0.0,1.0
24116,Summer '03,11746,11746,0,2018.csv,2018,1.0,0.0
24117,The Invisible Hand,11743,0,11743,2017.csv,2017,0.0,1.0
24118,Rid of Me,11740,11740,0,2011.csv,2011,1.0,0.0
24119,Age Of Monster,11739,0,11739,2016.csv,2016,0.0,1.0
24120,Schlagerstar,11737,0,11737,2013.csv,2013,0.0,1.0
24121,Everything Is Different,11736,0,11736,2019.csv,2019,0.0,1.0
24122,The Apartment 2018 Re-release,11728,0,11728,2018.csv,2018,0.0,1.0
24123,Lucha Mexico,11722,11722,0,2016.csv,2016,1.0,0.0
24124,Seven Courtyards,11721,0,11721,2011.csv,2011,0.0,1.0
24125,Mamma + Mamma,11718,0,11718,2019.csv,2019,0.0,1.0
24126,White Wedding 2010 Re-release,11710,11710,0,2010.csv,2010,1.0,0.0
24127,The Basque Swastika,11710,0,11710,2013.csv,2013,0.0,1.0
24128,Of Mice and Men,11694,0,11694,2015.csv,2015,0.0,1.0
24129,The Flood,11692,0,11692,2019.csv,2019,0.0,1.0
24130,Flowers in Full Bloom,11688,0,11688,2018.csv,2018,0.0,1.0
24131,A Marriage Story,11686,0,11686,2017.csv,2017,0.0,1.0
24132,Chal Man Jeetva Jaiye,11682,0,11682,2018.csv,2018,0.0,1.0
24133,Tótem,11676,0,11676,2012.csv,2012,0.0,1.0
24134,Busy Inside,11675,0,11675,2019.csv,2019,0.0,1.0
24135,La Strada 2017 Re-release,11674,0,11674,2017.csv,2017,0.0,1.0
24136,Gaip,11670,0,11670,2019.csv,2019,0.0,1.0
24137,Same But Different: A True New Zealand Love Story,11670,0,11670,2019.csv,2019,0.0,1.0
24138,Halal Daddy,11662,0,11662,2017.csv,2017,0.0,1.0
24139,To Live!,11661,0,11661,2010.csv,2010,0.0,1.0
24140,Jojo Siwa's D.R.E.A.M. Tour On The Big Screen!,11661,0,11661,2020.csv,2020,0.0,1.0
24141,Zefir,11660,0,11660,2011.csv,2011,0.0,1.0
24142,The Umbrellas of Cherbourg 2019 Re-release,11649,0,11649,2019.csv,2019,0.0,1.0
24143,Balik,11642,0,11642,2014.csv,2014,0.0,1.0
24144,Tharai Thappattai,11640,0,11640,2016.csv,2016,0.0,1.0
24145,36 Saints,11640,11640,0,2013.csv,2013,1.0,0.0
24146,Monsieur Taurins,11633,0,11633,2011.csv,2011,0.0,1.0
24147,The Life of Fish 2012 Re-release,11628,0,11628,2012.csv,2012,0.0,1.0
24148,40% - Le mani libere del destino,11626,0,11626,2010.csv,2010,0.0,1.0
24149,Rurangi,11624,0,11624,2021.csv,2021,0.0,1.0
24150,Breakaway,11623,0,11623,2010.csv,2010,0.0,1.0
24151,Sprinter,11622,0,11622,2019.csv,2019,0.0,1.0
24152,Kurtlar ve Çakallar,11611,0,11611,2018.csv,2018,0.0,1.0
24153,Southbound 2017 Re-release,11610,0,11610,2017.csv,2017,0.0,1.0
24154,Liebe Geschichte,11610,0,11610,2011.csv,2011,0.0,1.0
24155,"Kafka, Kiffer und Chaoten",11610,0,11610,2014.csv,2014,0.0,1.0
24156,Locos de Amor 2,11610,0,11610,2019.csv,2019,0.0,1.0
24157,The Colors of the Mountain,11604,0,11604,2011.csv,2011,0.0,1.0
24158,The Tribes of Palos Verdes,11603,11603,0,2017.csv,2017,1.0,0.0
24159,11 Flowers,11599,9213,2386,2012.csv,2012,0.79429261143202,0.20570738856798
24160,Heat and Dust 2019 Re-release,11598,0,11598,2019.csv,2019,0.0,1.0
24161,I Can Quit Whenever I Want: Ad Honorem 2018 Re-release,11597,0,11597,2018.csv,2018,0.0,1.0
24162,Genesis 2.0,11596,0,11596,2018.csv,2018,0.0,1.0
24163,Vanakkam Chennai,11594,0,11594,2013.csv,2013,0.0,1.0
24164,Ritual,11575,0,11575,2013.csv,2013,0.0,1.0
24165,Superior Ultraman 8 Brothers 2010 Re-release,11569,0,11569,2010.csv,2010,0.0,1.0
24166,Around India with a Movie Camera,11568,10389,1179,2018.csv,2018,0.8980809128630706,0.10191908713692946
24167,A Family Submerged,11565,0,11565,2018.csv,2018,0.0,1.0
24168,La tierra roja 2016 Re-release,11562,0,11562,2016.csv,2016,0.0,1.0
24169,Nirvana,11560,0,11560,2017.csv,2017,0.0,1.0
24170,DonT Stop,11560,0,11560,2012.csv,2012,0.0,1.0
24171,The Preppie Connection,11558,11558,0,2016.csv,2016,1.0,0.0
24172,River of Grass,11553,11553,0,2016.csv,2016,1.0,0.0
24173,Paul à Québec,11552,0,11552,2017.csv,2017,0.0,1.0
24174,Polski film,11552,0,11552,2013.csv,2013,0.0,1.0
24175,There Were We,11550,0,11550,2017.csv,2017,0.0,1.0
24176,The Old Woman at the Back 2012 Re-release,11550,0,11550,2012.csv,2012,0.0,1.0
24177,The Ruins of Lifta,11548,11548,0,2016.csv,2016,1.0,0.0
24178,Soy tu karma,11547,0,11547,2017.csv,2017,0.0,1.0
24179,The Innocents,11546,0,11546,2016.csv,2016,0.0,1.0
24180,Baba Joon,11541,0,11541,2016.csv,2016,0.0,1.0
24181,Ultrasuede: In Search of Halston,11539,11539,0,2012.csv,2012,1.0,0.0
24182,Unbeatable Fighter,11539,0,11539,2019.csv,2019,0.0,1.0
24183,Funny Neighbors,11538,0,11538,2010.csv,2010,0.0,1.0
24184,After the Cup: Sons of Sakhnin United,11538,11538,0,2010.csv,2010,1.0,0.0
24185,The Very Excellent Mr. Dundee,11529,0,11529,2021.csv,2021,0.0,1.0
24186,Buen Camino,11524,0,11524,2020.csv,2020,0.0,1.0
24187,Elektra Luxx,11514,11514,0,2011.csv,2011,1.0,0.0
24188,Damat Kogusu,11514,0,11514,2017.csv,2017,0.0,1.0
24189,Hansel and Gretel 2010 Re-release,11511,0,11511,2010.csv,2010,0.0,1.0
24190,Gods 2010 Re-release,11506,0,11506,2010.csv,2010,0.0,1.0
24191,The Nameless 2011 Re-release,11502,0,11502,2011.csv,2011,0.0,1.0
24192,Bite the Dust,11500,0,11500,2013.csv,2013,0.0,1.0
24193,Pessimist,11499,0,11499,2016.csv,2016,0.0,1.0
24194,Psycho Vertical,11496,0,11496,2018.csv,2018,0.0,1.0
24195,Solaris,11494,0,11494,2016.csv,2016,0.0,1.0
24196,A Heavy Heart,11485,0,11485,2016.csv,2016,0.0,1.0
24197,Brighton Rock 2011 Re-release,11484,0,11484,2011.csv,2011,0.0,1.0
24198,Die Kleinen und die Bösen,11484,0,11484,2015.csv,2015,0.0,1.0
24199,Pappa Tamne Nahi Samjaay,11471,0,11471,2017.csv,2017,0.0,1.0
24200,Dharam Yudh Morcha,11462,0,11462,2016.csv,2016,0.0,1.0
24201,Muti Betulia Liberata - Mozart,11457,0,11457,2010.csv,2010,0.0,1.0
24202,The Snake,11456,0,11456,2012.csv,2012,0.0,1.0
24203,Stonehearst Asylum 2017 Re-release,11455,0,11455,2017.csv,2017,0.0,1.0
24204,All Yours,11449,0,11449,2015.csv,2015,0.0,1.0
24205,Whisky Galore!,11444,0,11444,2011.csv,2011,0.0,1.0
24206,High School Story: Supervised Student Teaching,11429,0,11429,2010.csv,2010,0.0,1.0
24207,The Final Member,11428,11428,0,2014.csv,2014,1.0,0.0
24208,The Great Invisible,11428,11428,0,2014.csv,2014,1.0,0.0
24209,Diktatör Adolf Hitler'in Hayatinin Esrarengiz Yönleri,11422,0,11422,2015.csv,2015,0.0,1.0
24210,The 3 L'il Pigs 2,11414,0,11414,2016.csv,2016,0.0,1.0
24211,Sommer 1972,11413,0,11413,2012.csv,2012,0.0,1.0
24212,Crazy All the Way,11412,0,11412,2019.csv,2019,0.0,1.0
24213,Stopped on Track 2013 Re-release,11408,0,11408,2013.csv,2013,0.0,1.0
24214,Anuraga Karikkin Vellam,11405,0,11405,2016.csv,2016,0.0,1.0
24215,Beside Bowie: The Mick Ronson Story,11400,11400,0,2017.csv,2017,1.0,0.0
24216,Jill Bilcock: Dancing the Invisible,11388,0,11388,2018.csv,2018,0.0,1.0
24217,Journey to the Snowing Mountains,11386,0,11386,2018.csv,2018,0.0,1.0
24218,Tersine,11384,0,11384,2014.csv,2014,0.0,1.0
24219,Respect,11379,0,11379,2018.csv,2018,0.0,1.0
24220,What Is Love,11373,0,11373,2012.csv,2012,0.0,1.0
24221,A Viagem,11373,0,11373,2017.csv,2017,0.0,1.0
24222,The Snob,11365,0,11365,2019.csv,2019,0.0,1.0
24223,Czech Peace,11361,0,11361,2010.csv,2010,0.0,1.0
24224,Eighteen,11359,0,11359,2010.csv,2010,0.0,1.0
24225,The Metropolitan Opera HD Live: Tchaikovsky: Iolanta/Bartók: Bluebeard's Castle,11354,0,11354,2015.csv,2015,0.0,1.0
24226,Brakes,11352,0,11352,2017.csv,2017,0.0,1.0
24227,Please Remember Me 2018 Re-release,11350,0,11350,2018.csv,2018,0.0,1.0
24228,Blue My Mind,11350,0,11350,2018.csv,2018,0.0,1.0
24229,Brother Number One,11348,0,11348,2012.csv,2012,0.0,1.0
24230,Go Sister,11347,0,11347,2018.csv,2018,0.0,1.0
24231,The Plague,11343,0,11343,2013.csv,2013,0.0,1.0
24232,Doordarshan,11336,0,11336,2020.csv,2020,0.0,1.0
24233,Gueumul,11333,0,11333,2017.csv,2017,0.0,1.0
24234,Resentimental,11328,0,11328,2016.csv,2016,0.0,1.0
24235,Qalb el-Asad,11328,0,11328,2013.csv,2013,0.0,1.0
24236,Ulan,11327,0,11327,2019.csv,2019,0.0,1.0
24237,Bhaskar Oru Rascal,11325,0,11325,2018.csv,2018,0.0,1.0
24238,Fairy,11324,0,11324,2020.csv,2020,0.0,1.0
24239,Rendezvous in July,11321,11321,0,2018.csv,2018,1.0,0.0
24240,Powerbomb,11319,11319,0,2020.csv,2020,1.0,0.0
24241,Draupadi Unleashed,11317,11317,0,2020.csv,2020,1.0,0.0
24242,Saigon Bodyguards,11314,11314,0,2017.csv,2017,1.0,0.0
24243,Viktoria,11314,11314,0,2016.csv,2016,1.0,0.0
24244,Gulaebaghavali,11313,0,11313,2018.csv,2018,0.0,1.0
24245,Midnight Cowboy 2019 Re-release,11311,0,11311,2019.csv,2019,0.0,1.0
24246,Mumford & Sons Live From South Africa: Dust and Thunder,11308,0,11308,2016.csv,2016,0.0,1.0
24247,RISE: The Story of Augustines,11301,0,11301,2019.csv,2019,0.0,1.0
24248,Lost in America,11301,11301,0,2020.csv,2020,1.0,0.0
24249,Terkedilmis,11299,0,11299,2015.csv,2015,0.0,1.0
24250,Vábenie výsok,11296,0,11296,2017.csv,2017,0.0,1.0
24251,The Last Summer of the Rich,11293,0,11293,2015.csv,2015,0.0,1.0
24252,Altmissekiz'den Yetmissekiz'e: Bahar isyancidir,11292,0,11292,2013.csv,2013,0.0,1.0
24253,Raphael: The Young Prodigy,11290,0,11290,2021.csv,2021,0.0,1.0
24254,Dishkiyaoon,11288,11288,0,2014.csv,2014,1.0,0.0
24255,Chronicle of the End of the World,11285,0,11285,2013.csv,2013,0.0,1.0
24256,Wilderness Gas Station,11280,0,11280,2017.csv,2017,0.0,1.0
24257,5.5.5,11273,0,11273,2013.csv,2013,0.0,1.0
24258,Theo Who Lived,11271,11271,0,2016.csv,2016,1.0,0.0
24259,Kaadan,11269,0,11269,2021.csv,2021,0.0,1.0
24260,Lo que nunca nos dijimos,11267,0,11267,2016.csv,2016,0.0,1.0
24261,Whack,11263,0,11263,2019.csv,2019,0.0,1.0
24262,Daylight's End,11257,0,11257,2016.csv,2016,0.0,1.0
24263,Bullitt County,11257,11257,0,2018.csv,2018,1.0,0.0
24264,In Like Flynn,11255,11255,0,2019.csv,2019,1.0,0.0
24265,The Fourth Portrait,11254,0,11254,2010.csv,2010,0.0,1.0
24266,"Boa Sorte, Meu Amor",11252,0,11252,2013.csv,2013,0.0,1.0
24267,Dìtská pásma a filmy 2010,11244,0,11244,2010.csv,2010,0.0,1.0
24268,Virginia Casta,11240,0,11240,2017.csv,2017,0.0,1.0
24269,AgainstBlood,11240,0,11240,2015.csv,2015,0.0,1.0
24270,Hacker,11239,11239,0,2016.csv,2016,1.0,0.0
24271,The Flag,11239,0,11239,2016.csv,2016,0.0,1.0
24272,Parasite 2020 Re-release,11238,0,11238,2020.csv,2020,0.0,1.0
24273,Bright Days Ahead 2015 Re-release,11237,0,11237,2015.csv,2015,0.0,1.0
24274,A Woman of Paris: A Drama of Fate,11233,0,11233,2018.csv,2018,0.0,1.0
24275,Aurora,11232,0,11232,2019.csv,2019,0.0,1.0
24276,Me Too 2012 Re-release,11228,0,11228,2012.csv,2012,0.0,1.0
24277,The Pathological Optimist,11222,11222,0,2017.csv,2017,1.0,0.0
24278,Ye Re Ye Re Paisa,11219,0,11219,2018.csv,2018,0.0,1.0
24279,It's a Lot,11211,0,11211,2013.csv,2013,0.0,1.0
24280,Try to Remember,11207,0,11207,2010.csv,2010,0.0,1.0
24281,Russian Death,11203,0,11203,2020.csv,2020,0.0,1.0
24282,Don't Forget About Me,11196,0,11196,2017.csv,2017,0.0,1.0
24283,Searching for Sugar Man 2015 Re-release,11191,0,11191,2015.csv,2015,0.0,1.0
24284,We Are Family,11191,0,11191,2017.csv,2017,0.0,1.0
24285,Sunny et l'éléphant 2011 Re-release,11184,0,11184,2011.csv,2011,0.0,1.0
24286,Children of Invention,11183,11183,0,2010.csv,2010,1.0,0.0
24287,Mirror Without Reflection,11172,0,11172,2020.csv,2020,0.0,1.0
24288,Saved by Grace,11172,0,11172,2018.csv,2018,0.0,1.0
24289,Oldboy 2019 Re-release,11171,0,11171,2019.csv,2019,0.0,1.0
24290,Hellraiser 2017 Re-release,11166,0,11166,2017.csv,2017,0.0,1.0
24291,In the Tracks Of: In the Tracks of Alexandre Desplat,11162,0,11162,2020.csv,2020,0.0,1.0
24292,Face Down,11161,0,11161,2015.csv,2015,0.0,1.0
24293,Seethakaathi,11159,0,11159,2018.csv,2018,0.0,1.0
24294,Made Me Do It,11151,11151,0,2019.csv,2019,1.0,0.0
24295,Taken 2 2020 Re-release,11149,0,11149,2020.csv,2020,0.0,1.0
24296,Angels of Revolution,11147,0,11147,2015.csv,2015,0.0,1.0
24297,"Now, Forager",11146,11146,0,2012.csv,2012,1.0,0.0
24298,Raça,11136,0,11136,2013.csv,2013,0.0,1.0
24299,The Matrix Reloaded 2019 Re-release,11136,0,11136,2019.csv,2019,0.0,1.0
24300,Samar,11132,0,11132,2013.csv,2013,0.0,1.0
24301,Parallel,11132,0,11132,2018.csv,2018,0.0,1.0
24302,The Nine Muses,11127,0,11127,2012.csv,2012,0.0,1.0
24303,El Supremo Manuscrito,11126,0,11126,2019.csv,2019,0.0,1.0
24304,The Delay,11122,0,11122,2012.csv,2012,0.0,1.0
24305,The Yard,11119,0,11119,2019.csv,2019,0.0,1.0
24306,Either Way,11113,0,11113,2011.csv,2011,0.0,1.0
24307,If Thoughts Can Kill (2018),11112,0,11112,2019.csv,2019,0.0,1.0
24308,"Maravilla, a Fighter Inside and Outside the Ring",11112,0,11112,2014.csv,2014,0.0,1.0
24309,Normal the Düsseldorf Ripper 2019 Re-release,11111,0,11111,2019.csv,2019,0.0,1.0
24310,Darbareye Elly 2017 Re-release,11108,0,11108,2017.csv,2017,0.0,1.0
24311,The Piano 2018 Re-release,11100,0,11100,2018.csv,2018,0.0,1.0
24312,InSight,11100,11100,0,2011.csv,2011,1.0,0.0
24313,Behind the Column,11099,0,11099,2017.csv,2017,0.0,1.0
24314,Ci vediamo a casa,11097,0,11097,2012.csv,2012,0.0,1.0
24315,Sunday,11086,0,11086,2019.csv,2019,0.0,1.0
24316,Pro Lyolyu i Minku,11086,0,11086,2020.csv,2020,0.0,1.0
24317,Noodle 2011 Re-release,11083,0,11083,2011.csv,2011,0.0,1.0
24318,Bunny the Killer Thing,11082,0,11082,2015.csv,2015,0.0,1.0
24319,BBC Proms: First Night of the Proms,11079,0,11079,2011.csv,2011,0.0,1.0
24320,Solos en la ciudad,11076,0,11076,2011.csv,2011,0.0,1.0
24321,Lollipop Monster,11075,0,11075,2011.csv,2011,0.0,1.0
24322,Bittersweet Brew,11073,0,11073,2018.csv,2018,0.0,1.0
24323,Natasaarvabhowma,11063,0,11063,2019.csv,2019,0.0,1.0
24324,The Hooligan Factory,11060,0,11060,2014.csv,2014,0.0,1.0
24325,"Njósnir, lygar og fjölskyldubönd",11059,0,11059,2016.csv,2016,0.0,1.0
24326,Ateej,11058,0,11058,2016.csv,2016,0.0,1.0
24327,The Black Book of Father Dinis,11057,0,11057,2018.csv,2018,0.0,1.0
24328,Edward II 2018 Re-release,11055,4826,6229,2018.csv,2018,0.4365445499773858,0.5634554500226142
24329,Louise's Diary 1942,11046,0,11046,2010.csv,2010,0.0,1.0
24330,The Challenge,11043,11043,0,2017.csv,2017,1.0,0.0
24331,Exceptionally Gifted Girl,11039,0,11039,2019.csv,2019,0.0,1.0
24332,Milk 2011 Re-release,11037,0,11037,2011.csv,2011,0.0,1.0
24333,Bald Mountain 2014 Re-release,11034,0,11034,2014.csv,2014,0.0,1.0
24334,The Staggering Girl,11032,0,11032,2019.csv,2019,0.0,1.0
24335,Magical Girl 2016 Re-release,11026,0,11026,2016.csv,2016,0.0,1.0
24336,The Woman with the 5 Elephants 2011 Re-release,11026,11026,0,2011.csv,2011,1.0,0.0
24337,Little Forest 2018 Re-release,11024,0,11024,2018.csv,2018,0.0,1.0
24338,"Jelena, Katarina, Marija",11023,0,11023,2012.csv,2012,0.0,1.0
24339,PAY 2 PLAY: Democracy's High Stakes,11021,11021,0,2014.csv,2014,1.0,0.0
24340,Little Tailor,11018,0,11018,2010.csv,2010,0.0,1.0
24341,The Ploy 2017 Re-release,11016,0,11016,2017.csv,2017,0.0,1.0
24342,Çift'lik Bank: Tosun Firarda,11011,0,11011,2018.csv,2018,0.0,1.0
24343,Hara Hara Mahadevaki,11009,0,11009,2017.csv,2017,0.0,1.0
24344,Midget Zombie Takeover,11006,11006,0,2013.csv,2013,1.0,0.0
24345,Christina,11000,11000,0,2010.csv,2010,1.0,0.0
24346,Suburban Birds,10997,10997,0,2019.csv,2019,1.0,0.0
24347,The Propaganda Game,10991,0,10991,2015.csv,2015,0.0,1.0
24348,16 Bars,10985,10985,0,2019.csv,2019,1.0,0.0
24349,Drowning Echo,10982,0,10982,2019.csv,2019,0.0,1.0
24350,Blade of the Law,10981,0,10981,2018.csv,2018,0.0,1.0
24351,One Man and His Shoes,10977,0,10977,2020.csv,2020,0.0,1.0
24352,Just Before I Go,10970,10970,0,2015.csv,2015,1.0,0.0
24353,Digging Up the Marrow,10969,10969,0,2015.csv,2015,1.0,0.0
24354,Very Good Girls,10963,6940,4023,2014.csv,2014,0.6330384018972909,0.3669615981027091
24355,The Silence of the Lambs 2017 Re-release,10962,0,10962,2017.csv,2017,0.0,1.0
24356,Wreckers,10962,0,10962,2011.csv,2011,0.0,1.0
24357,Wallander: Hämnden 2012 Re-release,10960,10960,0,2012.csv,2012,1.0,0.0
24358,The Butcher Possessions,10955,0,10955,2015.csv,2015,0.0,1.0
24359,"Everton, Howard's Way",10951,0,10951,2019.csv,2019,0.0,1.0
24360,The Lavender Hill Mob,10945,0,10945,2011.csv,2011,0.0,1.0
24361,Hizli ve Tüplü,10941,0,10941,2017.csv,2017,0.0,1.0
24362,Words and Pictures 2017 Re-release,10937,0,10937,2017.csv,2017,0.0,1.0
24363,Never Said Goodbye,10935,0,10935,2017.csv,2017,0.0,1.0
24364,Sarah Palin: You Betcha!,10935,10935,0,2011.csv,2011,1.0,0.0
24365,Kral Midas'in Hazinesi,10934,0,10934,2019.csv,2019,0.0,1.0
24366,47 Meters Down 2020 Re-release,10932,0,10932,2020.csv,2020,0.0,1.0
24367,Blood Quantum,10926,0,10926,2020.csv,2020,0.0,1.0
24368,Colors of Wind,10925,0,10925,2018.csv,2018,0.0,1.0
24369,Taste of Cherry,10923,0,10923,2017.csv,2017,0.0,1.0
24370,"La defensa, por la libertad",10916,0,10916,2019.csv,2019,0.0,1.0
24371,Gulabjaam,10915,0,10915,2018.csv,2018,0.0,1.0
24372,If the Dancer Dances,10912,10912,0,2019.csv,2019,1.0,0.0
24373,DNA,10911,0,10911,2020.csv,2020,0.0,1.0
24374,Playoff,10905,0,10905,2012.csv,2012,0.0,1.0
24375,Skjærgården,10895,0,10895,2016.csv,2016,0.0,1.0
24376,Bhai Taru Singh,10893,0,10893,2018.csv,2018,0.0,1.0
24377,Underground Snatch,10890,0,10890,2018.csv,2018,0.0,1.0
24378,Dolphin Tale 2014 Re-release,10888,0,10888,2014.csv,2014,0.0,1.0
24379,Gruffalo si orietenii lui,10888,0,10888,2016.csv,2016,0.0,1.0
24380,When Day Breaks 2014 Re-release,10883,0,10883,2014.csv,2014,0.0,1.0
24381,The Gateway,10878,0,10878,2018.csv,2018,0.0,1.0
24382,Jarugandi,10877,0,10877,2018.csv,2018,0.0,1.0
24383,Finding Gaston,10875,0,10875,2014.csv,2014,0.0,1.0
24384,Kung Fu Yoga 2020 Re-release,10873,0,10873,2020.csv,2020,0.0,1.0
24385,The Arrival of Wang,10870,0,10870,2012.csv,2012,0.0,1.0
24386,"Rosi, Kurt und Koni",10869,0,10869,2015.csv,2015,0.0,1.0
24387,Heartbeats,10866,0,10866,2020.csv,2020,0.0,1.0
24388,The Crossbreed,10864,0,10864,2018.csv,2018,0.0,1.0
24389,Super Margin,10859,0,10859,2019.csv,2019,0.0,1.0
24390,WEAPONiZED,10857,0,10857,2017.csv,2017,0.0,1.0
24391,Coborâm la prima,10852,0,10852,2018.csv,2018,0.0,1.0
24392,Mumbai Love,10852,0,10852,2014.csv,2014,0.0,1.0
24393,Blue Bicycle,10850,0,10850,2016.csv,2016,0.0,1.0
24394,As It Is in Heaven,10850,10850,0,2014.csv,2014,1.0,0.0
24395,Brain on Fire,10846,0,10846,2017.csv,2017,0.0,1.0
24396,What Happened Last Night,10844,10844,0,2016.csv,2016,1.0,0.0
24397,Lucifer,10829,0,10829,2016.csv,2016,0.0,1.0
24398,Maligno,10826,0,10826,2016.csv,2016,0.0,1.0
24399,The Forecaster,10824,10172,652,2015.csv,2015,0.9397634885439764,0.06023651145602365
24400,Bleeding Heart,10815,0,10815,2015.csv,2015,0.0,1.0
24401,The Day After Valentine's,10815,0,10815,2018.csv,2018,0.0,1.0
24402,About Hope,10814,10814,0,2021.csv,2021,1.0,0.0
24403,The Receptionist,10814,0,10814,2018.csv,2018,0.0,1.0
24404,The Swedish Moment,10810,0,10810,2014.csv,2014,0.0,1.0
24405,Santificar lo profano,10808,0,10808,2017.csv,2017,0.0,1.0
24406,Interstellar 2019 Re-release,10803,0,10803,2019.csv,2019,0.0,1.0
24407,A Regular Woman,10786,0,10786,2019.csv,2019,0.0,1.0
24408,Silent Heart 2016 Re-release,10784,0,10784,2016.csv,2016,0.0,1.0
24409,The Trouble with Terkel 2010 Re-release,10783,10783,0,2010.csv,2010,1.0,0.0
24410,The Man Who Shook the Hand of Vicente Fernandez,10782,10782,0,2012.csv,2012,1.0,0.0
24411,Forgotten,10774,0,10774,2012.csv,2012,0.0,1.0
24412,Men Don't Cry,10774,0,10774,2018.csv,2018,0.0,1.0
24413,Labor Pains 2012 Re-release,10771,0,10771,2012.csv,2012,0.0,1.0
24414,Vision Portraits,10771,10771,0,2019.csv,2019,1.0,0.0
24415,Pecados,10770,0,10770,2012.csv,2012,0.0,1.0
24416,Mala Mala,10761,10761,0,2015.csv,2015,1.0,0.0
24417,Cau Chu Ma Ca Rong,10759,0,10759,2019.csv,2019,0.0,1.0
24418,Ayla: The Daughter of War 2019 Re-release,10752,0,10752,2019.csv,2019,0.0,1.0
24419,Laus,10748,0,10748,2014.csv,2014,0.0,1.0
24420,Paulo Moura: Alma Brasileira,10747,0,10747,2013.csv,2013,0.0,1.0
24421,Fuck for Forest,10739,0,10739,2013.csv,2013,0.0,1.0
24422,A Resurrection,10730,10730,0,2013.csv,2013,1.0,0.0
24423,Elfie Hopkins: Cannibal Hunter,10726,0,10726,2012.csv,2012,0.0,1.0
24424,O Labirinto da Saudade,10726,0,10726,2018.csv,2018,0.0,1.0
24425,Float Like a Butterfly,10721,0,10721,2019.csv,2019,0.0,1.0
24426,My Homeland Tales,10719,0,10719,2018.csv,2018,0.0,1.0
24427,Víctimas de Tangalanga,10712,0,10712,2016.csv,2016,0.0,1.0
24428,Other Angels,10709,0,10709,2010.csv,2010,0.0,1.0
24429,Patagonia,10708,0,10708,2011.csv,2011,0.0,1.0
24430,Nerven Bruch Zusammen,10706,0,10706,2013.csv,2013,0.0,1.0
24431,The Hunter,10705,0,10705,2011.csv,2011,0.0,1.0
24432,Mate,10701,0,10701,2019.csv,2019,0.0,1.0
24433,Management 2013 Re-release,10698,0,10698,2013.csv,2013,0.0,1.0
24434,Traders,10696,0,10696,2016.csv,2016,0.0,1.0
24435,Hollow in the Land,10688,0,10688,2017.csv,2017,0.0,1.0
24436,You Go to My Head,10682,10682,0,2020.csv,2020,1.0,0.0
24437,Made in Cleveland,10681,10681,0,2013.csv,2013,1.0,0.0
24438,Outbound,10678,0,10678,2011.csv,2011,0.0,1.0
24439,"Me, Myself & Her 2017 Re-release",10676,0,10676,2017.csv,2017,0.0,1.0
24440,Dead Man Tells His Own Tale,10671,0,10671,2016.csv,2016,0.0,1.0
24441,Frankie & Alice,10670,10670,0,2010.csv,2010,1.0,0.0
24442,A Childhood,10667,0,10667,2015.csv,2015,0.0,1.0
24443,Angel & Tony 2014 Re-release,10663,0,10663,2014.csv,2014,0.0,1.0
24444,National Bird,10656,10656,0,2016.csv,2016,1.0,0.0
24445,The Island of Cats,10651,0,10651,2020.csv,2020,0.0,1.0
24446,American Meat,10650,10650,0,2013.csv,2013,1.0,0.0
24447,Caucus,10645,10645,0,2013.csv,2013,1.0,0.0
24448,(A)social: 10 giorni senza lo smartphone,10642,0,10642,2019.csv,2019,0.0,1.0
24449,Oxygen,10640,0,10640,2017.csv,2017,0.0,1.0
24450,The Murder of Nicole Brown Simpson 2021 Re-release,10638,0,10638,2021.csv,2021,0.0,1.0
24451,Illary,10631,0,10631,2010.csv,2010,0.0,1.0
24452,The Secret of Carlos Castaneda,10626,0,10626,2019.csv,2019,0.0,1.0
24453,Lovesong,10626,10626,0,2017.csv,2017,1.0,0.0
24454,Teri Meri Jodi,10625,0,10625,2019.csv,2019,0.0,1.0
24455,Nenjamundu Nermaiyundu Odu Raja,10611,0,10611,2019.csv,2019,0.0,1.0
24456,Love You,10608,0,10608,2019.csv,2019,0.0,1.0
24457,Intuitions,10606,10606,0,2019.csv,2019,1.0,0.0
24458,The Reconstruction 2015 Re-release,10605,0,10605,2015.csv,2015,0.0,1.0
24459,¿Que Puede Pasar?,10602,0,10602,2018.csv,2018,0.0,1.0
24460,La mujer de los siete nombres,10601,0,10601,2018.csv,2018,0.0,1.0
24461,The Fourth Kind 2013 Re-release,10601,0,10601,2013.csv,2013,0.0,1.0
24462,Inside the Mind of Leonardo,10600,10600,0,2014.csv,2014,1.0,0.0
24463,Marriage Italian Style 2011 Re-release,10600,10600,0,2011.csv,2011,1.0,0.0
24464,Anando Brahma,10588,0,10588,2017.csv,2017,0.0,1.0
24465,Transylmania 2011 Re-release,10588,0,10588,2011.csv,2011,0.0,1.0
24466,Darling,10585,0,10585,2017.csv,2017,0.0,1.0
24467,O Céu Sobre os Ombros,10583,0,10583,2011.csv,2011,0.0,1.0
24468,Monk,10580,0,10580,2017.csv,2017,0.0,1.0
24469,Ahswiram,10579,0,10579,2010.csv,2010,0.0,1.0
24470,Dragoi ehiztaria,10578,0,10578,2012.csv,2012,0.0,1.0
24471,Men Vs Women 2012 Re-release,10576,0,10576,2012.csv,2012,0.0,1.0
24472,Hepta: The Last Lecture,10574,0,10574,2016.csv,2016,0.0,1.0
24473,Big Blue Lake,10566,0,10566,2011.csv,2011,0.0,1.0
24474,Vidas Partidas,10562,0,10562,2016.csv,2016,0.0,1.0
24475,Life in Four Elements,10557,0,10557,2017.csv,2017,0.0,1.0
24476,Blind 2014 Re-release,10551,0,10551,2014.csv,2014,0.0,1.0
24477,China Heavyweight,10550,10550,0,2012.csv,2012,1.0,0.0
24478,The Other Side,10537,0,10537,2020.csv,2020,0.0,1.0
24479,Robot Riot,10532,0,10532,2020.csv,2020,0.0,1.0
24480,The Iron Hole,10529,0,10529,2011.csv,2011,0.0,1.0
24481,Deep In My Heart,10526,0,10526,2017.csv,2017,0.0,1.0
24482,I'll Take Your Dead,10523,10523,0,2019.csv,2019,1.0,0.0
24483,Sleepless Nights,10517,0,10517,2013.csv,2013,0.0,1.0
24484,Arise,10515,0,10515,2018.csv,2018,0.0,1.0
24485,End of Winter,10509,0,10509,2016.csv,2016,0.0,1.0
24486,Mecánica Popular,10508,0,10508,2016.csv,2016,0.0,1.0
24487,Still the Enemy Within,10507,0,10507,2014.csv,2014,0.0,1.0
24488,Waiting for Armageddon,10501,10501,0,2010.csv,2010,1.0,0.0
24489,Clarence,10495,10495,0,2017.csv,2017,1.0,0.0
24490,Interlude in Prague 2018 Re-release,10490,0,10490,2018.csv,2018,0.0,1.0
24491,Santa Mesa,10490,10490,0,2012.csv,2012,1.0,0.0
24492,Castle in the Sky 2016 Re-release,10488,0,10488,2016.csv,2016,0.0,1.0
24493,Neon Flesh 2012 Re-release,10483,0,10483,2012.csv,2012,0.0,1.0
24494,Zanket Satat,10469,0,10469,2015.csv,2015,0.0,1.0
24495,Prince Orient House,10465,0,10465,2016.csv,2016,0.0,1.0
24496,Blood Bound,10463,0,10463,2019.csv,2019,0.0,1.0
24497,"Norte, the End of History",10457,10457,0,2014.csv,2014,1.0,0.0
24498,Nakhodka,10456,0,10456,2015.csv,2015,0.0,1.0
24499,The Fear,10454,0,10454,2013.csv,2013,0.0,1.0
24500,Evil Intent,10454,10454,0,2013.csv,2013,1.0,0.0
24501,Boy Meets Girl,10452,0,10452,2014.csv,2014,0.0,1.0
24502,Class Rank,10452,10452,0,2018.csv,2018,1.0,0.0
24503,The Lady Assassin 2015 Re-release,10432,0,10432,2015.csv,2015,0.0,1.0
24504,Mama Africa 2018 Re-release,10430,10430,0,2018.csv,2018,1.0,0.0
24505,Within,10424,0,10424,2017.csv,2017,0.0,1.0
24506,Badur Hogar,10421,0,10421,2019.csv,2019,0.0,1.0
24507,Chicken,10412,0,10412,2015.csv,2015,0.0,1.0
24508,The Advocates,10402,10402,0,2018.csv,2018,1.0,0.0
24509,Shanghai Calling,10400,10400,0,2013.csv,2013,1.0,0.0
24510,Peppa Pig: My First Cinema Experience 2020 Re-release,10400,0,10400,2020.csv,2020,0.0,1.0
24511,Ondine 2012 Re-release,10394,0,10394,2012.csv,2012,0.0,1.0
24512,El agua del fin del mundo,10393,0,10393,2011.csv,2011,0.0,1.0
24513,The Knight and the Princess,10386,0,10386,2020.csv,2020,0.0,1.0
24514,Saina,10377,0,10377,2021.csv,2021,0.0,1.0
24515,La mujer de tu prójimo,10377,0,10377,2016.csv,2016,0.0,1.0
24516,Natpe Thunai,10374,0,10374,2019.csv,2019,0.0,1.0
24517,Polisse 2014 Re-release,10373,0,10373,2014.csv,2014,0.0,1.0
24518,Perros,10371,0,10371,2017.csv,2017,0.0,1.0
24519,There'll Always Be an England,10365,0,10365,2018.csv,2018,0.0,1.0
24520,Everyday Is a Holiday,10360,0,10360,2010.csv,2010,0.0,1.0
24521,Adventures on the Red Plane,10360,0,10360,2016.csv,2016,0.0,1.0
24522,Elemental,10358,10358,0,2013.csv,2013,1.0,0.0
24523,Zero Bridge,10357,10357,0,2011.csv,2011,1.0,0.0
24524,Nevidimki,10352,0,10352,2015.csv,2015,0.0,1.0
24525,Forget Me Not,10345,0,10345,2011.csv,2011,0.0,1.0
24526,The Man on the Island,10342,0,10342,2020.csv,2020,0.0,1.0
24527,Wake Wood,10342,0,10342,2011.csv,2011,0.0,1.0
24528,Mahalle,10337,0,10337,2018.csv,2018,0.0,1.0
24529,SK1 2016 Re-release,10330,10330,0,2016.csv,2016,1.0,0.0
24530,Tokoloshe: An African Curse,10325,0,10325,2018.csv,2018,0.0,1.0
24531,The Third Party,10323,0,10323,2016.csv,2016,0.0,1.0
24532,Soleada,10322,0,10322,2016.csv,2016,0.0,1.0
24533,Are You Proud?,10312,0,10312,2019.csv,2019,0.0,1.0
24534,Stepinac: Kardinal I Njegova Savjest,10306,0,10306,2020.csv,2020,0.0,1.0
24535,The Host,10305,0,10305,2021.csv,2021,0.0,1.0
24536,Bong Srolanh Oun,10299,0,10299,2015.csv,2015,0.0,1.0
24537,Painted Woman,10298,10298,0,2017.csv,2017,1.0,0.0
24538,The Kid 2019 Re-release,10292,0,10292,2019.csv,2019,0.0,1.0
24539,Manithan,10285,0,10285,2016.csv,2016,0.0,1.0
24540,Cuidadores,10283,0,10283,2011.csv,2011,0.0,1.0
24541,Path Of The Soul,10278,0,10278,2017.csv,2017,0.0,1.0
24542,Shepard & Dark,10278,10278,0,2013.csv,2013,1.0,0.0
24543,Wildland,10263,0,10263,2020.csv,2020,0.0,1.0
24544,Radiogram,10262,0,10262,2018.csv,2018,0.0,1.0
24545,Moebius,10254,2340,7914,2014.csv,2014,0.22820362785254536,0.7717963721474547
24546,Shalom Taiwan,10254,0,10254,2019.csv,2019,0.0,1.0
24547,Song of My Mother,10254,0,10254,2014.csv,2014,0.0,1.0
24548,As God Commands 2010 Re-release,10253,0,10253,2010.csv,2010,0.0,1.0
24549,Mere Pyare Prime Minister,10248,0,10248,2019.csv,2019,0.0,1.0
24550,Mary Queen of Scots,10237,0,10237,2014.csv,2014,0.0,1.0
24551,Coded Bias,10236,10236,0,2020.csv,2020,1.0,0.0
24552,Amelia 2.0,10233,10233,0,2017.csv,2017,1.0,0.0
24553,The Endless Summer,10233,10233,0,2014.csv,2014,1.0,0.0
24554,Approaching the Unknown,10232,10232,0,2016.csv,2016,1.0,0.0
24555,Android Kunjappan Ver 5.25,10230,0,10230,2019.csv,2019,0.0,1.0
24556,Ne chuzhie,10227,0,10227,2018.csv,2018,0.0,1.0
24557,Cialo 2016 Re-release,10227,0,10227,2016.csv,2016,0.0,1.0
24558,Me & My Left Brain,10227,0,10227,2019.csv,2019,0.0,1.0
24559,The Lion Kid,10225,0,10225,2019.csv,2019,0.0,1.0
24560,Starry Eyes,10220,0,10220,2015.csv,2015,0.0,1.0
24561,¿De qué va la vida?,10220,0,10220,2013.csv,2013,0.0,1.0
24562,Tales from the Lakeside,10209,0,10209,2017.csv,2017,0.0,1.0
24563,Laatu,10208,0,10208,2018.csv,2018,0.0,1.0
24564,F for Fake,10206,0,10206,2012.csv,2012,0.0,1.0
24565,Elf on the Run,10205,0,10205,2017.csv,2017,0.0,1.0
24566,Tip Top,10201,6050,4151,2013.csv,2013,0.5930791098911872,0.4069208901088129
24567,When Lambs Become Lions,10197,9337,860,2019.csv,2019,0.9156614690595273,0.0843385309404727
24568,King George VI: The Man Behind the King's Speech,10194,0,10194,2011.csv,2011,0.0,1.0
24569,Prince of the Himalayas,10190,10190,0,2011.csv,2011,1.0,0.0
24570,Miss Minoes 2011 Re-release,10189,10189,0,2011.csv,2011,1.0,0.0
24571,Turn It Up to 11,10187,0,10187,2010.csv,2010,0.0,1.0
24572,Enemies,10184,0,10184,2018.csv,2018,0.0,1.0
24573,Valek,10166,0,10166,2018.csv,2018,0.0,1.0
24574,Bezdelniki,10160,0,10160,2011.csv,2011,0.0,1.0
24575,The Reasons of the Heart 2013 Re-release,10152,0,10152,2013.csv,2013,0.0,1.0
24576,A Bird of the Air,10152,10152,0,2011.csv,2011,1.0,0.0
24577,The Taste from Happy Island,10150,0,10150,2019.csv,2019,0.0,1.0
24578,Closing the Ring 2010 Re-release,10149,0,10149,2010.csv,2010,0.0,1.0
24579,Bunker of the Dead,10147,0,10147,2016.csv,2016,0.0,1.0
24580,Scenes from a Marriage,10146,0,10146,2017.csv,2017,0.0,1.0
24581,A Wakefield Project,10145,0,10145,2020.csv,2020,0.0,1.0
24582,Lawrence of Arabia 2011 Re-release,10143,0,10143,2011.csv,2011,0.0,1.0
24583,Mildred Pierce,10128,0,10128,2018.csv,2018,0.0,1.0
24584,Guerilla,10123,0,10123,2019.csv,2019,0.0,1.0
24585,Maalik,10121,0,10121,2016.csv,2016,0.0,1.0
24586,Aus dem Nichts,10117,0,10117,2016.csv,2016,0.0,1.0
24587,August Winds,10114,0,10114,2015.csv,2015,0.0,1.0
24588,Mammal,10107,0,10107,2016.csv,2016,0.0,1.0
24589,Beta Test,10104,10104,0,2016.csv,2016,1.0,0.0
24590,All Hands on Deck,10103,0,10103,2021.csv,2021,0.0,1.0
24591,Recon,10086,0,10086,2020.csv,2020,0.0,1.0
24592,Tornare,10084,0,10084,2020.csv,2020,0.0,1.0
24593,Putin's Kiss,10082,10082,0,2012.csv,2012,1.0,0.0
24594,National Theatre Live: The Kitchen,10082,0,10082,2011.csv,2011,0.0,1.0
24595,Self-Criticism of a Bourgeois Dog,10081,0,10081,2017.csv,2017,0.0,1.0
24596,Pawn Shop Chronicles,10080,8088,1992,2013.csv,2013,0.8023809523809524,0.1976190476190476
24597,Before I Disappear,10078,10078,0,2014.csv,2014,1.0,0.0
24598,Little Accidents,10071,10071,0,2015.csv,2015,1.0,0.0
24599,"Thelma, Louise et Chantal 2012 Re-release",10069,0,10069,2012.csv,2012,0.0,1.0
24600,Informant,10068,10068,0,2013.csv,2013,1.0,0.0
24601,Mohini,10066,0,10066,2018.csv,2018,0.0,1.0
24602,Murder in the Woods,10065,0,10065,2020.csv,2020,0.0,1.0
24603,Jil Jung Juk,10064,0,10064,2016.csv,2016,0.0,1.0
24604,Rumbo al Mar,10064,0,10064,2020.csv,2020,0.0,1.0
24605,The Kid,10062,0,10062,2010.csv,2010,0.0,1.0
24606,What You Don't See,10056,0,10056,2011.csv,2011,0.0,1.0
24607,We Are Never Alone,10052,0,10052,2016.csv,2016,0.0,1.0
24608,The Sunshine Makers,10042,10042,0,2017.csv,2017,1.0,0.0
24609,Adim Adim,10035,0,10035,2016.csv,2016,0.0,1.0
24610,Kalavaadiya Pozhuthugal,10031,0,10031,2017.csv,2017,0.0,1.0
24611,Blindado,10029,0,10029,2019.csv,2019,0.0,1.0
24612,Circle,10024,10024,0,2010.csv,2010,1.0,0.0
24613,The Life and Mind of Mark DeFriest,10021,10021,0,2015.csv,2015,1.0,0.0
24614,Arjun: The Warrior Prince,10017,10017,0,2012.csv,2012,1.0,0.0
24615,Guest Artist,10017,10017,0,2020.csv,2020,1.0,0.0
24616,Drugs 2,10013,0,10013,2011.csv,2011,0.0,1.0
24617,El francesito. Un documental (im)posible sobre Enrique Pichón-Riviere,10010,0,10010,2016.csv,2016,0.0,1.0
24618,A Korean in Paris,10006,0,10006,2016.csv,2016,0.0,1.0
24619,The Princess of Egypt,10005,0,10005,2013.csv,2013,0.0,1.0
24620,Iki Gözüm Ahmet,10004,0,10004,2020.csv,2020,0.0,1.0
24621,The Do-Deca-Pentathlon,10000,10000,0,2012.csv,2012,1.0,0.0
24622,"Hugh Hefner: Playboy, Activist and Rebel",10000,10000,0,2010.csv,2010,1.0,0.0
24623,The Happiest Girl in the World,9998,0,9998,2011.csv,2011,0.0,1.0
24624,Second Life,9997,0,9997,2019.csv,2019,0.0,1.0
24625,Pinoy Sunday,9996,0,9996,2011.csv,2011,0.0,1.0
24626,Tere Bin Laden: Dead Or Alive,9995,0,9995,2016.csv,2016,0.0,1.0
24627,Epifanía,9987,0,9987,2017.csv,2017,0.0,1.0
24628,Blackwood,9985,0,9985,2014.csv,2014,0.0,1.0
24629,Winter,9984,0,9984,2020.csv,2020,0.0,1.0
24630,Ignasi M.,9980,0,9980,2014.csv,2014,0.0,1.0
24631,The Lift Boy,9968,0,9968,2019.csv,2019,0.0,1.0
24632,Das Schreiben und das Schweigen. Die Schriftstellerin Friederike Mayröcker,9968,0,9968,2010.csv,2010,0.0,1.0
24633,Foosballers,9966,9966,0,2020.csv,2020,1.0,0.0
24634,The Young Cannibals,9963,0,9963,2020.csv,2020,0.0,1.0
24635,Andílek na nervy,9958,0,9958,2015.csv,2015,0.0,1.0
24636,Chha Maya Chhapakkai,9956,0,9956,2019.csv,2019,0.0,1.0
24637,Goldstone 2019 Re-release,9956,0,9956,2019.csv,2019,0.0,1.0
24638,Made in France,9956,9956,0,2016.csv,2016,1.0,0.0
24639,North by Northwest 2017 Re-release,9950,0,9950,2017.csv,2017,0.0,1.0
24640,Sammohanam,9945,0,9945,2018.csv,2018,0.0,1.0
24641,I Am Nasrine,9937,0,9937,2013.csv,2013,0.0,1.0
24642,Olivia,9934,9934,0,2019.csv,2019,1.0,0.0
24643,Gibby,9930,0,9930,2016.csv,2016,0.0,1.0
24644,Havenhurst 2018 Re-release,9927,0,9927,2018.csv,2018,0.0,1.0
24645,A Dark Song,9919,0,9919,2017.csv,2017,0.0,1.0
24646,Shoot,9917,0,9917,2018.csv,2018,0.0,1.0
24647,Eva + Candela,9912,0,9912,2018.csv,2018,0.0,1.0
24648,Escuchando al juez Garzón,9911,0,9911,2011.csv,2011,0.0,1.0
24649,Streetwise,9904,9904,0,2019.csv,2019,1.0,0.0
24650,Saithan,9890,0,9890,2016.csv,2016,0.0,1.0
24651,La misura del confine,9887,0,9887,2011.csv,2011,0.0,1.0
24652,Mappillai,9873,0,9873,2011.csv,2011,0.0,1.0
24653,Eternal Love,9869,0,9869,2017.csv,2017,0.0,1.0
24654,Wild Horses,9867,0,9867,2016.csv,2016,0.0,1.0
24655,God's Pocket 2016 Re-release,9854,0,9854,2016.csv,2016,0.0,1.0
24656,Dooman River,9850,0,9850,2011.csv,2011,0.0,1.0
24657,The Greenstone,9848,0,9848,2016.csv,2016,0.0,1.0
24658,52 Tuesdays,9844,0,9844,2015.csv,2015,0.0,1.0
24659,Hjarstastein,9844,0,9844,2017.csv,2017,0.0,1.0
24660,The Man Who Will Come 2011 Re-release,9838,0,9838,2011.csv,2011,0.0,1.0
24661,The Taverna,9835,0,9835,2020.csv,2020,0.0,1.0
24662,Solnechnyy udar,9834,0,9834,2015.csv,2015,0.0,1.0
24663,A Trip to Jamaica,9833,0,9833,2016.csv,2016,0.0,1.0
24664,Hill of Pleasures,9830,0,9830,2013.csv,2013,0.0,1.0
24665,Bamse and the Thief City 2020 Re-release,9827,0,9827,2020.csv,2020,0.0,1.0
24666,Black Ocean,9822,0,9822,2010.csv,2010,0.0,1.0
24667,Cesta za Vianoènou hviezdou,9821,0,9821,2013.csv,2013,0.0,1.0
24668,25 Kille,9817,0,9817,2016.csv,2016,0.0,1.0
24669,Kabbalah Me,9816,9816,0,2014.csv,2014,1.0,0.0
24670,Mar Jawan Gur Khake,9815,0,9815,2010.csv,2010,0.0,1.0
24671,Other Girls,9813,0,9813,2015.csv,2015,0.0,1.0
24672,Down Terrace,9812,9812,0,2010.csv,2010,1.0,0.0
24673,Birth of the Living Dead,9802,9802,0,2013.csv,2013,1.0,0.0
24674,Outlaws and Angels,9798,0,9798,2017.csv,2017,0.0,1.0
24675,Aleksi,9791,0,9791,2018.csv,2018,0.0,1.0
24676,Forbidden Zone,9780,0,9780,2017.csv,2017,0.0,1.0
24677,Anandi Gopal,9774,0,9774,2019.csv,2019,0.0,1.0
24678,Half-Way,9773,0,9773,2010.csv,2010,0.0,1.0
24679,In the Fog,9772,0,9772,2017.csv,2017,0.0,1.0
24680,The Reef 2012 Re-release,9767,0,9767,2012.csv,2012,0.0,1.0
24681,Swinger,9765,0,9765,2017.csv,2017,0.0,1.0
24682,Schulden G.m.b.H.,9761,0,9761,2013.csv,2013,0.0,1.0
24683,The Pencil,9760,0,9760,2019.csv,2019,0.0,1.0
24684,Dear Dictator,9759,0,9759,2018.csv,2018,0.0,1.0
24685,Pelle the Conqueror 2017 Re-release,9757,9757,0,2017.csv,2017,1.0,0.0
24686,Brochevarevarura,9737,0,9737,2019.csv,2019,0.0,1.0
24687,Possessed,9736,0,9736,2015.csv,2015,0.0,1.0
24688,Ramprasad Ki Tehrvi,9727,0,9727,2021.csv,2021,0.0,1.0
24689,Rendez-vous avec un ange,9724,0,9724,2011.csv,2011,0.0,1.0
24690,"If You Don't, I Will",9719,9719,0,2014.csv,2014,1.0,0.0
24691,Vi,9717,0,9717,2013.csv,2013,0.0,1.0
24692,Ultima Jugada,9714,0,9714,2011.csv,2011,0.0,1.0
24693,Ed è subito sera,9711,0,9711,2019.csv,2019,0.0,1.0
24694,With the Lips Closed,9710,0,9710,2017.csv,2017,0.0,1.0
24695,Antoine & Antoinette,9704,9704,0,2013.csv,2013,1.0,0.0
24696,Off the Road,9698,0,9698,2018.csv,2018,0.0,1.0
24697,Bednye lyudi. Kabakovy,9697,0,9697,2018.csv,2018,0.0,1.0
24698,Nefrin,9694,0,9694,2017.csv,2017,0.0,1.0
24699,Into the Ashes,9687,0,9687,2019.csv,2019,0.0,1.0
24700,Godovshchina revolyutsii,9685,0,9685,2019.csv,2019,0.0,1.0
24701,Lai Dahile,9685,0,9685,2017.csv,2017,0.0,1.0
24702,"¡Bruja, más que bruja!",9681,0,9681,2016.csv,2016,0.0,1.0
24703,Brutal Beauty: Tales of the Rose City Rollers,9677,9677,0,2010.csv,2010,1.0,0.0
24704,Odnazhdy v Amerike ili chisto russkaya skazka,9672,0,9672,2019.csv,2019,0.0,1.0
24705,The Fixer,9669,0,9669,2017.csv,2017,0.0,1.0
24706,The Idea of a Lake,9669,0,9669,2017.csv,2017,0.0,1.0
24707,Jimmy Ee Veedinte Aiswaryam,9663,0,9663,2019.csv,2019,0.0,1.0
24708,Vidar the Vampire,9649,0,9649,2018.csv,2018,0.0,1.0
24709,La isla del viento,9647,0,9647,2016.csv,2016,0.0,1.0
24710,Al Desierto,9644,0,9644,2017.csv,2017,0.0,1.0
24711,9 to 5 2018 Re-release,9643,0,9643,2018.csv,2018,0.0,1.0
24712,Sifir: Etkisiz Eleman,9643,0,9643,2019.csv,2019,0.0,1.0
24713,Koko-di Koko-da,9640,0,9640,2019.csv,2019,0.0,1.0
24714,The Trace,9638,0,9638,2011.csv,2011,0.0,1.0
24715,The Quest of Alain Ducasse,9627,9627,0,2018.csv,2018,1.0,0.0
24716,Effetto paradosso,9622,0,9622,2012.csv,2012,0.0,1.0
24717,Arraianos,9619,0,9619,2013.csv,2013,0.0,1.0
24718,The Belly of the Whale,9613,0,9613,2018.csv,2018,0.0,1.0
24719,Unrest 2017 Re-release,9607,0,9607,2017.csv,2017,0.0,1.0
24720,Tito's Glasses,9598,0,9598,2015.csv,2015,0.0,1.0
24721,The Past of Huanghuatang,9596,0,9596,2019.csv,2019,0.0,1.0
24722,Walachai,9591,0,9591,2013.csv,2013,0.0,1.0
24723,The Spanish Prisoner 2019 Re-release,9589,9589,0,2019.csv,2019,1.0,0.0
24724,The End of the Season,9589,0,9589,2019.csv,2019,0.0,1.0
24725,Els oblidats dels oblidats,9587,0,9587,2011.csv,2011,0.0,1.0
24726,Cat Funeral,9571,0,9571,2015.csv,2015,0.0,1.0
24727,Vito Bonafacci,9570,9570,0,2011.csv,2011,1.0,0.0
24728,Freedom Fields,9567,0,9567,2019.csv,2019,0.0,1.0
24729,A Idiot Lost in Xiangxi,9565,0,9565,2017.csv,2017,0.0,1.0
24730,Ivan Veramaathiri,9562,0,9562,2013.csv,2013,0.0,1.0
24731,Power Cut,9560,0,9560,2012.csv,2012,0.0,1.0
24732,Ond tro,9560,0,9560,2010.csv,2010,0.0,1.0
24733,The Reluctant Fundamentalist 2015 Re-release,9556,0,9556,2015.csv,2015,0.0,1.0
24734,To My River,9549,0,9549,2019.csv,2019,0.0,1.0
24735,Green Horse Rustlers,9542,0,9542,2016.csv,2016,0.0,1.0
24736,Chosen,9536,9283,253,2016.csv,2016,0.9734689597315436,0.026531040268456377
24737,A Useful Life,9536,0,9536,2010.csv,2010,0.0,1.0
24738,Orizont,9533,0,9533,2016.csv,2016,0.0,1.0
24739,The Lost Arcade,9522,9522,0,2016.csv,2016,1.0,0.0
24740,Wagner's Dream,9519,0,9519,2012.csv,2012,0.0,1.0
24741,Strangers on the Earth,9518,9518,0,2018.csv,2018,1.0,0.0
24742,Living Proof,9512,9512,0,2017.csv,2017,1.0,0.0
24743,The Message,9510,0,9510,2018.csv,2018,0.0,1.0
24744,L'Atalante,9505,0,9505,2012.csv,2012,0.0,1.0
24745,Vad Balaton,9489,0,9489,2018.csv,2018,0.0,1.0
24746,Misono Universe,9488,0,9488,2016.csv,2016,0.0,1.0
24747,Change Lifestyle,9486,0,9486,2016.csv,2016,0.0,1.0
24748,Some Like It Hot 2012 Re-release,9483,0,9483,2012.csv,2012,0.0,1.0
24749,In the House of Flies,9480,9480,0,2014.csv,2014,1.0,0.0
24750,Temel ile Dursun Istanbul'da,9472,0,9472,2016.csv,2016,0.0,1.0
24751,London Unplugged,9470,0,9470,2019.csv,2019,0.0,1.0
24752,The Spiritualist,9465,0,9465,2018.csv,2018,0.0,1.0
24753,A Good Old Fashioned Orgy 2013 Re-release,9462,0,9462,2013.csv,2013,0.0,1.0
24754,Red Vacance Black Wedding,9460,0,9460,2012.csv,2012,0.0,1.0
24755,Kittu Gadu Unnadu,9458,0,9458,2017.csv,2017,0.0,1.0
24756,Northern Lights,9453,9453,0,2013.csv,2013,1.0,0.0
24757,The General,9453,0,9453,2010.csv,2010,0.0,1.0
24758,Yuddham Sharanam,9451,0,9451,2017.csv,2017,0.0,1.0
24759,Smiles of a Summer Night 2017 Re-release,9441,0,9441,2017.csv,2017,0.0,1.0
24760,The Judgment,9440,0,9440,2014.csv,2014,0.0,1.0
24761,Memories,9439,0,9439,2017.csv,2017,0.0,1.0
24762,Our Daily Bread 2010 Re-release,9432,0,9432,2010.csv,2010,0.0,1.0
24763,If I Were You,9432,9432,0,2013.csv,2013,1.0,0.0
24764,Marita,9425,0,9425,2017.csv,2017,0.0,1.0
24765,Üç Harflilerin Musallat Oldugu Büyülü Konakta Ruh Çagiran Gençlerin Hazin Hikayesi,9424,0,9424,2018.csv,2018,0.0,1.0
24766,Lo peor de los deseos,9420,0,9420,2018.csv,2018,0.0,1.0
24767,Uppercase Print,9417,0,9417,2020.csv,2020,0.0,1.0
24768,Zero Charisma,9417,9417,0,2013.csv,2013,1.0,0.0
24769,"One Cut, One Life",9406,9406,0,2015.csv,2015,1.0,0.0
24770,Ghost Walk,9405,0,9405,2019.csv,2019,0.0,1.0
24771,Princess Yang Kwei-fei,9398,0,9398,2017.csv,2017,0.0,1.0
24772,Irène 2010 Re-release,9398,0,9398,2010.csv,2010,0.0,1.0
24773,Locusts,9395,0,9395,2019.csv,2019,0.0,1.0
24774,Miss Kiet's Children 2017 Re-release,9384,9384,0,2017.csv,2017,1.0,0.0
24775,The Half,9384,0,9384,2016.csv,2016,0.0,1.0
24776,Finding Nemo 2020 Re-release,9384,0,9384,2020.csv,2020,0.0,1.0
24777,They Have Escaped,9383,0,9383,2014.csv,2014,0.0,1.0
24778,National Theatre Live: A View from the Bridge,9377,0,9377,2015.csv,2015,0.0,1.0
24779,Shubh Lagna Savdhan,9372,0,9372,2018.csv,2018,0.0,1.0
24780,Uni Brennt: Bildungsprotest 2.0,9372,0,9372,2010.csv,2010,0.0,1.0
24781,The Tree of Wooden Clogs,9367,0,9367,2016.csv,2016,0.0,1.0
24782,Radio Free Albemuth,9365,9365,0,2014.csv,2014,1.0,0.0
24783,Cookie,9365,0,9365,2020.csv,2020,0.0,1.0
24784,The Way Out,9354,0,9354,2016.csv,2016,0.0,1.0
24785,Close Encounters of the Third Kind 2016 Re-release,9352,0,9352,2016.csv,2016,0.0,1.0
24786,Snaaks Genoeg,9346,0,9346,2016.csv,2016,0.0,1.0
24787,Fritz Lang's Indian Epic 2019 re-release,9345,9345,0,2019.csv,2019,1.0,0.0
24788,The End of Love,9342,9342,0,2013.csv,2013,1.0,0.0
24789,Looking for Maria Sanchez,9338,9338,0,2013.csv,2013,1.0,0.0
24790,Carmilla,9333,0,9333,2020.csv,2020,0.0,1.0
24791,The Immortalists,9331,9331,0,2014.csv,2014,1.0,0.0
24792,Pink Subaru,9325,0,9325,2011.csv,2011,0.0,1.0
24793,The Beat of Love: Utrip Ljubezni,9325,0,9325,2015.csv,2015,0.0,1.0
24794,Better Mus' Come,9318,9318,0,2013.csv,2013,1.0,0.0
24795,The Day God Walked Away,9315,0,9315,2010.csv,2010,0.0,1.0
24796,A Story from Chikamatsu,9311,0,9311,2017.csv,2017,0.0,1.0
24797,Wonderful World,9309,9309,0,2010.csv,2010,1.0,0.0
24798,LoveTrue,9309,0,9309,2017.csv,2017,0.0,1.0
24799,Cervená,9308,0,9308,2017.csv,2017,0.0,1.0
24800,Aakashaganga II,9306,0,9306,2019.csv,2019,0.0,1.0
24801,Island of the Hungry Ghosts,9305,0,9305,2019.csv,2019,0.0,1.0
24802,Servus Ishq,9299,0,9299,2014.csv,2014,0.0,1.0
24803,Foodies: The Culinary Jet Set,9299,0,9299,2015.csv,2015,0.0,1.0
24804,Giovanni Segantini - Magic of Light,9295,0,9295,2015.csv,2015,0.0,1.0
24805,Brutal Box,9295,0,9295,2011.csv,2011,0.0,1.0
24806,Hide and Seek,9282,0,9282,2019.csv,2019,0.0,1.0
24807,Little King Macius 2016 Re-release,9274,0,9274,2016.csv,2016,0.0,1.0
24808,High Strung 2018 Re-release,9274,0,9274,2018.csv,2018,0.0,1.0
24809,Munda Faridkotia,9273,0,9273,2019.csv,2019,0.0,1.0
24810,Ispade Rajavum Idhaya Raniyum,9272,0,9272,2019.csv,2019,0.0,1.0
24811,The City Dark,9269,9269,0,2012.csv,2012,1.0,0.0
24812,The Curious World of Hieronymus Bosch,9269,0,9269,2018.csv,2018,0.0,1.0
24813,Europe '51,9269,0,9269,2017.csv,2017,0.0,1.0
24814,Hooligan Sparrow,9263,9263,0,2016.csv,2016,1.0,0.0
24815,Chubby Funny,9263,0,9263,2017.csv,2017,0.0,1.0
24816,Jeff Beck at Ronnie Scott's,9250,0,9250,2010.csv,2010,0.0,1.0
24817,The Chaplin Revue,9249,0,9249,2018.csv,2018,0.0,1.0
24818,Donkey Xote 2010 Re-release,9247,0,9247,2010.csv,2010,0.0,1.0
24819,Quixote's Island,9241,0,9241,2011.csv,2011,0.0,1.0
24820,Tekken: Kazuya's Revenge,9240,0,9240,2014.csv,2014,0.0,1.0
24821,Public Enemy 2010 Re-release,9240,0,9240,2010.csv,2010,0.0,1.0
24822,Mikhael,9237,0,9237,2019.csv,2019,0.0,1.0
24823,The Dam Busters 2019 Re-release,9232,0,9232,2019.csv,2019,0.0,1.0
24824,Bet on Revenge 2018 Re-release,9231,0,9231,2018.csv,2018,0.0,1.0
24825,Guest,9227,0,9227,2011.csv,2011,0.0,1.0
24826,The Sacrament,9221,9221,0,2014.csv,2014,1.0,0.0
24827,24 Seconds,9215,0,9215,2018.csv,2018,0.0,1.0
24828,Yürügari ibram,9213,0,9213,2011.csv,2011,0.0,1.0
24829,A Dark Place,9212,0,9212,2019.csv,2019,0.0,1.0
24830,Lifting King Kong 2011 Re-release,9207,0,9207,2011.csv,2011,0.0,1.0
24831,Aysheen el lahza,9205,0,9205,2010.csv,2010,0.0,1.0
24832,Cracked Up,9197,9197,0,2019.csv,2019,1.0,0.0
24833,Domestic Life,9197,0,9197,2013.csv,2013,0.0,1.0
24834,Ghost Team One,9195,9195,0,2013.csv,2013,1.0,0.0
24835,Soul Exodus,9192,0,9192,2016.csv,2016,0.0,1.0
24836,Trouble Every Day 2013 Re-release,9189,9189,0,2013.csv,2013,1.0,0.0
24837,Nanak Shah Fakir,9188,0,9188,2015.csv,2015,0.0,1.0
24838,Frank & Lola,9188,9188,0,2016.csv,2016,1.0,0.0
24839,Trade 2010 Re-release,9187,0,9187,2010.csv,2010,0.0,1.0
24840,Average Joe,9176,9176,0,2021.csv,2021,1.0,0.0
24841,Scarface 2014 Re-release,9176,0,9176,2014.csv,2014,0.0,1.0
24842,Strange Occurrences in a Small Irish Village,9173,0,9173,2016.csv,2016,0.0,1.0
24843,The Inventor of Dreams,9172,0,9172,2013.csv,2013,0.0,1.0
24844,White on White,9171,0,9171,2020.csv,2020,0.0,1.0
24845,Machi Action,9167,0,9167,2013.csv,2013,0.0,1.0
24846,Los héroes del mal,9164,0,9164,2015.csv,2015,0.0,1.0
24847,The Hottest August,9163,9163,0,2019.csv,2019,1.0,0.0
24848,Two for Joy,9162,0,9162,2018.csv,2018,0.0,1.0
24849,Bad Blood 2015 Re-release,9161,0,9161,2015.csv,2015,0.0,1.0
24850,The Reef 2: High Tide 2017 Re-release,9159,0,9159,2017.csv,2017,0.0,1.0
24851,Time Out,9159,0,9159,2015.csv,2015,0.0,1.0
24852,The Elevator: Three Minutes Can Change Your Life,9157,0,9157,2019.csv,2019,0.0,1.0
24853,Tied,9155,0,9155,2013.csv,2013,0.0,1.0
24854,Baryllis Baked Beans,9153,0,9153,2011.csv,2011,0.0,1.0
24855,I'm Dating You Not,9152,0,9152,2013.csv,2013,0.0,1.0
24856,The Hollow Point,9149,0,9149,2016.csv,2016,0.0,1.0
24857,Blood Simple 2017 Re-release,9148,0,9148,2017.csv,2017,0.0,1.0
24858,Breeze on the Lingding Ocean,9144,0,9144,2019.csv,2019,0.0,1.0
24859,There Will be Ample Time,9135,0,9135,2018.csv,2018,0.0,1.0
24860,Wellspring,9134,0,9134,2016.csv,2016,0.0,1.0
24861,Just One More Kiss,9130,9130,0,2020.csv,2020,1.0,0.0
24862,Thirst Street,9129,9129,0,2017.csv,2017,1.0,0.0
24863,Cupcakes,9129,9129,0,2015.csv,2015,1.0,0.0
24864,Ente Mezhuthiri Athazhangal,9128,0,9128,2018.csv,2018,0.0,1.0
24865,Here We Are,9128,0,9128,2021.csv,2021,0.0,1.0
24866,Bad Lieutenant: Port of Call New Orleans 2011 Re-release,9121,0,9121,2011.csv,2011,0.0,1.0
24867,The Big Wave,9120,0,9120,2017.csv,2017,0.0,1.0
24868,The Guest Aleppo to Istanbul,9116,0,9116,2018.csv,2018,0.0,1.0
24869,Faith Connections,9111,9111,0,2014.csv,2014,1.0,0.0
24870,Lycan,9110,9110,0,2017.csv,2017,1.0,0.0
24871,Paternoster,9107,0,9107,2016.csv,2016,0.0,1.0
24872,Gorcilo,9105,0,9105,2015.csv,2015,0.0,1.0
24873,The Eyes,9104,9104,0,2017.csv,2017,1.0,0.0
24874,Julian Schnabel: A Private Portrait,9103,9103,0,2017.csv,2017,1.0,0.0
24875,Bruno Motoneta,9102,0,9102,2018.csv,2018,0.0,1.0
24876,Decoding Deepak,9100,9100,0,2012.csv,2012,1.0,0.0
24877,Dogs Without Names,9093,0,9093,2017.csv,2017,0.0,1.0
24878,Quiero Saber,9086,0,9086,2012.csv,2012,0.0,1.0
24879,National Theatre Live: I'm Not Running,9085,0,9085,2019.csv,2019,0.0,1.0
24880,Apolitical Romance,9083,0,9083,2014.csv,2014,0.0,1.0
24881,The Innkeepers 2016 Re-release,9081,0,9081,2016.csv,2016,0.0,1.0
24882,Gerontophilia 2015 Re-release,9074,4916,4158,2015.csv,2015,0.541767687899493,0.45823231210050697
24883,Cries & Whispers 2017 Re-release,9073,0,9073,2017.csv,2017,0.0,1.0
24884,Journey to the Sea,9069,0,9069,2017.csv,2017,0.0,1.0
24885,Geuk-jang-pan An-nyeong Ja-du-ya,9067,0,9067,2016.csv,2016,0.0,1.0
24886,El Mar La Mar,9065,9065,0,2018.csv,2018,1.0,0.0
24887,Fly with the Crane,9057,0,9057,2018.csv,2018,0.0,1.0
24888,Chaman el Ultimo Guerrero,9038,0,9038,2016.csv,2016,0.0,1.0
24889,Un caballo llamado Elefante,9034,0,9034,2017.csv,2017,0.0,1.0
24890,The Hunger 2014 Re-release,9030,0,9030,2014.csv,2014,0.0,1.0
24891,Benden Hikâyesi,9028,0,9028,2019.csv,2019,0.0,1.0
24892,Life and Death in 96 Hours,9028,0,9028,2016.csv,2016,0.0,1.0
24893,Frantz Fanon: Black Skin White Mask,9025,9025,0,2019.csv,2019,1.0,0.0
24894,The Apartment 2012 Re-release,9022,0,9022,2012.csv,2012,0.0,1.0
24895,The Sky Crawlers 2010 Re-release,9012,0,9012,2010.csv,2010,0.0,1.0
24896,The Long Way Home,9008,0,9008,2015.csv,2015,0.0,1.0
24897,Step Up: High Water,9005,9005,0,2018.csv,2018,1.0,0.0
24898,Money Fight,9004,9004,0,2012.csv,2012,1.0,0.0
24899,Station to Station,9000,9000,0,2015.csv,2015,1.0,0.0
24900,Mosquita y Mari,9000,9000,0,2012.csv,2012,1.0,0.0
24901,At an Uncertain Time,9000,0,9000,2015.csv,2015,0.0,1.0
24902,Zoo Wars,8998,8998,0,2018.csv,2018,1.0,0.0
24903,Colpo d'occhio 2011 Re-release,8991,0,8991,2011.csv,2011,0.0,1.0
24904,Revolt,8986,0,8986,2017.csv,2017,0.0,1.0
24905,Secret Ingredient,8982,0,8982,2018.csv,2018,0.0,1.0
24906,Survivors Guide To Prison,8982,8982,0,2018.csv,2018,1.0,0.0
24907,Fall in Love,8977,0,8977,2016.csv,2016,0.0,1.0
24908,Rang Panjab,8974,0,8974,2018.csv,2018,0.0,1.0
24909,Selah el-Talamiz,8972,0,8972,2016.csv,2016,0.0,1.0
24910,Oscuro animal,8972,0,8972,2016.csv,2016,0.0,1.0
24911,Colossal Youth,8968,8331,637,2018.csv,2018,0.9289696699375558,0.07103033006244425
24912,Bir damla ates,8965,0,8965,2017.csv,2017,0.0,1.0
24913,Big Words,8965,8965,0,2013.csv,2013,1.0,0.0
24914,Myanmar in Love with Bangkok,8963,0,8963,2014.csv,2014,0.0,1.0
24915,Technoboss,8960,0,8960,2019.csv,2019,0.0,1.0
24916,The Tianchi Monster,8958,0,8958,2019.csv,2019,0.0,1.0
24917,"Death Doesn't Exist, and Love Doesn't Either",8957,0,8957,2020.csv,2020,0.0,1.0
24918,Racing Hearts 2015 Re-release,8953,0,8953,2015.csv,2015,0.0,1.0
24919,Three Stars,8942,8942,0,2012.csv,2012,1.0,0.0
24920,Winnetou's Son,8942,0,8942,2015.csv,2015,0.0,1.0
24921,Summer of '67,8941,8941,0,2018.csv,2018,1.0,0.0
24922,Desingle Bible,8940,0,8940,2016.csv,2016,0.0,1.0
24923,Lotte from Gadgetville 2015 Re-release,8931,0,8931,2015.csv,2015,0.0,1.0
24924,El plan divino,8931,0,8931,2019.csv,2019,0.0,1.0
24925,The Murder of Nicole Brown Simpson,8931,0,8931,2019.csv,2019,0.0,1.0
24926,Mario on Tour,8927,0,8927,2017.csv,2017,0.0,1.0
24927,Kindred,8921,8921,0,2020.csv,2020,1.0,0.0
24928,Walking Vengeance 2011 Re-release,8919,0,8919,2011.csv,2011,0.0,1.0
24929,The Future's Past,8911,0,8911,2012.csv,2012,0.0,1.0
24930,Pray,8910,0,8910,2020.csv,2020,0.0,1.0
24931,Wold,8906,0,8906,2015.csv,2015,0.0,1.0
24932,Dark Skull,8905,0,8905,2016.csv,2016,0.0,1.0
24933,This is Congo,8905,7051,1854,2018.csv,2018,0.7918023582257159,0.2081976417742841
24934,Unwanted Brother,8902,0,8902,2016.csv,2016,0.0,1.0
24935,Xingu 2013 Re-release,8901,0,8901,2013.csv,2013,0.0,1.0
24936,Praana,8892,0,8892,2019.csv,2019,0.0,1.0
24937,Cold Sunday,8888,0,8888,2012.csv,2012,0.0,1.0
24938,Echo of Time,8878,0,8878,2017.csv,2017,0.0,1.0
24939,A Thousand Kisses Deep,8877,0,8877,2012.csv,2012,0.0,1.0
24940,Bali: Beats of Paradise,8876,0,8876,2019.csv,2019,0.0,1.0
24941,Cinema Digital Seoul,8873,0,8873,2010.csv,2010,0.0,1.0
24942,B-Side,8870,8870,0,2015.csv,2015,1.0,0.0
24943,Dear Etranger,8864,0,8864,2018.csv,2018,0.0,1.0
24944,Seni Gidi Seni,8861,0,8861,2017.csv,2017,0.0,1.0
24945,Nocturne,8861,0,8861,2019.csv,2019,0.0,1.0
24946,The Woman of Rumour,8860,0,8860,2017.csv,2017,0.0,1.0
24947,Ptitsa 2017 Re-release,8860,0,8860,2017.csv,2017,0.0,1.0
24948,The Meanest Man in Texas,8850,8850,0,2019.csv,2019,1.0,0.0
24949,PSV Garuda Vega,8849,0,8849,2017.csv,2017,0.0,1.0
24950,90 Years of PAOK: Nostalgia for the Future,8847,0,8847,2016.csv,2016,0.0,1.0
24951,The Pardon,8845,8845,0,2015.csv,2015,1.0,0.0
24952,Providence,8840,8840,0,2016.csv,2016,1.0,0.0
24953,Kabus,8832,0,8832,2018.csv,2018,0.0,1.0
24954,The Prisoner 2020 Re-release,8829,0,8829,2020.csv,2020,0.0,1.0
24955,Las mujeres llegan tarde,8828,0,8828,2012.csv,2012,0.0,1.0
24956,Saskinlar Cetesi,8826,0,8826,2018.csv,2018,0.0,1.0
24957,Linhas Tortas,8825,0,8825,2019.csv,2019,0.0,1.0
24958,Nostalgia for the Light 2016 Re-release,8824,0,8824,2016.csv,2016,0.0,1.0
24959,Home Run Showdown,8824,8824,0,2012.csv,2012,1.0,0.0
24960,Isolated,8823,0,8823,2016.csv,2016,0.0,1.0
24961,The Hidden Love,8823,0,8823,2019.csv,2019,0.0,1.0
24962,Ombline,8817,0,8817,2012.csv,2012,0.0,1.0
24963,Amor Amor,8813,0,8813,2018.csv,2018,0.0,1.0
24964,That Part Feeling - the Universe of Arvo Part,8812,8812,0,2019.csv,2019,1.0,0.0
24965,The Ghazi Attack,8812,0,8812,2017.csv,2017,0.0,1.0
24966,The Cabinet of Dr. Caligari 2014 Re-release,8811,8811,0,2014.csv,2014,1.0,0.0
24967,The Grand Budapest Hotel 2020 Re-release,8809,0,8809,2020.csv,2020,0.0,1.0
24968,Daddy,8808,0,8808,2017.csv,2017,0.0,1.0
24969,The Dead Nation,8804,0,8804,2017.csv,2017,0.0,1.0
24970,King Jack,8801,0,8801,2016.csv,2016,0.0,1.0
24971,Wild Grass 2013 Re-release,8800,0,8800,2013.csv,2013,0.0,1.0
24972,Dawn of the Crescent Moon,8799,8799,0,2015.csv,2015,1.0,0.0
24973,Gayby Baby,8798,0,8798,2015.csv,2015,0.0,1.0
24974,Repeat I Love You,8797,0,8797,2012.csv,2012,0.0,1.0
24975,Smilie (Smilik),8787,0,8787,2015.csv,2015,0.0,1.0
24976,Prague Short Film Festival,8785,0,8785,2011.csv,2011,0.0,1.0
24977,Hell Baby,8785,8785,0,2013.csv,2013,1.0,0.0
24978,Kanithan,8782,0,8782,2016.csv,2016,0.0,1.0
24979,Tao Hua Yuan 2020 Re-release,8777,0,8777,2020.csv,2020,0.0,1.0
24980,Zerk,8772,0,8772,2018.csv,2018,0.0,1.0
24981,The Riddle 2010 Re-release,8769,0,8769,2010.csv,2010,0.0,1.0
24982,La Rodata 2013 Re-release,8768,0,8768,2013.csv,2013,0.0,1.0
24983,Dulce de leche,8762,0,8762,2012.csv,2012,0.0,1.0
24984,El padre médico,8758,0,8758,2020.csv,2020,0.0,1.0
24985,Nagisa Oshima Retrospective,8757,0,8757,2010.csv,2010,0.0,1.0
24986,Kar,8756,0,8756,2016.csv,2016,0.0,1.0
24987,Fair Play 2015 Re-release,8753,0,8753,2015.csv,2015,0.0,1.0
24988,The Rifleman,8750,0,8750,2020.csv,2020,0.0,1.0
24989,Love Sick,8744,0,8744,2015.csv,2015,0.0,1.0
24990,Only When I Dance,8738,8738,0,2010.csv,2010,1.0,0.0
24991,Dunkirk 2020 Re-release,8738,0,8738,2020.csv,2020,0.0,1.0
24992,Sandeep Aur Pinky Faraar,8735,0,8735,2021.csv,2021,0.0,1.0
24993,Gold,8729,0,8729,2014.csv,2014,0.0,1.0
24994,And Your Bird Can Sing,8726,0,8726,2020.csv,2020,0.0,1.0
24995,A Chance Encounter 2015 Re-release,8724,0,8724,2015.csv,2015,0.0,1.0
24996,Quezon's Game,8721,0,8721,2020.csv,2020,0.0,1.0
24997,Cars,8718,0,8718,2020.csv,2020,0.0,1.0
24998,The Man in the White Suit,8718,8718,0,2012.csv,2012,1.0,0.0
24999,Death on the Nile 2020 Re-release,8717,0,8717,2020.csv,2020,0.0,1.0
25000,Domain,8716,0,8716,2010.csv,2010,0.0,1.0
25001,Lasaòa De Mono,8710,0,8710,2017.csv,2017,0.0,1.0
25002,Aswathama,8708,0,8708,2020.csv,2020,0.0,1.0
25003,Blood Feast,8708,8708,0,2018.csv,2018,1.0,0.0
25004,Amnesia,8700,8700,0,2017.csv,2017,1.0,0.0
25005,Jab Tak Hai Jaan 2016 Re-release,8690,0,8690,2016.csv,2016,0.0,1.0
25006,Man on a Mission: Richard Garriott's Road to the Stars,8688,8688,0,2012.csv,2012,1.0,0.0
25007,Love Comes After,8683,0,8683,2013.csv,2013,0.0,1.0
25008,Sathru,8683,0,8683,2019.csv,2019,0.0,1.0
25009,Cut-Out Girls,8682,0,8682,2019.csv,2019,0.0,1.0
25010,Zog,8681,0,8681,2019.csv,2019,0.0,1.0
25011,The Brink 2019 Re-release,8675,0,8675,2019.csv,2019,0.0,1.0
25012,Exit,8666,0,8666,2015.csv,2015,0.0,1.0
25013,Hasret: Sehnsucht,8665,0,8665,2016.csv,2016,0.0,1.0
25014,Make Me Up,8660,0,8660,2018.csv,2018,0.0,1.0
25015,Miss Julie 2016 Re-release,8657,0,8657,2016.csv,2016,0.0,1.0
25016,O Carteiro,8656,0,8656,2013.csv,2013,0.0,1.0
25017,3 Kadin 3 Kader,8650,0,8650,2013.csv,2013,0.0,1.0
25018,Chungul,8650,0,8650,2016.csv,2016,0.0,1.0
25019,Supreme Justice with Judge Karen: Rent My Ride/Circle of Friends,8648,0,8648,2016.csv,2016,0.0,1.0
25020,By the Rails,8645,0,8645,2016.csv,2016,0.0,1.0
25021,Selfie with Timochenko,8644,0,8644,2018.csv,2018,0.0,1.0
25022,Ghana Must Go,8643,0,8643,2017.csv,2017,0.0,1.0
25023,Dosed,8643,0,8643,2019.csv,2019,0.0,1.0
25024,The Dead and the Living 2014 Re-release,8638,0,8638,2014.csv,2014,0.0,1.0
25025,They Will Return,8632,0,8632,2014.csv,2014,0.0,1.0
25026,"Small, Beautifully Moving Parts",8631,8631,0,2012.csv,2012,1.0,0.0
25027,Proximity 2020 Re-release,8626,0,8626,2020.csv,2020,0.0,1.0
25028,A Young Man with High Potential,8623,0,8623,2019.csv,2019,0.0,1.0
25029,Extortion,8617,0,8617,2017.csv,2017,0.0,1.0
25030,Pepo: La última oportunidad,8616,0,8616,2018.csv,2018,0.0,1.0
25031,Meet Me in Montenegro,8612,8612,0,2015.csv,2015,1.0,0.0
25032,Almost Human,8608,8447,161,2014.csv,2014,0.981296468401487,0.018703531598513012
25033,The End,8606,0,8606,2014.csv,2014,0.0,1.0
25034,Mojave,8602,8253,349,2016.csv,2016,0.9594280399906998,0.04057196000930016
25035,Farewell to Hollywood,8601,8601,0,2015.csv,2015,1.0,0.0
25036,General Education,8601,8601,0,2012.csv,2012,1.0,0.0
25037,The Wolf's Lair,8597,0,8597,2016.csv,2016,0.0,1.0
25038,No es lo que parece,8592,0,8592,2019.csv,2019,0.0,1.0
25039,We Were There: True Love 2013 Re-release,8583,0,8583,2013.csv,2013,0.0,1.0
25040,Guests in the Villa,8577,0,8577,2020.csv,2020,0.0,1.0
25041,Ombre,8573,0,8573,2015.csv,2015,0.0,1.0
25042,Nati 2 volte,8573,0,8573,2019.csv,2019,0.0,1.0
25043,Brother's Day,8570,0,8570,2019.csv,2019,0.0,1.0
25044,Düzensiz Düzenbazlar,8569,0,8569,2017.csv,2017,0.0,1.0
25045,Lucky,8564,8564,0,2011.csv,2011,1.0,0.0
25046,Sobrevivi ao Holocausto,8555,0,8555,2014.csv,2014,0.0,1.0
25047,Absentia,8555,0,8555,2013.csv,2013,0.0,1.0
25048,Love Beats,8550,0,8550,2019.csv,2019,0.0,1.0
25049,What Lies Below,8550,0,8550,2021.csv,2021,0.0,1.0
25050,Inside Out,8547,0,8547,2011.csv,2011,0.0,1.0
25051,Liza the Fox-Fairy 2016 Re-release,8547,0,8547,2016.csv,2016,0.0,1.0
25052,Tomorrow You Will Leave,8546,0,8546,2014.csv,2014,0.0,1.0
25053,From the East,8540,8540,0,2016.csv,2016,1.0,0.0
25054,The Harvesters,8529,0,8529,2019.csv,2019,0.0,1.0
25055,Inspector Maigret,8528,8528,0,2017.csv,2017,1.0,0.0
25056,She Monkeys,8523,0,8523,2012.csv,2012,0.0,1.0
25057,Eyvah Karim,8522,0,8522,2018.csv,2018,0.0,1.0
25058,Lira Paulistana e a Vanguarda Paulista,8518,0,8518,2013.csv,2013,0.0,1.0
25059,The Fall,8516,0,8516,2016.csv,2016,0.0,1.0
25060,En apatía,8516,0,8516,2014.csv,2014,0.0,1.0
25061,The Quitter,8512,8512,0,2014.csv,2014,1.0,0.0
25062,SOS Matrosu,8503,0,8503,2018.csv,2018,0.0,1.0
25063,Stopping: Wie Man Die Welt Anhaelt,8492,0,8492,2015.csv,2015,0.0,1.0
25064,The Post 2020 Re-release,8490,0,8490,2020.csv,2020,0.0,1.0
25065,Local Heroes,8488,0,8488,2013.csv,2013,0.0,1.0
25066,Jhalki,8488,0,8488,2019.csv,2019,0.0,1.0
25067,Run,8487,0,8487,2019.csv,2019,0.0,1.0
25068,Late Summer,8487,0,8487,2016.csv,2016,0.0,1.0
25069,The Empty Hours,8478,8244,234,2014.csv,2014,0.9723991507430998,0.027600849256900213
25070,From Bangkok to Mandalay,8476,0,8476,2016.csv,2016,0.0,1.0
25071,God's Not Dead 2017 Re-release,8475,0,8475,2017.csv,2017,0.0,1.0
25072,Phoenix 2015 Re-release,8474,0,8474,2015.csv,2015,0.0,1.0
25073,Spring,8473,0,8473,2016.csv,2016,0.0,1.0
25074,Furlough,8472,8472,0,2018.csv,2018,1.0,0.0
25075,Señora Haidi,8468,0,8468,2017.csv,2017,0.0,1.0
25076,Love Cell,8467,0,8467,2015.csv,2015,0.0,1.0
25077,I Hugged the Berlin Patient,8463,0,8463,2013.csv,2013,0.0,1.0
25078,El espacio entre las cosas,8463,0,8463,2013.csv,2013,0.0,1.0
25079,Nobody Dies,8462,0,8462,2019.csv,2019,0.0,1.0
25080,Canopy,8462,8462,0,2014.csv,2014,1.0,0.0
25081,Nightlife,8462,0,8462,2016.csv,2016,0.0,1.0
25082,Anomalous,8462,0,8462,2016.csv,2016,0.0,1.0
25083,Pandemic,8459,0,8459,2016.csv,2016,0.0,1.0
25084,Karel Svoboda: Stastna leta,8452,0,8452,2020.csv,2020,0.0,1.0
25085,The Institute,8445,8445,0,2013.csv,2013,1.0,0.0
25086,1929,8442,0,8442,2019.csv,2019,0.0,1.0
25087,L'innocenza di Clara,8442,0,8442,2012.csv,2012,0.0,1.0
25088,Tengri: Blue Heavens,8441,0,8441,2010.csv,2010,0.0,1.0
25089,We Are the Flesh,8438,8438,0,2017.csv,2017,1.0,0.0
25090,Before the Revolution,8438,0,8438,2011.csv,2011,0.0,1.0
25091,Hello Herman,8437,8437,0,2013.csv,2013,1.0,0.0
25092,My Days with Gloria,8434,0,8434,2010.csv,2010,0.0,1.0
25093,When You No Longer Love Me 2019 Re-release,8433,0,8433,2019.csv,2019,0.0,1.0
25094,Lulu 2016 Re-release,8432,0,8432,2016.csv,2016,0.0,1.0
25095,Cold Feet,8432,0,8432,2019.csv,2019,0.0,1.0
25096,Red Hollywood,8426,8426,0,2014.csv,2014,1.0,0.0
25097,A Chinese Odyssey: Part One - Pandora's Box,8425,0,8425,2010.csv,2010,0.0,1.0
25098,Fathers,8423,0,8423,2016.csv,2016,0.0,1.0
25099,Rail,8414,0,8414,2016.csv,2016,0.0,1.0
25100,Beyond the Road,8412,0,8412,2011.csv,2011,0.0,1.0
25101,Housewife,8408,0,8408,2018.csv,2018,0.0,1.0
25102,Vedi,8406,0,8406,2011.csv,2011,0.0,1.0
25103,Portal,8406,0,8406,2020.csv,2020,0.0,1.0
25104,Highway 33,8405,0,8405,2018.csv,2018,0.0,1.0
25105,Esteros,8404,0,8404,2017.csv,2017,0.0,1.0
25106,Soekarno,8403,0,8403,2014.csv,2014,0.0,1.0
25107,Yaan,8403,0,8403,2014.csv,2014,0.0,1.0
25108,In a Lonely Place 2017 Re-release,8401,0,8401,2017.csv,2017,0.0,1.0
25109,"First of All, Felicia",8399,0,8399,2010.csv,2010,0.0,1.0
25110,Airstream,8396,0,8396,2013.csv,2013,0.0,1.0
25111,The Happy Sad,8395,8395,0,2013.csv,2013,1.0,0.0
25112,The Necessities of Life,8393,0,8393,2010.csv,2010,0.0,1.0
25113,The Big Bang 2014 Re-release,8393,0,8393,2014.csv,2014,0.0,1.0
25114,Night of the Living Dead: Resurrection,8393,0,8393,2012.csv,2012,0.0,1.0
25115,LX 2048,8393,0,8393,2020.csv,2020,0.0,1.0
25116,Bottled Life: Nestle's Business with Water,8390,0,8390,2013.csv,2013,0.0,1.0
25117,The Confirmation,8382,0,8382,2016.csv,2016,0.0,1.0
25118,Downloaded,8377,8377,0,2013.csv,2013,1.0,0.0
25119,Counting,8374,8374,0,2015.csv,2015,1.0,0.0
25120,Nr. 7,8364,0,8364,2012.csv,2012,0.0,1.0
25121,Zootopia 2020 Re-release,8363,0,8363,2016.csv,2016,0.0,1.0
25122,Gilbert,8362,8362,0,2017.csv,2017,1.0,0.0
25123,Kathakali,8361,0,8361,2016.csv,2016,0.0,1.0
25124,Ryan's Daughter,8358,0,8358,2011.csv,2011,0.0,1.0
25125,Hamah,8357,0,8357,2017.csv,2017,0.0,1.0
25126,Eternity: The Movie,8350,8350,0,2014.csv,2014,1.0,0.0
25127,Gringo Trails,8349,8349,0,2014.csv,2014,1.0,0.0
25128,A Teacher,8348,8348,0,2013.csv,2013,1.0,0.0
25129,As If I Am Not There,8347,0,8347,2011.csv,2011,0.0,1.0
25130,Seytan Oyunu,8345,0,8345,2019.csv,2019,0.0,1.0
25131,All of a Sudden,8341,0,8341,2016.csv,2016,0.0,1.0
25132,Sweet Bean 2018 Re-release,8340,0,8340,2018.csv,2018,0.0,1.0
25133,My Last Day Without You,8335,0,8335,2014.csv,2014,0.0,1.0
25134,Pioneer 2016 Re-release,8332,0,8332,2016.csv,2016,0.0,1.0
25135,Natasha,8325,8325,0,2017.csv,2017,1.0,0.0
25136,Ee Adutha Kaalath,8323,0,8323,2012.csv,2012,0.0,1.0
25137,The Dead Center,8320,8320,0,2019.csv,2019,1.0,0.0
25138,One More Time 2018 Re-release,8317,0,8317,2018.csv,2018,0.0,1.0
25139,About Cherry,8315,3003,5312,2012.csv,2012,0.36115453998797353,0.6388454600120265
25140,Woman Without Piano 2011 Re-release,8305,0,8305,2011.csv,2011,0.0,1.0
25141,The Big Meeting,8305,0,8305,2019.csv,2019,0.0,1.0
25142,The Holy Mountain,8302,0,8302,2020.csv,2020,0.0,1.0
25143,Mr. Chibbs,8302,8302,0,2017.csv,2017,1.0,0.0
25144,The Last Word,8298,0,8298,2010.csv,2010,0.0,1.0
25145,Il conte magico,8296,0,8296,2019.csv,2019,0.0,1.0
25146,Served Like a Girl,8290,8290,0,2017.csv,2017,1.0,0.0
25147,La Salada,8278,0,8278,2015.csv,2015,0.0,1.0
25148,We Are Twisted Fucking Sister!,8277,8277,0,2016.csv,2016,1.0,0.0
25149,Anti-Argentine Campaign,8271,0,8271,2016.csv,2016,0.0,1.0
25150,Hans Dampf,8269,0,8269,2013.csv,2013,0.0,1.0
25151,Safe,8265,0,8265,2019.csv,2019,0.0,1.0
25152,Life Partners,8265,8265,0,2014.csv,2014,1.0,0.0
25153,I Will Be In The Music,8264,0,8264,2017.csv,2017,0.0,1.0
25154,Love Ranch 2012 Re-release,8264,0,8264,2012.csv,2012,0.0,1.0
25155,Conference,8261,0,8261,2020.csv,2020,0.0,1.0
25156,Rise of the Footsoldier: The Heist,8261,0,8261,2019.csv,2019,0.0,1.0
25157,French Cancan,8259,0,8259,2011.csv,2011,0.0,1.0
25158,Little Mountain Boy,8254,0,8254,2016.csv,2016,0.0,1.0
25159,Aliyah,8253,8253,0,2013.csv,2013,1.0,0.0
25160,The Holiday 2020 Re-release,8249,0,8249,2020.csv,2020,0.0,1.0
25161,8½ 2016 Re-release,8245,0,8245,2016.csv,2016,0.0,1.0
25162,Crazy House,8243,0,8243,2019.csv,2019,0.0,1.0
25163,Jaddi Sardar,8242,0,8242,2019.csv,2019,0.0,1.0
25164,Silicon Cowboys,8239,8239,0,2016.csv,2016,1.0,0.0
25165,Sunburn,8238,0,8238,2020.csv,2020,0.0,1.0
25166,Jim: The James Foley Story,8236,0,8236,2016.csv,2016,0.0,1.0
25167,Le Doulos 2017 Re-release,8235,0,8235,2017.csv,2017,0.0,1.0
25168,All About My Mother 2017 Re-release,8231,0,8231,2017.csv,2017,0.0,1.0
25169,Start Over Tonight,8224,0,8224,2017.csv,2017,0.0,1.0
25170,The Haunt,8222,0,8222,2020.csv,2020,0.0,1.0
25171,Headfirst,8215,0,8215,2012.csv,2012,0.0,1.0
25172,The Etruscan Smile 2019 release,8213,8213,0,2019.csv,2019,1.0,0.0
25173,"Raúl, la democracia desde adentro",8213,0,8213,2019.csv,2019,0.0,1.0
25174,Brooklyn Brothers Beat the Best,8210,7466,744,2012.csv,2012,0.9093788063337394,0.09062119366626066
25175,Wish to Wash with Rain,8203,0,8203,2017.csv,2017,0.0,1.0
25176,Vendetta 2013 Re-release,8197,0,8197,2013.csv,2013,0.0,1.0
25177,Don't Kill It,8196,0,8196,2018.csv,2018,0.0,1.0
25178,Still River,8195,0,8195,2019.csv,2019,0.0,1.0
25179,Pasaje al amanecer,8193,0,8193,2017.csv,2017,0.0,1.0
25180,Spiral,8190,8190,0,2018.csv,2018,1.0,0.0
25181,County Lines,8189,0,8189,2020.csv,2020,0.0,1.0
25182,The Man,8184,0,8184,2017.csv,2017,0.0,1.0
25183,Jellyfish Eyes,8176,8176,0,2015.csv,2015,1.0,0.0
25184,Yasar Kemal Efsanesi,8174,0,8174,2018.csv,2018,0.0,1.0
25185,Green Light,8172,0,8172,2019.csv,2019,0.0,1.0
25186,Anatahan,8171,8171,0,2017.csv,2017,1.0,0.0
25187,The Other Side,8168,8074,94,2016.csv,2016,0.9884916748285995,0.011508325171400588
25188,Isztambul,8160,0,8160,2011.csv,2011,0.0,1.0
25189,If You Were Me 5,8158,0,8158,2011.csv,2011,0.0,1.0
25190,Danny,8158,0,8158,2016.csv,2016,0.0,1.0
25191,Desde Adentro,8157,0,8157,2013.csv,2013,0.0,1.0
25192,Rise of the Footsoldier Part II,8156,0,8156,2015.csv,2015,0.0,1.0
25193,Volley,8155,0,8155,2015.csv,2015,0.0,1.0
25194,Dark Butterfly,8154,0,8154,2018.csv,2018,0.0,1.0
25195,Blue Train,8151,0,8151,2010.csv,2010,0.0,1.0
25196,Inside the Rain,8140,8140,0,2020.csv,2020,1.0,0.0
25197,Somewhere Tonight,8139,0,8139,2012.csv,2012,0.0,1.0
25198,Let the Bullets Fly 2014 Re-release,8136,0,8136,2014.csv,2014,0.0,1.0
25199,The Striving,8134,0,8134,2017.csv,2017,0.0,1.0
25200,Keep Rollin',8133,0,8133,2014.csv,2014,0.0,1.0
25201,Far from Vietnam,8132,8132,0,2013.csv,2013,1.0,0.0
25202,A Son Named Erasmus,8123,0,8123,2020.csv,2020,0.0,1.0
25203,Tan frágil como un segundo,8121,0,8121,2015.csv,2015,0.0,1.0
25204,Game of Death,8120,0,8120,2020.csv,2020,0.0,1.0
25205,Ifrit,8113,0,8113,2019.csv,2019,0.0,1.0
25206,Second Hand,8110,0,8110,2019.csv,2019,0.0,1.0
25207,From Nowhere,8109,8109,0,2017.csv,2017,1.0,0.0
25208,Breathing into Marble,8108,0,8108,2018.csv,2018,0.0,1.0
25209,The Wave,8101,8101,0,2020.csv,2020,1.0,0.0
25210,Restless City,8100,8100,0,2012.csv,2012,1.0,0.0
25211,Wild Grass,8099,0,8099,2020.csv,2020,0.0,1.0
25212,Frankenstein 2011 Re-release,8095,0,8095,2011.csv,2011,0.0,1.0
25213,La vida en llamas,8095,0,8095,2015.csv,2015,0.0,1.0
25214,Half-Sister,8095,0,8095,2020.csv,2020,0.0,1.0
25215,Next Year Jerusalem,8093,8093,0,2014.csv,2014,1.0,0.0
25216,The Sunlit Night,8090,0,8090,2020.csv,2020,0.0,1.0
25217,Adventures in Public School,8090,0,8090,2018.csv,2018,0.0,1.0
25218,Out of Thin Air,8083,0,8083,2017.csv,2017,0.0,1.0
25219,Golden Kingdom,8077,8077,0,2016.csv,2016,1.0,0.0
25220,El testigo,8071,0,8071,2018.csv,2018,0.0,1.0
25221,Vann over ild,8069,0,8069,2018.csv,2018,0.0,1.0
25222,Lee Scratch Perry's Vision of Paradise,8068,0,8068,2016.csv,2016,0.0,1.0
25223,Oleg,8061,0,8061,2020.csv,2020,0.0,1.0
25224,Blood Glacier 2015 Re-release,8058,0,8058,2015.csv,2015,0.0,1.0
25225,24 Hours of Love,8052,0,8052,2013.csv,2013,0.0,1.0
25226,"Corda Bamba, historia de uma menina equilibrista",8050,0,8050,2013.csv,2013,0.0,1.0
25227,The Royal Opera House: Faust,8046,0,8046,2019.csv,2019,0.0,1.0
25228,Çünkü Onu Çok Sevdim,8045,0,8045,2017.csv,2017,0.0,1.0
25229,The Mona Lisa Identity,8044,0,8044,2020.csv,2020,0.0,1.0
25230,The Rotten Link,8044,0,8044,2016.csv,2016,0.0,1.0
25231,Steak (R)evolution,8038,8025,13,2015.csv,2015,0.9983826822592685,0.0016173177407315252
25232,Fair Game 2013 Re-release,8038,0,8038,2013.csv,2013,0.0,1.0
25233,Bare Essence of Life Ultra-Miracle Love Story 2010 Re-release,8030,0,8030,2010.csv,2010,0.0,1.0
25234,Straight Outta Tompkins,8022,8022,0,2015.csv,2015,1.0,0.0
25235,Sta. Niña,8007,0,8007,2012.csv,2012,0.0,1.0
25236,El Markab,8005,0,8005,2012.csv,2012,0.0,1.0
25237,Eiki Mikijjang,7999,0,7999,2010.csv,2010,0.0,1.0
25238,Talent Has Hunger,7998,7998,0,2016.csv,2016,1.0,0.0
25239,All About Evil,7995,7995,0,2010.csv,2010,1.0,0.0
25240,Puzhikkadakan,7995,0,7995,2019.csv,2019,0.0,1.0
25241,Ransacked,7991,0,7991,2016.csv,2016,0.0,1.0
25242,A Portuguesa,7990,0,7990,2019.csv,2019,0.0,1.0
25243,Cyril and Methodius: The Apostles of the Slavs,7988,0,7988,2014.csv,2014,0.0,1.0
25244,Mirusia Sings For You,7984,0,7984,2020.csv,2020,0.0,1.0
25245,One Small Hitch 2015 Re-release,7965,7965,0,2015.csv,2015,1.0,0.0
25246,Asik,7964,0,7964,2016.csv,2016,0.0,1.0
25247,How to live in this world,7964,0,7964,2019.csv,2019,0.0,1.0
25248,Roseanne for President!,7960,7960,0,2016.csv,2016,1.0,0.0
25249,Pink Wall,7960,0,7960,2019.csv,2019,0.0,1.0
25250,Keshava,7957,0,7957,2017.csv,2017,0.0,1.0
25251,Hurricane,7952,0,7952,2016.csv,2016,0.0,1.0
25252,Shatru Gate,7952,0,7952,2018.csv,2018,0.0,1.0
25253,Ama-San,7948,0,7948,2017.csv,2017,0.0,1.0
25254,22nd of May,7947,0,7947,2010.csv,2010,0.0,1.0
25255,Tango with Me,7943,0,7943,2012.csv,2012,0.0,1.0
25256,Stolen,7943,7943,0,2010.csv,2010,1.0,0.0
25257,Iliana,7941,0,7941,2020.csv,2020,0.0,1.0
25258,Glory Game,7940,0,7940,2015.csv,2015,0.0,1.0
25259,Mahanubhavudu,7938,0,7938,2017.csv,2017,0.0,1.0
25260,My Stuff,7936,0,7936,2013.csv,2013,0.0,1.0
25261,Alket Moot/Alket Moot,7935,0,7935,2011.csv,2011,0.0,1.0
25262,The Sound of Music 2019 Re-release,7933,0,7933,2019.csv,2019,0.0,1.0
25263,Omniyat Omri,7933,0,7933,2018.csv,2018,0.0,1.0
25264,Luna en Leo,7932,0,7932,2013.csv,2013,0.0,1.0
25265,Payanam,7930,0,7930,2011.csv,2011,0.0,1.0
25266,Knucklehead,7927,0,7927,2010.csv,2010,0.0,1.0
25267,The Player,7926,0,7926,2012.csv,2012,0.0,1.0
25268,Mugabe and the White African,7924,7924,0,2010.csv,2010,1.0,0.0
25269,Angels Are Made Of Light,7919,7919,0,2019.csv,2019,1.0,0.0
25270,Tess 2012 Re-release,7917,0,7917,2012.csv,2012,0.0,1.0
25271,John Wick: Chapter 2 2020 Re-release,7915,0,7915,2020.csv,2020,0.0,1.0
25272,Zorawar,7914,0,7914,2016.csv,2016,0.0,1.0
25273,Portrait of a Garden,7914,7914,0,2016.csv,2016,1.0,0.0
25274,The Silly Ones and the Stupid Ones,7912,0,7912,2014.csv,2014,0.0,1.0
25275,Back Home,7911,0,7911,2015.csv,2015,0.0,1.0
25276,Long Street,7906,0,7906,2010.csv,2010,0.0,1.0
25277,Gece Gelenler,7901,0,7901,2019.csv,2019,0.0,1.0
25278,The Universe Of One's Own,7898,0,7898,2018.csv,2018,0.0,1.0
25279,I AM PATRICK,7896,0,7896,2020.csv,2020,0.0,1.0
25280,Night on Earth 2017 Re-release,7893,0,7893,2017.csv,2017,0.0,1.0
25281,51 Por Ciento Boca,7892,0,7892,2017.csv,2017,0.0,1.0
25282,Into America's Wild,7890,0,7890,2020.csv,2020,0.0,1.0
25283,This Magnificent Cake!,7888,7888,0,2019.csv,2019,1.0,0.0
25284,Bleak Street,7888,0,7888,2015.csv,2015,0.0,1.0
25285,Almayer's Folly,7876,0,7876,2012.csv,2012,0.0,1.0
25286,Chhello Divas: A New Beginning,7876,0,7876,2015.csv,2015,0.0,1.0
25287,Dulla Bhatti Wala,7876,0,7876,2016.csv,2016,0.0,1.0
25288,Doom of Humanity,7876,0,7876,2017.csv,2017,0.0,1.0
25289,Swept Away,7876,7876,0,2017.csv,2017,1.0,0.0
25290,The Bad Sleep Better,7873,0,7873,2010.csv,2010,0.0,1.0
25291,Gizli Yüzler,7872,0,7872,2014.csv,2014,0.0,1.0
25292,Türk Lokumu,7870,0,7870,2016.csv,2016,0.0,1.0
25293,Ecuación,7869,0,7869,2016.csv,2016,0.0,1.0
25294,The Ninth,7865,0,7865,2019.csv,2019,0.0,1.0
25295,Zenith,7862,7862,0,2010.csv,2010,1.0,0.0
25296,Humraz: Cin Tarikati,7862,0,7862,2020.csv,2020,0.0,1.0
25297,The Field Guide to Evil,7860,0,7860,2020.csv,2020,0.0,1.0
25298,Mirattal,7859,0,7859,2012.csv,2012,0.0,1.0
25299,Born in Gaza,7859,0,7859,2014.csv,2014,0.0,1.0
25300,The Ballad of Lefty Brown,7856,7856,0,2017.csv,2017,1.0,0.0
25301,Kuwait Marrakech Kuwait,7852,0,7852,2020.csv,2020,0.0,1.0
25302,Ghost Fleet,7850,7850,0,2019.csv,2019,1.0,0.0
25303,Happy Hour,7848,0,7848,2019.csv,2019,0.0,1.0
25304,Winter's Night,7843,0,7843,2020.csv,2020,0.0,1.0
25305,Under Milk Wood,7843,0,7843,2015.csv,2015,0.0,1.0
25306,The Necromancer,7841,0,7841,2018.csv,2018,0.0,1.0
25307,Fagot,7838,0,7838,2018.csv,2018,0.0,1.0
25308,Journal de France 2014 Re-release,7836,0,7836,2014.csv,2014,0.0,1.0
25309,Still Loved,7835,0,7835,2016.csv,2016,0.0,1.0
25310,Dove Bisogna Stare,7834,0,7834,2019.csv,2019,0.0,1.0
25311,Let There Be Light 2019 Re-release,7831,0,7831,2019.csv,2019,0.0,1.0
25312,Of Love & Law,7826,0,7826,2019.csv,2019,0.0,1.0
25313,In the Zone,7826,0,7826,2018.csv,2018,0.0,1.0
25314,Enakku Innoru Per Irukku,7825,0,7825,2016.csv,2016,0.0,1.0
25315,Roadie,7825,7825,0,2012.csv,2012,1.0,0.0
25316,Photographic Memory,7822,7822,0,2012.csv,2012,1.0,0.0
25317,Two Women,7821,0,7821,2016.csv,2016,0.0,1.0
25318,A Última Estação,7820,0,7820,2013.csv,2013,0.0,1.0
25319,Pretty in Pink 2020 Re-release,7817,0,7817,2020.csv,2020,0.0,1.0
25320,The Great Man,7814,7814,0,2015.csv,2015,1.0,0.0
25321,Saf,7813,0,7813,2019.csv,2019,0.0,1.0
25322,A Moving Image,7807,0,7807,2017.csv,2017,0.0,1.0
25323,Show Me The Picture: The Story of Jim Marshall,7806,0,7806,2020.csv,2020,0.0,1.0
25324,Il flauto magico di Piazza Vittorio,7796,0,7796,2019.csv,2019,0.0,1.0
25325,Archipelago 2014 Re-release,7791,7791,0,2014.csv,2014,1.0,0.0
25326,Dreaming Grand Avenue,7789,7789,0,2020.csv,2020,1.0,0.0
25327,Na svete zhivut dobrye i khoroshie lyudi,7786,0,7786,2010.csv,2010,0.0,1.0
25328,Yellow River Aria,7776,0,7776,2016.csv,2016,0.0,1.0
25329,Il colore del vento,7775,0,7775,2011.csv,2011,0.0,1.0
25330,The Plagiarists,7768,7768,0,2019.csv,2019,1.0,0.0
25331,Old Stone,7768,7476,292,2016.csv,2016,0.962409886714727,0.03759011328527292
25332,The Lonely Battle of Thomas Reid,7768,0,7768,2018.csv,2018,0.0,1.0
25333,Big Jato,7765,0,7765,2016.csv,2016,0.0,1.0
25334,Touchless,7755,0,7755,2013.csv,2013,0.0,1.0
25335,And While We Were Here,7750,7750,0,2013.csv,2013,1.0,0.0
25336,Come Back to Me,7744,7744,0,2014.csv,2014,1.0,0.0
25337,Giulia Doesn't Date at Night 2011 Re-release,7743,0,7743,2011.csv,2011,0.0,1.0
25338,Eliza Lynch: Queen of Paraguay,7741,0,7741,2016.csv,2016,0.0,1.0
25339,Young Ones,7740,0,7740,2014.csv,2014,0.0,1.0
25340,Idiots and Angels 2010 Re-release,7739,0,7739,2010.csv,2010,0.0,1.0
25341,Saakshyam,7737,0,7737,2018.csv,2018,0.0,1.0
25342,España dividida: La Guerra Civil en color,7727,0,7727,2016.csv,2016,0.0,1.0
25343,Strange Colours,7725,0,7725,2018.csv,2018,0.0,1.0
25344,Scarlet Innocence,7713,0,7713,2015.csv,2015,0.0,1.0
25345,Moments,7711,0,7711,2018.csv,2018,0.0,1.0
25346,At Ellen's Age,7710,0,7710,2012.csv,2012,0.0,1.0
25347,Gregory's Girl,7710,7710,0,2019.csv,2019,1.0,0.0
25348,Maurizio Cattelan: Be Right Back,7706,7706,0,2017.csv,2017,1.0,0.0
25349,Taksim Hold'em,7703,0,7703,2018.csv,2018,0.0,1.0
25350,I Don't Belong Anywhere: The Cinema of Chantal Akerman,7703,7703,0,2016.csv,2016,1.0,0.0
25351,The House Next Door,7699,0,7699,2017.csv,2017,0.0,1.0
25352,The White Sound 2011 Re-release,7698,0,7698,2011.csv,2011,0.0,1.0
25353,The Old Woman at the Back,7687,0,7687,2011.csv,2011,0.0,1.0
25354,Poraali,7684,0,7684,2011.csv,2011,0.0,1.0
25355,I Believe 2020 Re-release,7677,0,7677,2020.csv,2020,0.0,1.0
25356,Res publica,7675,0,7675,2010.csv,2010,0.0,1.0
25357,Running Shaadi,7674,0,7674,2017.csv,2017,0.0,1.0
25358,Valley Girl,7671,0,7671,2020.csv,2020,0.0,1.0
25359,The Sound Story,7669,0,7669,2019.csv,2019,0.0,1.0
25360,The Last Projectionist,7664,0,7664,2012.csv,2012,0.0,1.0
25361,País do Desejo,7663,0,7663,2013.csv,2013,0.0,1.0
25362,Struggle for Life 2017 Re-release,7663,0,7663,2017.csv,2017,0.0,1.0
25363,A Long Farewell,7661,0,7661,2018.csv,2018,0.0,1.0
25364,Califórnia,7659,0,7659,2015.csv,2015,0.0,1.0
25365,Anatoly Krupnov. He Was,7659,0,7659,2019.csv,2019,0.0,1.0
25366,A Change in the Weather,7657,0,7657,2017.csv,2017,0.0,1.0
25367,10 Years 2014 Re-release,7648,0,7648,2014.csv,2014,0.0,1.0
25368,Nobody's Daughter Haewon,7646,0,7646,2013.csv,2013,0.0,1.0
25369,Last Days Here,7643,7643,0,2012.csv,2012,1.0,0.0
25370,Goal! III,7641,0,7641,2010.csv,2010,0.0,1.0
25371,Little DJ: Chiisana koi no monogatari,7641,0,7641,2010.csv,2010,0.0,1.0
25372,Legend of the Mountain,7640,7640,0,2018.csv,2018,1.0,0.0
25373,Siv sover vilse,7638,0,7638,2016.csv,2016,0.0,1.0
25374,The High Pressures,7634,0,7634,2015.csv,2015,0.0,1.0
25375,Kaç Kaçabilirsen,7634,0,7634,2018.csv,2018,0.0,1.0
25376,Shimal Ya Dunia,7634,0,7634,2013.csv,2013,0.0,1.0
25377,Journey to a Mother's Room,7632,0,7632,2019.csv,2019,0.0,1.0
25378,First Law,7631,0,7631,2017.csv,2017,0.0,1.0
25379,Beaten Black and Blue,7630,0,7630,2016.csv,2016,0.0,1.0
25380,A Prairie Home Companion 2010 Re-release,7630,0,7630,2010.csv,2010,0.0,1.0
25381,Insan Hayawan Chay',7628,0,7628,2014.csv,2014,0.0,1.0
25382,Stanley a Man of Variety,7619,0,7619,2018.csv,2018,0.0,1.0
25383,Necronomicón,7617,0,7617,2017.csv,2017,0.0,1.0
25384,Echoes of War,7615,0,7615,2016.csv,2016,0.0,1.0
25385,Psycho Raman,7612,0,7612,2016.csv,2016,0.0,1.0
25386,Vater Morgana,7609,0,7609,2010.csv,2010,0.0,1.0
25387,Slatin Pasha: On Her Majesty's Service,7601,0,7601,2012.csv,2012,0.0,1.0
25388,"Pettson, Findus ja mälukaotus",7600,0,7600,2010.csv,2010,0.0,1.0
25389,Look Back in Anger,7593,0,7593,2018.csv,2018,0.0,1.0
25390,Ayla,7592,0,7592,2010.csv,2010,0.0,1.0
25391,"DC Super Hero Girls: Dude, Where's My Invisible Jet?",7587,0,7587,2016.csv,2016,0.0,1.0
25392,Nice Shorts,7582,0,7582,2010.csv,2010,0.0,1.0
25393,Metal Heart,7582,0,7582,2019.csv,2019,0.0,1.0
25394,Ya Baada,7582,0,7582,2021.csv,2021,0.0,1.0
25395,Romance De Formacao,7581,0,7581,2012.csv,2012,0.0,1.0
25396,Dugun Dernek 3,7580,0,7580,2017.csv,2017,0.0,1.0
25397,When Harry Met Sally... 2015 Re-release,7578,0,7578,2015.csv,2015,0.0,1.0
25398,Prophecy,7577,0,7577,2019.csv,2019,0.0,1.0
25399,Al Jawla Al Akheera,7570,0,7570,2017.csv,2017,0.0,1.0
25400,Habibie & Ainun,7562,0,7562,2013.csv,2013,0.0,1.0
25401,Baskavígin,7558,0,7558,2016.csv,2016,0.0,1.0
25402,Amateurs,7557,0,7557,2018.csv,2018,0.0,1.0
25403,Area 51,7556,7556,0,2015.csv,2015,1.0,0.0
25404,Ali: Fear Eats the Soul,7554,0,7554,2017.csv,2017,0.0,1.0
25405,The Wrong Light,7553,7553,0,2017.csv,2017,1.0,0.0
25406,Street of Shame,7549,0,7549,2017.csv,2017,0.0,1.0
25407,Paddington 2020 Re-release,7548,0,7548,2020.csv,2020,0.0,1.0
25408,33 Postcards,7547,0,7547,2011.csv,2011,0.0,1.0
25409,The Goonies 2011 Re-release,7542,0,7542,2011.csv,2011,0.0,1.0
25410,Ferris Bueller's Day Off 2020 Re-release,7538,0,7538,2020.csv,2020,0.0,1.0
25411,Trampolim do Forte,7537,0,7537,2013.csv,2013,0.0,1.0
25412,Train Driver's Diary,7536,0,7536,2017.csv,2017,0.0,1.0
25413,Fátima no Mundo,7536,0,7536,2014.csv,2014,0.0,1.0
25414,Tales from the Script,7535,7535,0,2010.csv,2010,1.0,0.0
25415,Restaurant Makeover: De Great Iron Pot,7529,0,7529,2016.csv,2016,0.0,1.0
25416,Girls Against Boys,7529,7529,0,2013.csv,2013,1.0,0.0
25417,Medici con l'Africa,7528,0,7528,2012.csv,2012,0.0,1.0
25418,Nina Forever,7528,0,7528,2016.csv,2016,0.0,1.0
25419,WiNWiN,7527,0,7527,2016.csv,2016,0.0,1.0
25420,O Outro Lado do Paraíso,7527,0,7527,2016.csv,2016,0.0,1.0
25421,4 Days in May 2013 Re-release,7521,0,7521,2013.csv,2013,0.0,1.0
25422,Birthright: A War Story,7519,7519,0,2017.csv,2017,1.0,0.0
25423,All the Beauty,7519,0,7519,2016.csv,2016,0.0,1.0
25424,The Search 2019 Re-release,7517,0,7517,2019.csv,2019,0.0,1.0
25425,Marudhu,7514,0,7514,2016.csv,2016,0.0,1.0
25426,Rabbit Woman,7510,0,7510,2013.csv,2013,0.0,1.0
25427,Limelight,7506,0,7506,2018.csv,2018,0.0,1.0
25428,Winter Flies,7500,0,7500,2018.csv,2018,0.0,1.0
25429,"My Love, Don't Cross That River 2020 Re-release",7499,0,7499,2020.csv,2020,0.0,1.0
25430,Life in Movement,7494,0,7494,2012.csv,2012,0.0,1.0
25431,La vacanza,7494,0,7494,2020.csv,2020,0.0,1.0
25432,Handle with Care 2018 Re-release,7490,0,7490,2018.csv,2018,0.0,1.0
25433,8 Dates 2010 Re-release,7488,0,7488,2010.csv,2010,0.0,1.0
25434,Sheeple,7474,0,7474,2019.csv,2019,0.0,1.0
25435,Any Day,7469,0,7469,2015.csv,2015,0.0,1.0
25436,La maleta mexicana,7466,0,7466,2011.csv,2011,0.0,1.0
25437,Udaan,7461,7461,0,2010.csv,2010,1.0,0.0
25438,Weekend,7458,0,7458,2017.csv,2017,0.0,1.0
25439,Poker Night,7457,0,7457,2015.csv,2015,0.0,1.0
25440,Scott and Sid,7457,0,7457,2018.csv,2018,0.0,1.0
25441,Liar Game: Reborn 2013 Re-release,7446,0,7446,2013.csv,2013,0.0,1.0
25442,Get Out 2018 Re-release,7445,0,7445,2016.csv,2016,0.0,1.0
25443,The Little Bedroom 2014 Re-release,7440,7440,0,2014.csv,2014,1.0,0.0
25444,Outlaw,7440,0,7440,2020.csv,2020,0.0,1.0
25445,Boarding School,7438,0,7438,2018.csv,2018,0.0,1.0
25446,Where I Belong,7436,0,7436,2013.csv,2013,0.0,1.0
25447,Southwest,7433,0,7433,2012.csv,2012,0.0,1.0
25448,The Secret Board,7432,0,7432,2018.csv,2018,0.0,1.0
25449,Raze,7429,7429,0,2014.csv,2014,1.0,0.0
25450,Virality,7426,0,7426,2017.csv,2017,0.0,1.0
25451,Bel Borba Aqui,7426,7426,0,2012.csv,2012,1.0,0.0
25452,Die Lust der Frauen,7423,0,7423,2011.csv,2011,0.0,1.0
25453,State of Violence,7420,0,7420,2011.csv,2011,0.0,1.0
25454,Rubble Kings,7416,7416,0,2015.csv,2015,1.0,0.0
25455,Price Check,7413,7413,0,2012.csv,2012,1.0,0.0
25456,Fevereiros,7413,0,7413,2018.csv,2018,0.0,1.0
25457,29 February 2012 Re-release,7406,0,7406,2012.csv,2012,0.0,1.0
25458,Come On Murderer: The Legendary Thief,7402,0,7402,2017.csv,2017,0.0,1.0
25459,The Giant Mechanical Man,7396,7396,0,2012.csv,2012,1.0,0.0
25460,Codename 'Holec',7393,0,7393,2016.csv,2016,0.0,1.0
25461,The Beaches of Agnès 2012 Re-release,7392,0,7392,2012.csv,2012,0.0,1.0
25462,Viernes de Soltero,7392,0,7392,2018.csv,2018,0.0,1.0
25463,To Life 2016 Re-release,7389,0,7389,2016.csv,2016,0.0,1.0
25464,Colao,7389,0,7389,2018.csv,2018,0.0,1.0
25465,The Other Lamb,7385,6024,1361,2020.csv,2020,0.8157075152335815,0.1842924847664184
25466,A Deal with the Universe,7381,0,7381,2019.csv,2019,0.0,1.0
25467,Honey Money,7378,0,7378,2016.csv,2016,0.0,1.0
25468,Anukta,7377,0,7377,2019.csv,2019,0.0,1.0
25469,A Queen Is Crowned,7373,0,7373,2012.csv,2012,0.0,1.0
25470,The Metropolitan Opera HD Live: Verdi: Don Carlo 2011 Re-release,7373,0,7373,2011.csv,2011,0.0,1.0
25471,Desperate Acts of Magic,7373,7373,0,2013.csv,2013,1.0,0.0
25472,Benjamin Britten: Peace and Conflict,7371,0,7371,2013.csv,2013,0.0,1.0
25473,901 kilometr,7369,0,7369,2012.csv,2012,0.0,1.0
25474,Away,7367,0,7367,2020.csv,2020,0.0,1.0
25475,Dogtooth 2018 Re-release,7367,0,7367,2018.csv,2018,0.0,1.0
25476,B.O.K.: Bi O Kalmisti,7366,0,7366,2016.csv,2016,0.0,1.0
25477,Tokyo Ghoul: 'S',7365,0,7365,2019.csv,2019,0.0,1.0
25478,Liquid Gold,7365,0,7365,2019.csv,2019,0.0,1.0
25479,100,7365,0,7365,2019.csv,2019,0.0,1.0
25480,Haze,7356,0,7356,2010.csv,2010,0.0,1.0
25481,Big Time,7347,7347,0,2017.csv,2017,1.0,0.0
25482,Hammer of the Gods,7343,641,6702,2013.csv,2013,0.0872940215170911,0.9127059784829089
25483,Anchors Up: Boat to the Rescue,7338,0,7338,2017.csv,2017,0.0,1.0
25484,Körfez,7337,0,7337,2017.csv,2017,0.0,1.0
25485,Bogowie 2016 Re-release,7336,0,7336,2016.csv,2016,0.0,1.0
25486,Wake Me Up,7328,0,7328,2017.csv,2017,0.0,1.0
25487,Shoah: Four Sisters,7323,7323,0,2018.csv,2018,1.0,0.0
25488,Kurukshetra,7320,0,7320,2019.csv,2019,0.0,1.0
25489,Dreamfish,7318,0,7318,2016.csv,2016,0.0,1.0
25490,Girl with No Mouth,7316,0,7316,2020.csv,2020,0.0,1.0
25491,Urumi: The Warriors Who Wanted to Kill Vasco Da Gama,7315,0,7315,2011.csv,2011,0.0,1.0
25492,Urban Evil 2,7313,0,7313,2020.csv,2020,0.0,1.0
25493,Climbing Blind,7301,0,7301,2020.csv,2020,0.0,1.0
25494,Beloved Beast,7301,7301,0,2019.csv,2019,1.0,0.0
25495,Once in Trubchevsk,7301,0,7301,2019.csv,2019,0.0,1.0
25496,The Big Bang 2012 Re-release,7300,0,7300,2012.csv,2012,0.0,1.0
25497,The Culling,7295,0,7295,2015.csv,2015,0.0,1.0
25498,Gangster's Paradise: Jerusalema 2010 Re-release,7294,7294,0,2010.csv,2010,1.0,0.0
25499,The Camino Voyage,7291,0,7291,2018.csv,2018,0.0,1.0
25500,Red Sky,7289,0,7289,2014.csv,2014,0.0,1.0
25501,Another WolfCop,7285,7285,0,2017.csv,2017,1.0,0.0
25502,The Broken 2017 Re-release,7284,0,7284,2017.csv,2017,0.0,1.0
25503,Tea With the Dames 2019 Re-release,7282,0,7282,2019.csv,2019,0.0,1.0
25504,Headshots,7280,0,7280,2012.csv,2012,0.0,1.0
25505,The Green Cat,7280,0,7280,2019.csv,2019,0.0,1.0
25506,Bangalore Naatkal,7279,0,7279,2016.csv,2016,0.0,1.0
25507,Wedding Palace 2014 Re-release,7275,0,7275,2014.csv,2014,0.0,1.0
25508,Cinzento e Negro,7274,0,7274,2016.csv,2016,0.0,1.0
25509,Il mercante di stoffe,7272,0,7272,2011.csv,2011,0.0,1.0
25510,A Chinese Odyssey: Part Two - Cinderella,7271,0,7271,2010.csv,2010,0.0,1.0
25511,Tres Dias,7269,0,7269,2011.csv,2011,0.0,1.0
25512,Snap,7263,0,7263,2011.csv,2011,0.0,1.0
25513,"Hochelaga, Land of Souls",7262,0,7262,2019.csv,2019,0.0,1.0
25514,Valle de Lobos,7262,0,7262,2019.csv,2019,0.0,1.0
25515,Velainu Vandhutta Vellaikaaran,7253,0,7253,2016.csv,2016,0.0,1.0
25516,Hiroshima,7251,0,7251,2010.csv,2010,0.0,1.0
25517,Indian Point,7251,7251,0,2016.csv,2016,1.0,0.0
25518,In the Life of Music,7238,7238,0,2020.csv,2020,1.0,0.0
25519,Surviving Life (Theory and Practice),7234,0,7234,2010.csv,2010,0.0,1.0
25520,The Deflowering of Eva van End,7232,0,7232,2015.csv,2015,0.0,1.0
25521,Angelita la doctora,7230,0,7230,2016.csv,2016,0.0,1.0
25522,Where Do We Go from Here?,7229,0,7229,2018.csv,2018,0.0,1.0
25523,Little Crusader,7228,0,7228,2017.csv,2017,0.0,1.0
25524,Outside Satan,7226,0,7226,2013.csv,2013,0.0,1.0
25525,Hirugao 2019 Re-release,7219,0,7219,2019.csv,2019,0.0,1.0
25526,Tall: The American Skyscraper and Louis Sullivan,7216,7216,0,2018.csv,2018,1.0,0.0
25527,Magari (If Only),7212,0,7212,2020.csv,2020,0.0,1.0
25528,I Am Ali,7205,7205,0,2014.csv,2014,1.0,0.0
25529,Inland Empire 2010 Re-release,7204,0,7204,2010.csv,2010,0.0,1.0
25530,Bibliothèque Pascal 2013 Re-release,7200,0,7200,2013.csv,2013,0.0,1.0
25531,Las voces 2015 Re-release,7200,0,7200,2015.csv,2015,0.0,1.0
25532,London River 2011 Re-release,7200,7200,0,2011.csv,2011,1.0,0.0
25533,Summer Interlude,7200,0,7200,2017.csv,2017,0.0,1.0
25534,Happiness Runs,7199,7199,0,2010.csv,2010,1.0,0.0
25535,Nokia Mobile: We Were Connecting People,7194,0,7194,2017.csv,2017,0.0,1.0
25536,Zapashny Brothers' Show,7193,0,7193,2016.csv,2016,0.0,1.0
25537,Antarctic Edge: 70° South,7193,7193,0,2015.csv,2015,1.0,0.0
25538,Detachment 2013 Re-release,7189,0,7189,2013.csv,2013,0.0,1.0
25539,Moulin Rouge! 2020 Re-release,7185,0,7185,2020.csv,2020,0.0,1.0
25540,Bekarliga Feda,7185,0,7185,2019.csv,2019,0.0,1.0
25541,Belmonte,7184,0,7184,2018.csv,2018,0.0,1.0
25542,The Strange Color of Your Body's Tears,7182,7182,0,2014.csv,2014,1.0,0.0
25543,February,7179,0,7179,2019.csv,2019,0.0,1.0
25544,The Delivered,7176,0,7176,2021.csv,2021,0.0,1.0
25545,ABCs of Death 2,7171,7171,0,2014.csv,2014,1.0,0.0
25546,Ni à vendre ni à louer,7170,0,7170,2011.csv,2011,0.0,1.0
25547,Villa Touma,7170,0,7170,2015.csv,2015,0.0,1.0
25548,It Had to Be You,7162,7162,0,2016.csv,2016,1.0,0.0
25549,Urbanized,7154,0,7154,2012.csv,2012,0.0,1.0
25550,"Kostis Papagiorgis, the Sweetest Misanthrope",7154,0,7154,2018.csv,2018,0.0,1.0
25551,Bachaana,7149,0,7149,2016.csv,2016,0.0,1.0
25552,La muerte de Marga Maier,7148,0,7148,2017.csv,2017,0.0,1.0
25553,Beyond a Reasonable Doubt 2012 Re-release,7144,0,7144,2012.csv,2012,0.0,1.0
25554,"Brutti, sporchi e cattivi",7144,7144,0,2016.csv,2016,1.0,0.0
25555,Red Gloves,7139,0,7139,2011.csv,2011,0.0,1.0
25556,Logan,7137,7137,0,2010.csv,2010,1.0,0.0
25557,A Bullet for Sandoval,7132,0,7132,2012.csv,2012,0.0,1.0
25558,Mot naturen,7131,0,7131,2016.csv,2016,0.0,1.0
25559,Rise of the Superheroes,7130,0,7130,2019.csv,2019,0.0,1.0
25560,This Mountain Life,7129,0,7129,2019.csv,2019,0.0,1.0
25561,Oopiri,7124,0,7124,2016.csv,2016,0.0,1.0
25562,Cam Yarmasi,7120,0,7120,2017.csv,2017,0.0,1.0
25563,Óli Prik,7118,0,7118,2015.csv,2015,0.0,1.0
25564,Mandharam,7115,0,7115,2018.csv,2018,0.0,1.0
25565,Last Year at Marienbad 2011 Re-release,7115,0,7115,2011.csv,2011,0.0,1.0
25566,The Reagan Show,7109,5500,1609,2017.csv,2017,0.7736671824447883,0.2263328175552117
25567,Yaara Ve,7106,0,7106,2019.csv,2019,0.0,1.0
25568,Domain 2012 Re-release,7105,7105,0,2012.csv,2012,1.0,0.0
25569,The Jazz Funeral,7103,7103,0,2017.csv,2017,1.0,0.0
25570,Anina provizija,7096,0,7096,2017.csv,2017,0.0,1.0
25571,The Dark Below,7095,7095,0,2017.csv,2017,1.0,0.0
25572,Winter Light,7095,0,7095,2017.csv,2017,0.0,1.0
25573,Pup 2015 Re-release,7089,0,7089,2015.csv,2015,0.0,1.0
25574,I Carried You Home,7086,0,7086,2012.csv,2012,0.0,1.0
25575,Rapiscimi,7086,0,7086,2019.csv,2019,0.0,1.0
25576,"Italy: Love It, or Leave It",7085,0,7085,2012.csv,2012,0.0,1.0
25577,Painless,7082,7082,0,2018.csv,2018,1.0,0.0
25578,Latch,7079,0,7079,2013.csv,2013,0.0,1.0
25579,Stage Fright,7078,7078,0,2014.csv,2014,1.0,0.0
25580,Romeos 2013 Re-release,7076,0,7076,2013.csv,2013,0.0,1.0
25581,Red Desert,7076,0,7076,2012.csv,2012,0.0,1.0
25582,La Scala: The Thieving Magpie,7074,0,7074,2017.csv,2017,0.0,1.0
25583,Good Neighbours,7072,7072,0,2011.csv,2011,1.0,0.0
25584,In Echo Park,7072,7072,0,2018.csv,2018,1.0,0.0
25585,Manzelske Etudy: Nova Generace,7071,0,7071,2019.csv,2019,0.0,1.0
25586,An Alan Smithee Film: Burn Hollywood Burn 2011 Re-release,7071,0,7071,2011.csv,2011,0.0,1.0
25587,D-Day Assassins,7059,0,7059,2019.csv,2019,0.0,1.0
25588,Ibiza Occident,7055,0,7055,2012.csv,2012,0.0,1.0
25589,The Forest Monster,7053,0,7053,2019.csv,2019,0.0,1.0
25590,Dios Me Libre,7051,0,7051,2012.csv,2012,0.0,1.0
25591,Zashchitniki,7049,0,7049,2016.csv,2016,0.0,1.0
25592,Contract to Kill,7048,0,7048,2019.csv,2019,0.0,1.0
25593,Blood Money 2017 Re-release,7042,0,7042,2017.csv,2017,0.0,1.0
25594,The Spearhead Effect,7042,0,7042,2018.csv,2018,0.0,1.0
25595,You All Are Captains,7042,0,7042,2011.csv,2011,0.0,1.0
25596,Petty Letters and Love Crimes 2012 Re-release,7040,0,7040,2012.csv,2012,0.0,1.0
25597,The Sixth Day,7039,0,7039,2013.csv,2013,0.0,1.0
25598,Away from the shore,7038,0,7038,2019.csv,2019,0.0,1.0
25599,Mathu Vadalara,7035,0,7035,2019.csv,2019,0.0,1.0
25600,"Profilers, Gaze Into the Abyss",7035,0,7035,2014.csv,2014,0.0,1.0
25601,"Mudar de Vida - José Mário Branco, vida e obra",7035,0,7035,2016.csv,2016,0.0,1.0
25602,Hit the Night,7028,0,7028,2018.csv,2018,0.0,1.0
25603,The Brainwashing of My Dad,7028,7028,0,2016.csv,2016,1.0,0.0
25604,Life Goes On,7025,0,7025,2011.csv,2011,0.0,1.0
25605,I della sua vita children,7025,0,7025,2011.csv,2011,0.0,1.0
25606,Guardians of Time Lost,7022,0,7022,2015.csv,2015,0.0,1.0
25607,Breaking & Exiting,7018,0,7018,2019.csv,2019,0.0,1.0
25608,BBC Proms: Prom 47: Brahms Night with Bernard Haitink and Emanuel Ax,7017,0,7017,2011.csv,2011,0.0,1.0
25609,In the Same Boat 2019 Re-release,7016,0,7016,2019.csv,2019,0.0,1.0
25610,In the Land of Pomegranates,7014,7014,0,2018.csv,2018,1.0,0.0
25611,El camino más largo,7013,0,7013,2016.csv,2016,0.0,1.0
25612,Punk Never Ends!,7009,0,7009,2019.csv,2019,0.0,1.0
25613,The Incredible 25th Year of Mitzi Bearclaw,7001,7001,0,2021.csv,2021,1.0,0.0
25614,Corman's World: Exploits of a Hollywood Rebel,7000,7000,0,2011.csv,2011,1.0,0.0
25615,Fishing and Fishermen's Conversations,6998,0,6998,2020.csv,2020,0.0,1.0
25616,The Brass Teapot,6997,6997,0,2013.csv,2013,1.0,0.0
25617,Just a Gigolo,6994,0,6994,2020.csv,2020,0.0,1.0
25618,I Am Lisa,6986,6986,0,2020.csv,2020,1.0,0.0
25619,The Anderssons Rock the Mountains 2016 Re-release,6982,0,6982,2016.csv,2016,0.0,1.0
25620,Kaleidoscope,6980,0,6980,2017.csv,2017,0.0,1.0
25621,What We Found,6976,6976,0,2020.csv,2020,1.0,0.0
25622,The Secret of a Leader,6965,0,6965,2019.csv,2019,0.0,1.0
25623,Tears of the Yang-Tse,6962,0,6962,2017.csv,2017,0.0,1.0
25624,The Clapper,6961,0,6961,2018.csv,2018,0.0,1.0
25625,Annanukku Jey,6961,0,6961,2018.csv,2018,0.0,1.0
25626,Gabriel,6959,6959,0,2015.csv,2015,1.0,0.0
25627,Henry,6957,0,6957,2012.csv,2012,0.0,1.0
25628,Sita,6954,0,6954,2019.csv,2019,0.0,1.0
25629,Dusk,6952,0,6952,2014.csv,2014,0.0,1.0
25630,A Caretaker's Tale,6950,0,6950,2012.csv,2012,0.0,1.0
25631,You & I,6950,0,6950,2015.csv,2015,0.0,1.0
25632,"Love, Marilyn",6950,6950,0,2012.csv,2012,1.0,0.0
25633,Iraqi Odyssey,6949,0,6949,2015.csv,2015,0.0,1.0
25634,A Batalha do Passinho: O Filme,6945,0,6945,2013.csv,2013,0.0,1.0
25635,Angry Indian Goddesses 2017 Re-release,6940,0,6940,2017.csv,2017,0.0,1.0
25636,Dua Et Kardesiz,6937,0,6937,2018.csv,2018,0.0,1.0
25637,The Trap 2010 Re-release,6933,0,6933,2010.csv,2010,0.0,1.0
25638,Seahorse,6933,0,6933,2019.csv,2019,0.0,1.0
25639,The Blue Wave,6925,0,6925,2014.csv,2014,0.0,1.0
25640,No Fathers in Kashmir,6919,0,6919,2020.csv,2020,0.0,1.0
25641,The Philadelphia Story 2016 Re-release,6918,0,6918,2016.csv,2016,0.0,1.0
25642,A Kind of Loving,6912,6912,0,2017.csv,2017,1.0,0.0
25643,Avant,6910,0,6910,2014.csv,2014,0.0,1.0
25644,To Kill a Mockingbird 2017 Re-release,6909,0,6909,2017.csv,2017,0.0,1.0
25645,Gres? Grem!,6909,0,6909,2019.csv,2019,0.0,1.0
25646,Assaulted: Civil Rights Under Fire,6905,6905,0,2013.csv,2013,1.0,0.0
25647,The Map to Paradise,6902,0,6902,2019.csv,2019,0.0,1.0
25648,Bastards y Diablos,6898,0,6898,2018.csv,2018,0.0,1.0
25649,Trading Paint,6898,0,6898,2019.csv,2019,0.0,1.0
25650,Boom Bust Boom,6896,6896,0,2016.csv,2016,1.0,0.0
25651,Eu Sou Carlos Imperial,6896,0,6896,2016.csv,2016,0.0,1.0
25652,The Magician,6895,0,6895,2014.csv,2014,0.0,1.0
25653,Victoria,6893,0,6893,2015.csv,2015,0.0,1.0
25654,Phullu,6893,0,6893,2017.csv,2017,0.0,1.0
25655,Khun Phaen Begins,6892,0,6892,2019.csv,2019,0.0,1.0
25656,The Butterfly Tree,6892,0,6892,2018.csv,2018,0.0,1.0
25657,Misconceptions,6892,6892,0,2010.csv,2010,1.0,0.0
25658,Todo sobre el asado,6892,0,6892,2017.csv,2017,0.0,1.0
25659,La petite Jérusalem 2011 Re-release,6890,0,6890,2011.csv,2011,0.0,1.0
25660,The Aristocats 2012 Re-release,6885,0,6885,2012.csv,2012,0.0,1.0
25661,Sound of Morocco,6885,0,6885,2011.csv,2011,0.0,1.0
25662,Sal,6883,6883,0,2013.csv,2013,1.0,0.0
25663,The Human Scale,6878,6878,0,2013.csv,2013,1.0,0.0
25664,Duck Butter,6877,6877,0,2018.csv,2018,1.0,0.0
25665,Castaway on the Moon 2010 Re-release,6872,0,6872,2010.csv,2010,0.0,1.0
25666,The Sisterhood of Night,6870,6870,0,2015.csv,2015,1.0,0.0
25667,The Last Summer of La Boyita 2013 Re-release,6869,0,6869,2013.csv,2013,0.0,1.0
25668,George Reddy,6862,0,6862,2019.csv,2019,0.0,1.0
25669,Doktor Proktors tidsbadekar 2018 Re-release,6858,0,6858,2018.csv,2018,0.0,1.0
25670,Last Ride 2012 Re-release,6853,6853,0,2012.csv,2012,1.0,0.0
25671,La niña de tacones amarillos,6850,0,6850,2016.csv,2016,0.0,1.0
25672,Sombras del demonio,6843,0,6843,2019.csv,2019,0.0,1.0
25673,The Swell Season,6842,0,6842,2012.csv,2012,0.0,1.0
25674,Corridor 2013 Re-release,6842,0,6842,2013.csv,2013,0.0,1.0
25675,Janie Jones,6840,6840,0,2011.csv,2011,1.0,0.0
25676,The Rape of Recy Taylor,6828,0,6828,2018.csv,2018,0.0,1.0
25677,Mad Tiger,6823,6823,0,2016.csv,2016,1.0,0.0
25678,12 Hour Shift,6820,6820,0,2020.csv,2020,1.0,0.0
25679,Silent Night 2018 Re-release,6816,0,6816,2018.csv,2018,0.0,1.0
25680,Stop Making Sense 2017 Re-release,6813,0,6813,2017.csv,2017,0.0,1.0
25681,Sideway,6810,0,6810,2018.csv,2018,0.0,1.0
25682,The Berlin File 2014 Re-release,6808,0,6808,2014.csv,2014,0.0,1.0
25683,Harry Birrell: Films of Love and War,6808,0,6808,2019.csv,2019,0.0,1.0
25684,Paltan,6807,0,6807,2018.csv,2018,0.0,1.0
25685,Until Porn Do Us Part,6804,0,6804,2019.csv,2019,0.0,1.0
25686,Crossroads,6797,0,6797,2013.csv,2013,0.0,1.0
25687,"No God, No Master",6796,6796,0,2014.csv,2014,1.0,0.0
25688,Daniel Sloss: X,6789,0,6789,2020.csv,2020,0.0,1.0
25689,Thor: Ragnarok 2020 Re-release,6785,0,6785,2020.csv,2020,0.0,1.0
25690,Finding Bliss,6783,6783,0,2010.csv,2010,1.0,0.0
25691,"Namaste Hello, Bye-Bye",6782,0,6782,2013.csv,2013,0.0,1.0
25692,Mercy,6780,6780,0,2010.csv,2010,1.0,0.0
25693,Gebo and the Shadow,6780,0,6780,2014.csv,2014,0.0,1.0
25694,On the wave,6780,0,6780,2019.csv,2019,0.0,1.0
25695,Kurmaiyan,6779,0,6779,2018.csv,2018,0.0,1.0
25696,Christian Brothers,6775,0,6775,2011.csv,2011,0.0,1.0
25697,Með hangandi hendi,6775,0,6775,2010.csv,2010,0.0,1.0
25698,The Black Hen,6771,0,6771,2016.csv,2016,0.0,1.0
25699,Vourate Geitonoi,6764,0,6764,2019.csv,2019,0.0,1.0
25700,Going Attractions: The Definitive Story of the Movie Palace,6763,6763,0,2019.csv,2019,1.0,0.0
25701,Godless,6763,0,6763,2017.csv,2017,0.0,1.0
25702,Red Flowers and Green Leaves,6757,0,6757,2019.csv,2019,0.0,1.0
25703,Windjammer: The Voyage of the Christian Radich,6757,0,6757,2018.csv,2018,0.0,1.0
25704,Calling All Earthlings,6756,6756,0,2018.csv,2018,1.0,0.0
25705,Dying to Survive 2019 Re-release,6752,6752,0,2019.csv,2019,1.0,0.0
25706,Djon Africa,6750,0,6750,2018.csv,2018,0.0,1.0
25707,A Whale of a Tale,6747,6747,0,2018.csv,2018,1.0,0.0
25708,The Reunion 2014 Re-release,6724,0,6724,2014.csv,2014,0.0,1.0
25709,Iceman,6719,2138,4581,2018.csv,2018,0.3182021134097336,0.6817978865902664
25710,"Lots of Kids, a Monkey and a Castle 2019 Re-release",6719,0,6719,2019.csv,2019,0.0,1.0
25711,Las voces,6719,0,6719,2012.csv,2012,0.0,1.0
25712,The First Swallows,6718,0,6718,2019.csv,2019,0.0,1.0
25713,Todavia,6718,0,6718,2018.csv,2018,0.0,1.0
25714,Before You Know It,6717,6717,0,2014.csv,2014,1.0,0.0
25715,Alemde 1 Gece,6716,0,6716,2016.csv,2016,0.0,1.0
25716,Steadiness,6714,0,6714,2014.csv,2014,0.0,1.0
25717,After Midnight,6713,0,6713,2020.csv,2020,0.0,1.0
25718,Sofía y el Terco,6712,0,6712,2013.csv,2013,0.0,1.0
25719,The International Player,6712,0,6712,2010.csv,2010,0.0,1.0
25720,Celeste,6707,0,6707,2019.csv,2019,0.0,1.0
25721,A Streetcar Named Desire 2020 Re-release,6705,0,6705,2020.csv,2020,0.0,1.0
25722,El Corral,6702,0,6702,2017.csv,2017,0.0,1.0
25723,Commando 2,6701,0,6701,2017.csv,2017,0.0,1.0
25724,Kamala,6701,0,6701,2019.csv,2019,0.0,1.0
25725,Rok,6698,0,6698,2017.csv,2017,0.0,1.0
25726,Lovely Louise,6697,0,6697,2014.csv,2014,0.0,1.0
25727,The End of the Line 2010 Re-release,6696,0,6696,2010.csv,2010,0.0,1.0
25728,8 1/2 2011 Re-release,6692,0,6692,2011.csv,2011,0.0,1.0
25729,Kuldip Patwal: I Didn't Do It!,6690,0,6690,2017.csv,2017,0.0,1.0
25730,A Tale of Springtime 2010 Re-release,6687,0,6687,2010.csv,2010,0.0,1.0
25731,Regina Spektor Live in London,6684,6684,0,2010.csv,2010,1.0,0.0
25732,Arabian Nights: Volume 3 - The Enchanted One,6681,4502,2179,2015.csv,2015,0.6738512198772639,0.3261487801227361
25733,'Der Müde Tod': Die Restaurierung eines frühen,6679,0,6679,2017.csv,2017,0.0,1.0
25734,Fastey Fasaatey,6676,0,6676,2019.csv,2019,0.0,1.0
25735,Plan B: Scheiß auf Plan A,6666,0,6666,2017.csv,2017,0.0,1.0
25736,Bons baisers de la Colonie,6664,0,6664,2012.csv,2012,0.0,1.0
25737,Remember Baghdad,6663,0,6663,2017.csv,2017,0.0,1.0
25738,Dog Soldiers 2020 Re-release,6663,0,6663,2020.csv,2020,0.0,1.0
25739,Shall We Dance 2010 Re-release,6662,0,6662,2010.csv,2010,0.0,1.0
25740,Footnotes 2017 Re-release,6660,6660,0,2017.csv,2017,1.0,0.0
25741,Parque vía 2010 Re-release,6659,0,6659,2010.csv,2010,0.0,1.0
25742,The United States vs. Billie Holiday,6658,0,6658,2021.csv,2021,0.0,1.0
25743,Aniceto 2011 Re-release,6658,0,6658,2011.csv,2011,0.0,1.0
25744,Ella and Friends 2 2015 Re-release,6656,0,6656,2015.csv,2015,0.0,1.0
25745,Kauwboy 2014 Re-release,6652,0,6652,2014.csv,2014,0.0,1.0
25746,Indak,6648,0,6648,2019.csv,2019,0.0,1.0
25747,Ghost Team,6639,6639,0,2016.csv,2016,1.0,0.0
25748,The Persian Connection,6634,6634,0,2017.csv,2017,1.0,0.0
25749,L'année prochaine,6631,0,6631,2015.csv,2015,0.0,1.0
25750,Bratrícek Karel,6629,0,6629,2016.csv,2016,0.0,1.0
25751,Kiki ile Miki Alatura,6629,0,6629,2017.csv,2017,0.0,1.0
25752,Breakfast with Curtis,6629,6629,0,2013.csv,2013,1.0,0.0
25753,The Dying of the Light,6627,6627,0,2016.csv,2016,1.0,0.0
25754,Star Men,6624,0,6624,2015.csv,2015,0.0,1.0
25755,Mezarlik,6618,0,6618,2018.csv,2018,0.0,1.0
25756,Botticelli Inferno 2018 Re-release,6618,0,6618,2018.csv,2018,0.0,1.0
25757,You've Been Trumped Too,6615,0,6615,2016.csv,2016,0.0,1.0
25758,Undertow,6613,0,6613,2020.csv,2020,0.0,1.0
25759,Kolachi,6603,0,6603,2011.csv,2011,0.0,1.0
25760,Aatsinki: The Story of Arctic Cowboys,6601,6601,0,2014.csv,2014,1.0,0.0
25761,Brief Reunion,6601,6601,0,2013.csv,2013,1.0,0.0
25762,Sahara in mir,6600,0,6600,2012.csv,2012,0.0,1.0
25763,The Cleaner,6598,0,6598,2015.csv,2015,0.0,1.0
25764,Human Capital,6596,6596,0,2020.csv,2020,1.0,0.0
25765,Piggies,6596,0,6596,2011.csv,2011,0.0,1.0
25766,Nosso Lar 2014 Re-release,6592,0,6592,2014.csv,2014,0.0,1.0
25767,Pompeya,6587,0,6587,2012.csv,2012,0.0,1.0
25768,Freetime Machos,6584,0,6584,2010.csv,2010,0.0,1.0
25769,Semper Fi,6584,0,6584,2020.csv,2020,0.0,1.0
25770,Dawn of Evil: Rise of the Reich,6584,0,6584,2010.csv,2010,0.0,1.0
25771,Most Beautiful Island,6582,0,6582,2017.csv,2017,0.0,1.0
25772,Khal El Mout,6581,0,6581,2019.csv,2019,0.0,1.0
25773,Last Vegas 2018 Re-release,6575,0,6575,2018.csv,2018,0.0,1.0
25774,I Came from Busan,6574,0,6574,2010.csv,2010,0.0,1.0
25775,Seven Days,6568,0,6568,2017.csv,2017,0.0,1.0
25776,Revolución,6564,0,6564,2011.csv,2011,0.0,1.0
25777,I am not Salvador,6559,0,6559,2016.csv,2016,0.0,1.0
25778,Down the Shore,6558,6558,0,2013.csv,2013,1.0,0.0
25779,Salvador Dali: The Quest for Immortality,6558,0,6558,2018.csv,2018,0.0,1.0
25780,Kadhalil Sodhappuvadhu Yeppadi,6558,0,6558,2012.csv,2012,0.0,1.0
25781,The Calling,6558,0,6558,2019.csv,2019,0.0,1.0
25782,Guys from Mars,6546,0,6546,2011.csv,2011,0.0,1.0
25783,21st Century Cinema Now,6545,0,6545,2010.csv,2010,0.0,1.0
25784,In Our Nature,6543,6543,0,2012.csv,2012,1.0,0.0
25785,Elizabeth Blue,6542,6542,0,2017.csv,2017,1.0,0.0
25786,Making Noise Quietly,6536,0,6536,2019.csv,2019,0.0,1.0
25787,The Anomaly 2017 Re-release,6536,0,6536,2017.csv,2017,0.0,1.0
25788,Fist With Great Ambition,6534,0,6534,2019.csv,2019,0.0,1.0
25789,Dream Boy,6534,6534,0,2010.csv,2010,1.0,0.0
25790,Panama,6527,0,6527,2016.csv,2016,0.0,1.0
25791,I Just Didn't Do It 2010 Re-release,6525,0,6525,2010.csv,2010,0.0,1.0
25792,Marry Me - Aber bitte auf Indisch,6523,0,6523,2015.csv,2015,0.0,1.0
25793,Spiral Farm,6517,6517,0,2019.csv,2019,1.0,0.0
25794,Pooch Portraits,6515,0,6515,2011.csv,2011,0.0,1.0
25795,Neeya 2,6514,0,6514,2019.csv,2019,0.0,1.0
25796,Sari siyah,6512,0,6512,2013.csv,2013,0.0,1.0
25797,Patient,6509,0,6509,2016.csv,2016,0.0,1.0
25798,Horse Money,6508,6508,0,2015.csv,2015,1.0,0.0
25799,People That Are Not Me,6507,0,6507,2017.csv,2017,0.0,1.0
25800,Jews of Egypt,6505,6505,0,2014.csv,2014,1.0,0.0
25801,Windfall,6504,6504,0,2012.csv,2012,1.0,0.0
25802,Bioscopewala,6501,0,6501,2018.csv,2018,0.0,1.0
25803,Ride,6489,0,6489,2015.csv,2015,0.0,1.0
25804,The Sky Trembles and the Earth Is Afraid and the Two Eyes Are Not Brothers,6487,0,6487,2016.csv,2016,0.0,1.0
25805,Back to Berlin,6485,0,6485,2018.csv,2018,0.0,1.0
25806,Mari,6484,0,6484,2019.csv,2019,0.0,1.0
25807,All Good Children,6483,0,6483,2010.csv,2010,0.0,1.0
25808,Thien Su Khong Phep Mau,6482,0,6482,2019.csv,2019,0.0,1.0
25809,Attacking the Devil,6481,0,6481,2016.csv,2016,0.0,1.0
25810,The Beat Hotel,6480,6480,0,2012.csv,2012,1.0,0.0
25811,Kavalai Vendam,6480,0,6480,2016.csv,2016,0.0,1.0
25812,Afterward,6477,6477,0,2020.csv,2020,1.0,0.0
25813,Murattu Kaalai,6475,0,6475,2012.csv,2012,0.0,1.0
25814,The Boat Race 2013 Re-release,6469,0,6469,2013.csv,2013,0.0,1.0
25815,Prasad,6468,0,6468,2019.csv,2019,0.0,1.0
25816,The Legend of Sarila 2015 Re-release,6468,0,6468,2015.csv,2015,0.0,1.0
25817,Sirb Al-Hamam,6464,0,6464,2018.csv,2018,0.0,1.0
25818,Hard Boiled Sweets,6462,0,6462,2012.csv,2012,0.0,1.0
25819,Scum,6461,6461,0,2017.csv,2017,1.0,0.0
25820,Do Novogo Goda ostalos...,6450,0,6450,2019.csv,2019,0.0,1.0
25821,Batman and Harley Quinn,6448,0,6448,2017.csv,2017,0.0,1.0
25822,The Touch,6446,0,6446,2018.csv,2018,0.0,1.0
25823,Tu Dors Nicole,6445,5662,783,2015.csv,2015,0.8785104732350659,0.12148952676493406
25824,Farmtastic Fun,6441,0,6441,2019.csv,2019,0.0,1.0
25825,Escape from Extinction,6435,0,6435,2020.csv,2020,0.0,1.0
25826,The Suicide Theory,6434,6434,0,2015.csv,2015,1.0,0.0
25827,Knuckledust,6428,0,6428,2021.csv,2021,0.0,1.0
25828,25 Carat 2010 Re-release,6424,0,6424,2010.csv,2010,0.0,1.0
25829,Some Velvet Morning,6420,6420,0,2013.csv,2013,1.0,0.0
25830,RX 100,6419,0,6419,2018.csv,2018,0.0,1.0
25831,El idioma imposible,6414,0,6414,2010.csv,2010,0.0,1.0
25832,3pol Trobol Huli Ka Balbon,6410,0,6410,2019.csv,2019,0.0,1.0
25833,Meeku Maathrame Chepta,6409,0,6409,2019.csv,2019,0.0,1.0
25834,School of Babel,6407,0,6407,2014.csv,2014,0.0,1.0
25835,Olmo & the Seagull,6405,0,6405,2015.csv,2015,0.0,1.0
25836,Elia Kazan Exhibition,6404,0,6404,2010.csv,2010,0.0,1.0
25837,Setenta,6401,0,6401,2014.csv,2014,0.0,1.0
25838,Eh Janam Tumhare Lekhe,6393,0,6393,2015.csv,2015,0.0,1.0
25839,Father,6392,0,6392,2010.csv,2010,0.0,1.0
25840,A tu lado,6391,0,6391,2018.csv,2018,0.0,1.0
25841,Hunted,6391,0,6391,2021.csv,2021,0.0,1.0
25842,The Unthinkable,6390,0,6390,2019.csv,2019,0.0,1.0
25843,Bamse and the Thief City 2017 Re-release,6388,0,6388,2017.csv,2017,0.0,1.0
25844,100 Bloody Acres,6388,6388,0,2013.csv,2013,1.0,0.0
25845,Hunting and Gathering 2020 Re-release,6377,0,6377,2020.csv,2020,0.0,1.0
25846,Saftirikler,6376,0,6376,2016.csv,2016,0.0,1.0
25847,Leave It on the Floor 2013 Re-release,6375,0,6375,2013.csv,2013,0.0,1.0
25848,Circular,6375,0,6375,2012.csv,2012,0.0,1.0
25849,Aardman Double Bill,6369,0,6369,2011.csv,2011,0.0,1.0
25850,Santa Claws,6367,0,6367,2015.csv,2015,0.0,1.0
25851,In Your Dreams!,6364,0,6364,2016.csv,2016,0.0,1.0
25852,American Fighter,6361,0,6361,2020.csv,2020,0.0,1.0
25853,Estranged,6357,0,6357,2017.csv,2017,0.0,1.0
25854,Don't Forget to Breathe,6356,0,6356,2020.csv,2020,0.0,1.0
25855,Quero-te Tanto!,6347,0,6347,2019.csv,2019,0.0,1.0
25856,Gremlins 2010 Re-release,6345,0,6345,2010.csv,2010,0.0,1.0
25857,Between Valleys,6339,0,6339,2014.csv,2014,0.0,1.0
25858,Lost in Paradise,6338,0,6338,2013.csv,2013,0.0,1.0
25859,La Scala: Manon Lescaut,6336,0,6336,2019.csv,2019,0.0,1.0
25860,The Lamb,6335,0,6335,2020.csv,2020,0.0,1.0
25861,Inescapable,6334,6334,0,2013.csv,2013,1.0,0.0
25862,The Charnel House,6332,6332,0,2016.csv,2016,1.0,0.0
25863,Swan Lake 3D - Live from the Mariinsky Theatre,6332,0,6332,2013.csv,2013,0.0,1.0
25864,Sumikko Gurashi the Movie: The Unexpected Picture Book and the Secret Child 2021 Re-release,6332,0,6332,2021.csv,2021,0.0,1.0
25865,Remain,6331,0,6331,2020.csv,2020,0.0,1.0
25866,Weekender,6327,0,6327,2011.csv,2011,0.0,1.0
25867,The Big Heat,6324,0,6324,2017.csv,2017,0.0,1.0
25868,Garbage in the Garden of Eden,6324,0,6324,2012.csv,2012,0.0,1.0
25869,Love Never Dies,6308,0,6308,2012.csv,2012,0.0,1.0
25870,"Acasa, My Home",6308,0,6308,2020.csv,2020,0.0,1.0
25871,Watercolors,6305,6305,0,2010.csv,2010,1.0,0.0
25872,El rey de Canfranc,6305,0,6305,2013.csv,2013,0.0,1.0
25873,Citizen Lane,6302,0,6302,2018.csv,2018,0.0,1.0
25874,Samotari: Obnovena premiera po 20 letech,6298,0,6298,2020.csv,2020,0.0,1.0
25875,Sergio and Sergei,6297,0,6297,2018.csv,2018,0.0,1.0
25876,Eastern,6295,0,6295,2020.csv,2020,0.0,1.0
25877,Manuscripts Don't Burn,6295,6295,0,2014.csv,2014,1.0,0.0
25878,Mahi NRI,6294,0,6294,2017.csv,2017,0.0,1.0
25879,Kto ya? 2015 Re-release,6292,0,6292,2015.csv,2015,0.0,1.0
25880,Romeo and Juliet 2016 Re-release,6292,0,6292,2016.csv,2016,0.0,1.0
25881,Under the Eiffel Tower,6291,6291,0,2019.csv,2019,1.0,0.0
25882,Beyaz Balina,6291,0,6291,2017.csv,2017,0.0,1.0
25883,Crazy Rich Asians 2020 Re-release,6277,0,6277,2020.csv,2020,0.0,1.0
25884,Amerikanuak,6269,0,6269,2010.csv,2010,0.0,1.0
25885,Nota: None of the Above,6267,0,6267,2018.csv,2018,0.0,1.0
25886,Barefoot in the Kitchen,6263,0,6263,2013.csv,2013,0.0,1.0
25887,I Promise You Anarchy,6263,0,6263,2016.csv,2016,0.0,1.0
25888,Soldier's Mementos,6257,0,6257,2018.csv,2018,0.0,1.0
25889,Schweizer Helden,6255,0,6255,2015.csv,2015,0.0,1.0
25890,Two Heads Creek,6254,0,6254,2019.csv,2019,0.0,1.0
25891,The Skyjacker's Tale,6253,6253,0,2017.csv,2017,1.0,0.0
25892,From Me to You 2011 Re-release,6252,0,6252,2011.csv,2011,0.0,1.0
25893,La Strada 2020 Re-release,6249,0,6249,2020.csv,2020,0.0,1.0
25894,One Last Thing,6232,6232,0,2018.csv,2018,1.0,0.0
25895,In the Steps of Trisha Brown,6230,6230,0,2017.csv,2017,1.0,0.0
25896,La piazza della mia città - Bologna e Lo Stato Sociale,6230,0,6230,2020.csv,2020,0.0,1.0
25897,Down by Law 2017 Re-release,6229,0,6229,2017.csv,2017,0.0,1.0
25898,East of the Mountain,6227,0,6227,2015.csv,2015,0.0,1.0
25899,The Bad Kids,6226,6226,0,2016.csv,2016,1.0,0.0
25900,Dance Marathon,6225,0,6225,2011.csv,2011,0.0,1.0
25901,"Late August, Early September 2016 Re-release",6222,0,6222,2016.csv,2016,0.0,1.0
25902,Nunca pasa nada,6221,0,6221,2012.csv,2012,0.0,1.0
25903,Om Shanti Om 2010 Re-release,6216,0,6216,2010.csv,2010,0.0,1.0
25904,Hip Hop-eration 2015 Re-release,6203,0,6203,2015.csv,2015,0.0,1.0
25905,"Danse la danse, Nacho Duato",6203,0,6203,2013.csv,2013,0.0,1.0
25906,The Red and the Blue 2014 Re-release,6203,0,6203,2014.csv,2014,0.0,1.0
25907,A Man Vanishes 2012 Re-release,6201,6201,0,2012.csv,2012,1.0,0.0
25908,Being Rose,6198,0,6198,2018.csv,2018,0.0,1.0
25909,Southern District 2011 Re-release,6197,0,6197,2011.csv,2011,0.0,1.0
25910,Syndromes and a Century 2010 Re-release,6196,0,6196,2010.csv,2010,0.0,1.0
25911,The Red Chapel,6196,6196,0,2010.csv,2010,1.0,0.0
25912,I'm Not Harry Jenson.,6196,0,6196,2010.csv,2010,0.0,1.0
25913,The Night of the Shooting Stars 2015 Re-release,6186,6186,0,2015.csv,2015,1.0,0.0
25914,Cores,6184,0,6184,2013.csv,2013,0.0,1.0
25915,"Y si te vi, no me acuerdo",6173,0,6173,2011.csv,2011,0.0,1.0
25916,To Be of Service,6173,6173,0,2019.csv,2019,1.0,0.0
25917,Dobaara: See Your Evil,6164,0,6164,2017.csv,2017,0.0,1.0
25918,To Let,6155,0,6155,2019.csv,2019,0.0,1.0
25919,La revolución es un sueño eterno,6151,0,6151,2012.csv,2012,0.0,1.0
25920,Emelie,6147,0,6147,2016.csv,2016,0.0,1.0
25921,Sweetwater,6147,6147,0,2013.csv,2013,1.0,0.0
25922,Tim Lopes - Histórias de Arcanjo,6146,0,6146,2014.csv,2014,0.0,1.0
25923,Na Band Na Baraati,6142,0,6142,2018.csv,2018,0.0,1.0
25924,Crazy Eyes,6141,6141,0,2012.csv,2012,1.0,0.0
25925,Adi Kapyare Kootamani,6135,0,6135,2016.csv,2016,0.0,1.0
25926,Relaxer,6133,6133,0,2019.csv,2019,1.0,0.0
25927,Guitar Innovators: John Fahey & Nels Cline,6132,6132,0,2013.csv,2013,1.0,0.0
25928,Elevator to the Gallows 2018 Re-release,6130,0,6130,2018.csv,2018,0.0,1.0
25929,Top Hat,6129,0,6129,2010.csv,2010,0.0,1.0
25930,The Story of the Last Chrysanthemum,6125,0,6125,2017.csv,2017,0.0,1.0
25931,Aire,6124,0,6124,2018.csv,2018,0.0,1.0
25932,"El Sicario, Room 164",6123,6123,0,2011.csv,2011,1.0,0.0
25933,Munde Kamaal De,6119,0,6119,2015.csv,2015,0.0,1.0
25934,Mother Gamer,6118,0,6118,2020.csv,2020,0.0,1.0
25935,Bollywood: The Greatest Love Story Ever Told,6118,0,6118,2012.csv,2012,0.0,1.0
25936,Welcome to Pine Hill,6115,6115,0,2013.csv,2013,1.0,0.0
25937,Arise from Darkness,6112,6112,0,2017.csv,2017,1.0,0.0
25938,Hello Jam Rao Dai Mai,6109,0,6109,2017.csv,2017,0.0,1.0
25939,Misión en Mocland - Una aventura super espacial 2014 Re-release,6109,0,6109,2014.csv,2014,0.0,1.0
25940,Rangrezz,6108,6108,0,2013.csv,2013,1.0,0.0
25941,Mitti,6103,0,6103,2010.csv,2010,0.0,1.0
25942,The Last Fall,6100,6100,0,2012.csv,2012,1.0,0.0
25943,From 5 to 7,6095,0,6095,2017.csv,2017,0.0,1.0
25944,The Last Time I Saw Macao,6095,6095,0,2013.csv,2013,1.0,0.0
25945,Billion Star Hotel,6095,0,6095,2016.csv,2016,0.0,1.0
25946,Genezis,6085,0,6085,2018.csv,2018,0.0,1.0
25947,Kesfedilmemis Çocuklar,6083,0,6083,2019.csv,2019,0.0,1.0
25948,Last Flight to Abuja,6083,0,6083,2012.csv,2012,0.0,1.0
25949,Deep Blue Dream,6080,0,6080,2016.csv,2016,0.0,1.0
25950,A Journey to the Fumigated Towns,6075,0,6075,2018.csv,2018,0.0,1.0
25951,Beautiful 2012 Re-release,6074,0,6074,2012.csv,2012,0.0,1.0
25952,The Fuzz,6067,6067,0,2017.csv,2017,1.0,0.0
25953,My Fading Childhood,6057,0,6057,2018.csv,2018,0.0,1.0
25954,Abandoned: Angelique's Isle,6055,6055,0,2021.csv,2021,1.0,0.0
25955,The Miners' Hymns,6051,6051,0,2012.csv,2012,1.0,0.0
25956,The Marquise of O,6048,6048,0,2015.csv,2015,1.0,0.0
25957,Gundu,6048,0,6048,2019.csv,2019,0.0,1.0
25958,Blood Widow,6047,6047,0,2019.csv,2019,1.0,0.0
25959,Love & Air Sex,6047,6047,0,2014.csv,2014,1.0,0.0
25960,National Theatre Live: Travelling Light,6043,0,6043,2012.csv,2012,0.0,1.0
25961,El último mago O Bilembambudin,6041,0,6041,2014.csv,2014,0.0,1.0
25962,Baikonur 2014 Re-release,6040,0,6040,2014.csv,2014,0.0,1.0
25963,"Tal Mãe, Tal Filha",6040,0,6040,2018.csv,2018,0.0,1.0
25964,Delfin,6037,0,6037,2019.csv,2019,0.0,1.0
25965,The Family Tree,6035,6035,0,2011.csv,2011,1.0,0.0
25966,Love Sonia,6034,0,6034,2019.csv,2019,0.0,1.0
25967,Jack em Popoy: The Puliscredibles,6030,0,6030,2019.csv,2019,0.0,1.0
25968,Sous le figuier,6030,0,6030,2013.csv,2013,0.0,1.0
25969,Pretty Strong,6026,0,6026,2020.csv,2020,0.0,1.0
25970,Evergreen,6023,6023,0,2020.csv,2020,1.0,0.0
25971,Find Your Voice,6019,6019,0,2020.csv,2020,1.0,0.0
25972,Empire Me: New Worlds Are Happening!,6018,0,6018,2012.csv,2012,0.0,1.0
25973,Amalia,6016,0,6016,2019.csv,2019,0.0,1.0
25974,Headlock,6016,0,6016,2019.csv,2019,0.0,1.0
25975,Txarriboda,6009,0,6009,2015.csv,2015,0.0,1.0
25976,Wine Calling,6008,0,6008,2019.csv,2019,0.0,1.0
25977,Steelers: the World's First Gay Rugby Club,6006,0,6006,2020.csv,2020,0.0,1.0
25978,Patron,6003,0,6003,2013.csv,2013,0.0,1.0
25979,BearCity,6000,6000,0,2010.csv,2010,1.0,0.0
25980,Shirley Adams,5995,0,5995,2010.csv,2010,0.0,1.0
25981,Wait for Him,5992,0,5992,2018.csv,2018,0.0,1.0
25982,Mumbai Mirror,5988,0,5988,2013.csv,2013,0.0,1.0
25983,Raatchasi,5987,0,5987,2019.csv,2019,0.0,1.0
25984,A Man of Honor,5985,0,5985,2012.csv,2012,0.0,1.0
25985,Jihad Jane,5984,0,5984,2020.csv,2020,0.0,1.0
25986,A Simple Story,5983,0,5983,2016.csv,2016,0.0,1.0
25987,The Writer's Burrow,5981,0,5981,2016.csv,2016,0.0,1.0
25988,A Girl from Mogadishu,5981,0,5981,2020.csv,2020,0.0,1.0
25989,Primeiro Dia de Um Ano Qualquer,5979,0,5979,2013.csv,2013,0.0,1.0
25990,A Flickering Truth,5978,0,5978,2016.csv,2016,0.0,1.0
25991,The Weekend,5976,0,5976,2016.csv,2016,0.0,1.0
25992,48 Hours,5976,0,5976,2016.csv,2016,0.0,1.0
25993,On Wings of Eagles 2017 Re-release,5975,5975,0,2017.csv,2017,1.0,0.0
25994,2008 Seotaiji Symphony Encore,5974,0,5974,2010.csv,2010,0.0,1.0
25995,Thira,5973,0,5973,2013.csv,2013,0.0,1.0
25996,Sorcerer 2017 Re-release,5972,0,5972,2017.csv,2017,0.0,1.0
25997,"Sex, Death and Bowling",5972,5972,0,2015.csv,2015,1.0,0.0
25998,Mozart's Sister 2015 Re-release,5972,0,5972,2015.csv,2015,0.0,1.0
25999,Se Un Giorno Tornerai,5969,0,5969,2020.csv,2020,0.0,1.0
26000,Austerlitz,5965,0,5965,2017.csv,2017,0.0,1.0
26001,Road Kill,5964,0,5964,2010.csv,2010,0.0,1.0
26002,The Playroom,5964,5964,0,2013.csv,2013,1.0,0.0
26003,Doctor Proctor's Fart Powder 2018 Re-release,5962,0,5962,2018.csv,2018,0.0,1.0
26004,Poetry 2012 Re-release,5951,0,5951,2012.csv,2012,0.0,1.0
26005,Profu'/Teach,5950,0,5950,2020.csv,2020,0.0,1.0
26006,Michael H. Profession: Director,5950,0,5950,2013.csv,2013,0.0,1.0
26007,Lincoln Center Series: San Francisco Ballet's Romeo & Juliet,5948,0,5948,2016.csv,2016,0.0,1.0
26008,Cavemen,5948,5948,0,2014.csv,2014,1.0,0.0
26009,Druzina v najem,5946,0,5946,2015.csv,2015,0.0,1.0
26010,Peace to Us in Our Dreams,5940,0,5940,2015.csv,2015,0.0,1.0
26011,Lie Exposed,5938,5938,0,2020.csv,2020,1.0,0.0
26012,A Alma da Gente,5938,0,5938,2013.csv,2013,0.0,1.0
26013,Starless Dreams,5937,5937,0,2017.csv,2017,1.0,0.0
26014,The Silence,5936,0,5936,2017.csv,2017,0.0,1.0
26015,Spirited Away 2016 Re-release,5936,0,5936,2016.csv,2016,0.0,1.0
26016,Saak,5934,0,5934,2019.csv,2019,0.0,1.0
26017,Only Men Go to the Grave,5929,0,5929,2017.csv,2017,0.0,1.0
26018,American Animal,5928,5928,0,2012.csv,2012,1.0,0.0
26019,A Bitter Taste of Freedom,5928,0,5928,2011.csv,2011,0.0,1.0
26020,Reign of the Supermen/The Death of Superman,5923,0,5923,2019.csv,2019,0.0,1.0
26021,Sweethearts of the Prison Rodeo,5922,5922,0,2010.csv,2010,1.0,0.0
26022,Larry Gaye: Renegade Male Flight Attendant 2017 Re-release,5921,0,5921,2017.csv,2017,0.0,1.0
26023,I Am MLK Jr.,5918,5918,0,2018.csv,2018,1.0,0.0
26024,The Conjuring 2020 Re-release,5915,0,5915,2020.csv,2020,0.0,1.0
26025,Norte Estrecho,5910,0,5910,2015.csv,2015,0.0,1.0
26026,"Kartinki, narisovannye v chasi zakata i rassveta",5910,0,5910,2019.csv,2019,0.0,1.0
26027,Famel Top Secret,5910,0,5910,2014.csv,2014,0.0,1.0
26028,The Limit Of,5909,0,5909,2019.csv,2019,0.0,1.0
26029,Gang of Ghosts,5906,5906,0,2014.csv,2014,1.0,0.0
26030,Path of Blood,5905,0,5905,2018.csv,2018,0.0,1.0
26031,Araña,5904,0,5904,2020.csv,2020,0.0,1.0
26032,Slash,5902,5902,0,2016.csv,2016,1.0,0.0
26033,Evolution of Violence,5897,0,5897,2012.csv,2012,0.0,1.0
26034,White Rage,5896,0,5896,2015.csv,2015,0.0,1.0
26035,Sokrovenny Chelovek,5895,0,5895,2020.csv,2020,0.0,1.0
26036,Medeas,5895,5895,0,2015.csv,2015,1.0,0.0
26037,Driver,5894,0,5894,2017.csv,2017,0.0,1.0
26038,An Actor Prepares,5891,1743,4148,2018.csv,2018,0.2958750636564251,0.704124936343575
26039,Uma Dose Violenta de Qualquer Coisa,5887,0,5887,2014.csv,2014,0.0,1.0
26040,Ranjha Refugee,5878,0,5878,2018.csv,2018,0.0,1.0
26041,Infliction,5875,5875,0,2014.csv,2014,1.0,0.0
26042,The Imperialists Are Still Alive!,5874,5874,0,2011.csv,2011,1.0,0.0
26043,La espina de Dios,5872,0,5872,2015.csv,2015,0.0,1.0
26044,Domestique,5871,0,5871,2018.csv,2018,0.0,1.0
26045,São Silvestre,5870,0,5870,2013.csv,2013,0.0,1.0
26046,Dunderklumpen!,5869,0,5869,2013.csv,2013,0.0,1.0
26047,La obra secreta,5869,0,5869,2018.csv,2018,0.0,1.0
26048,Empire of Silver 2011 Re-release,5867,0,5867,2011.csv,2011,0.0,1.0
26049,BuzzKill,5860,5860,0,2012.csv,2012,1.0,0.0
26050,Top Spin,5858,5858,0,2015.csv,2015,1.0,0.0
26051,The Silent Army 2011 Re-release,5852,0,5852,2011.csv,2011,0.0,1.0
26052,Campo Grande,5852,0,5852,2016.csv,2016,0.0,1.0
26053,Alien Uprising,5848,0,5848,2012.csv,2012,0.0,1.0
26054,Shamantakamani,5848,0,5848,2017.csv,2017,0.0,1.0
26055,Bourek,5844,5844,0,2016.csv,2016,1.0,0.0
26056,Barb and Star Go to Vista Del Mar,5842,0,5842,2021.csv,2021,0.0,1.0
26057,¡Asu Mare! 3,5841,0,5841,2019.csv,2019,0.0,1.0
26058,Wrong-Way Driving,5839,0,5839,2017.csv,2017,0.0,1.0
26059,Shout Gladi Gladi,5839,5839,0,2015.csv,2015,1.0,0.0
26060,Human Nature,5834,5487,347,2019.csv,2019,0.9405210833047651,0.05947891669523483
26061,Pryg Skok: In Search Of Treasure,5834,0,5834,2020.csv,2020,0.0,1.0
26062,Nemci Ven! Deutsche Raus!,5825,0,5825,2015.csv,2015,0.0,1.0
26063,Dark State,5824,5824,0,2021.csv,2021,1.0,0.0
26064,Gracias Gauchito,5820,0,5820,2018.csv,2018,0.0,1.0
26065,Tej... I Love You,5817,0,5817,2018.csv,2018,0.0,1.0
26066,Mystikal,5817,0,5817,2010.csv,2010,0.0,1.0
26067,A Farra do Circo,5816,0,5816,2014.csv,2014,0.0,1.0
26068,"What's for Dinner, Mom?",5813,0,5813,2017.csv,2017,0.0,1.0
26069,"Tata Cedrón, el regreso de Juancito Caminador",5812,0,5812,2011.csv,2011,0.0,1.0
26070,Smoking Club 129 normas,5812,0,5812,2017.csv,2017,0.0,1.0
26071,Speed Kills,5812,0,5812,2019.csv,2019,0.0,1.0
26072,Beyond Beyond 2018 Re-release,5811,0,5811,2018.csv,2018,0.0,1.0
26073,Uppena,5794,0,5794,2021.csv,2021,0.0,1.0
26074,Self Redemption,5792,0,5792,2016.csv,2016,0.0,1.0
26075,Five Dances,5788,5788,0,2013.csv,2013,1.0,0.0
26076,Paralelo 10,5784,0,5784,2012.csv,2012,0.0,1.0
26077,Black November,5782,5782,0,2015.csv,2015,1.0,0.0
26078,Ayushmanbava,5780,0,5780,2019.csv,2019,0.0,1.0
26079,Uno 2012 Re-release,5780,0,5780,2012.csv,2012,0.0,1.0
26080,Undrafted,5777,5777,0,2016.csv,2016,1.0,0.0
26081,Locura al aire,5768,0,5768,2018.csv,2018,0.0,1.0
26082,The Flowers Bloomin,5768,0,5768,2016.csv,2016,0.0,1.0
26083,Neka ostane medju nama 2013 Re-release,5766,0,5766,2013.csv,2013,0.0,1.0
26084,Our Last Tango 2017 Re-release,5765,0,5765,2017.csv,2017,0.0,1.0
26085,Blue Lips,5764,0,5764,2014.csv,2014,0.0,1.0
26086,Good as You 2013 Re-release,5764,0,5764,2013.csv,2013,0.0,1.0
26087,Lies We Tell,5762,0,5762,2018.csv,2018,0.0,1.0
26088,Devi 2,5760,0,5760,2019.csv,2019,0.0,1.0
26089,Sushi: The Global Catch,5757,5757,0,2012.csv,2012,1.0,0.0
26090,Ambi Ning Vysaitho,5755,0,5755,2018.csv,2018,0.0,1.0
26091,Nebo izmeryaetsya milyami,5752,0,5752,2019.csv,2019,0.0,1.0
26092,Katheyondu Shuruvagide,5750,0,5750,2018.csv,2018,0.0,1.0
26093,A Dark Truth,5750,5750,0,2013.csv,2013,1.0,0.0
26094,An Outpost of Progress,5746,0,5746,2016.csv,2016,0.0,1.0
26095,Sex and the Future,5745,5745,0,2020.csv,2020,1.0,0.0
26096,Love Goes Public,5738,5738,0,2019.csv,2019,1.0,0.0
26097,Excellent Doctor from Hejian,5737,0,5737,2018.csv,2018,0.0,1.0
26098,Roman de gare 2011 Re-release,5736,0,5736,2011.csv,2011,0.0,1.0
26099,Kiraz Mevsimi,5732,0,5732,2018.csv,2018,0.0,1.0
26100,A trip to the Moon,5731,0,5731,2018.csv,2018,0.0,1.0
26101,Bombay Beach,5730,0,5730,2012.csv,2012,0.0,1.0
26102,"Pororo, the Snow Fairy Village Adventure 2021 Re-release",5727,0,5727,2020.csv,2020,0.0,1.0
26103,Polar Star,5726,0,5726,2017.csv,2017,0.0,1.0
26104,You Were Here in My Youth,5726,0,5726,2017.csv,2017,0.0,1.0
26105,Love Live! Series 9th Anniversary LOVE LIVE! FEST,5721,0,5721,2020.csv,2020,0.0,1.0
26106,Save the Date,5719,5719,0,2012.csv,2012,1.0,0.0
26107,Aisylu Movie,5714,0,5714,2017.csv,2017,0.0,1.0
26108,Generation Singles,5711,0,5711,2011.csv,2011,0.0,1.0
26109,Deadly Code 2015 Re-release,5710,0,5710,2015.csv,2015,0.0,1.0
26110,Ningún amor es perfecto,5705,0,5705,2012.csv,2012,0.0,1.0
26111,Back from the Beat,5705,0,5705,2019.csv,2019,0.0,1.0
26112,Rocky II 2020 Re-release,5695,0,5695,2020.csv,2020,0.0,1.0
26113,Insônia,5695,0,5695,2014.csv,2014,0.0,1.0
26114,Go Lala Go!,5692,0,5692,2010.csv,2010,0.0,1.0
26115,Porro Hecho En Colombia,5689,0,5689,2015.csv,2015,0.0,1.0
26116,Alive!,5688,0,5688,2011.csv,2011,0.0,1.0
26117,Uma Noite em Sampa,5688,0,5688,2016.csv,2016,0.0,1.0
26118,The Magic Flute 2010 Re-release,5688,0,5688,2010.csv,2010,0.0,1.0
26119,The Wanted 18,5680,5680,0,2015.csv,2015,1.0,0.0
26120,People of a Feather,5677,5677,0,2013.csv,2013,1.0,0.0
26121,Mirchi,5676,0,5676,2013.csv,2013,0.0,1.0
26122,The Fall of Night,5673,5673,0,2010.csv,2010,1.0,0.0
26123,Teja Bhai and Family,5664,0,5664,2011.csv,2011,0.0,1.0
26124,Knife Fight,5661,5661,0,2013.csv,2013,1.0,0.0
26125,Papirosen,5658,5658,0,2014.csv,2014,1.0,0.0
26126,The Rememberer,5656,0,5656,2019.csv,2019,0.0,1.0
26127,This Isn't Funny,5654,5654,0,2015.csv,2015,1.0,0.0
26128,The Bird,5652,0,5652,2012.csv,2012,0.0,1.0
26129,Journey to the Safest Place on Earth,5652,0,5652,2014.csv,2014,0.0,1.0
26130,Those Who Go Those Who Stay,5649,0,5649,2014.csv,2014,0.0,1.0
26131,Ju-on: The Final Curse 2019 Re-release,5646,0,5646,2019.csv,2019,0.0,1.0
26132,The Music Box,5642,0,5642,2019.csv,2019,0.0,1.0
26133,Vaaliba Raja,5642,0,5642,2016.csv,2016,0.0,1.0
26134,"Births, Deaths and Marriages",5639,0,5639,2020.csv,2020,0.0,1.0
26135,Série noire,5633,5633,0,2019.csv,2019,1.0,0.0
26136,Desertor,5633,0,5633,2019.csv,2019,0.0,1.0
26137,Centro Histórico,5633,0,5633,2013.csv,2013,0.0,1.0
26138,Sankarabharanam,5633,0,5633,2015.csv,2015,0.0,1.0
26139,La Chinoise 2017 Re-release,5631,5631,0,2017.csv,2017,1.0,0.0
26140,Practical Guide to Belgrade with Singing and Crying,5630,0,5630,2011.csv,2011,0.0,1.0
26141,Padre de Familia,5629,0,5629,2016.csv,2016,0.0,1.0
26142,Russian Roulette,5626,0,5626,2018.csv,2018,0.0,1.0
26143,The Bank Job 2011 Re-release,5625,0,5625,2011.csv,2011,0.0,1.0
26144,Sonata for Cello 2017 Re-release,5624,0,5624,2017.csv,2017,0.0,1.0
26145,Mentor,5619,0,5619,2020.csv,2020,0.0,1.0
26146,The Best Things in the World 2012 Re-release,5617,0,5617,2012.csv,2012,0.0,1.0
26147,Vic + Flo Saw a Bear,5613,0,5613,2014.csv,2014,0.0,1.0
26148,Met Opera Encores,5608,0,5608,2012.csv,2012,0.0,1.0
26149,Fanaa 2012 Re-release,5608,0,5608,2012.csv,2012,0.0,1.0
26150,4 Singh Confirm,5602,0,5602,2010.csv,2010,0.0,1.0
26151,Arest,5601,0,5601,2019.csv,2019,0.0,1.0
26152,Bahti kara,5601,0,5601,2010.csv,2010,0.0,1.0
26153,The Captive 2016 Re-release,5600,0,5600,2016.csv,2016,0.0,1.0
26154,Kuku: mina jään ellu,5596,0,5596,2011.csv,2011,0.0,1.0
26155,The Russian Bride,5595,0,5595,2019.csv,2019,0.0,1.0
26156,The Meeting,5594,0,5594,2018.csv,2018,0.0,1.0
26157,Arreo,5592,0,5592,2015.csv,2015,0.0,1.0
26158,A Geisha,5583,0,5583,2017.csv,2017,0.0,1.0
26159,Caps,5580,0,5580,2017.csv,2017,0.0,1.0
26160,Elevate,5580,5580,0,2011.csv,2011,1.0,0.0
26161,Turn Around,5579,0,5579,2019.csv,2019,0.0,1.0
26162,Naan Sirithaal,5575,0,5575,2020.csv,2020,0.0,1.0
26163,A Season in France 2019 Re-release,5573,0,5573,2019.csv,2019,0.0,1.0
26164,Our Man in Tehran,5573,5573,0,2015.csv,2015,1.0,0.0
26165,Low Definition Control - Malfunctions #0,5571,0,5571,2012.csv,2012,0.0,1.0
26166,"Where Are You, João Gilberto?",5568,0,5568,2019.csv,2019,0.0,1.0
26167,Elena and Her Men,5568,0,5568,2018.csv,2018,0.0,1.0
26168,Kid Cannabis,5565,5565,0,2014.csv,2014,1.0,0.0
26169,Lost After Dark,5562,0,5562,2015.csv,2015,0.0,1.0
26170,The Miracle of the Little Prince,5553,5553,0,2019.csv,2019,1.0,0.0
26171,Russia 88,5553,0,5553,2010.csv,2010,0.0,1.0
26172,Nannu Dochukunduvate,5552,0,5552,2018.csv,2018,0.0,1.0
26173,Arpeggio of Blue Steel: Ars Nova - Cadenza,5549,0,5549,2016.csv,2016,0.0,1.0
26174,Booker's Place: A Mississippi Story,5549,5549,0,2012.csv,2012,1.0,0.0
26175,Being 17 2017 Re-release,5547,0,5547,2017.csv,2017,0.0,1.0
26176,"4, 5, 6... Mélie pain d'épice",5545,0,5545,2010.csv,2010,0.0,1.0
26177,Antonio Conselheiro: O Taumaturgo Dos Sertoes,5545,0,5545,2012.csv,2012,0.0,1.0
26178,La Médium del Venerable,5543,0,5543,2019.csv,2019,0.0,1.0
26179,Señora de,5542,0,5542,2010.csv,2010,0.0,1.0
26180,Matriarch,5535,0,5535,2018.csv,2018,0.0,1.0
26181,Jack and the Cuckoo-Clock Heart 2021 Re-release,5532,0,5532,2021.csv,2021,0.0,1.0
26182,American Grindhouse,5529,5529,0,2010.csv,2010,1.0,0.0
26183,Ikiru 2020 Re-release,5529,0,5529,2020.csv,2020,0.0,1.0
26184,Bad Police,5529,0,5529,2017.csv,2017,0.0,1.0
26185,The Chronicles of Melanie,5527,0,5527,2016.csv,2016,0.0,1.0
26186,Toz Ruhu,5527,0,5527,2015.csv,2015,0.0,1.0
26187,Closed Diary 2011 Re-release,5526,0,5526,2011.csv,2011,0.0,1.0
26188,Red Amnesia,5526,0,5526,2015.csv,2015,0.0,1.0
26189,My Brothers,5523,0,5523,2012.csv,2012,0.0,1.0
26190,The Rift: Dark Side of the Moon,5520,0,5520,2016.csv,2016,0.0,1.0
26191,Aslan Parçam,5520,0,5520,2019.csv,2019,0.0,1.0
26192,Mater,5519,0,5519,2017.csv,2017,0.0,1.0
26193,Are We Not Cats,5518,5518,0,2018.csv,2018,1.0,0.0
26194,Kaira,5518,0,5518,2018.csv,2018,0.0,1.0
26195,Al khourouj an la nas,5518,0,5518,2018.csv,2018,0.0,1.0
26196,The Living,5514,5514,0,2015.csv,2015,1.0,0.0
26197,All Against All,5514,0,5514,2020.csv,2020,0.0,1.0
26198,Icaros: A Vision,5510,5510,0,2017.csv,2017,1.0,0.0
26199,Tomato Red: Blood Money,5504,5504,0,2021.csv,2021,1.0,0.0
26200,The Nest,5504,0,5504,2020.csv,2020,0.0,1.0
26201,Rescripts Bout Peony Fairy,5501,0,5501,2016.csv,2016,0.0,1.0
26202,Mountains May Depart 2017 Re-release,5500,0,5500,2017.csv,2017,0.0,1.0
26203,Mutant Blast,5498,0,5498,2019.csv,2019,0.0,1.0
26204,Nadhoo Khan,5490,0,5490,2019.csv,2019,0.0,1.0
26205,Outlaw,5489,0,5489,2010.csv,2010,0.0,1.0
26206,The Endless River,5487,0,5487,2016.csv,2016,0.0,1.0
26207,House of Tolerance 2014 Re-release,5477,0,5477,2014.csv,2014,0.0,1.0
26208,Karski & the Lords of Humanity,5475,0,5475,2016.csv,2016,0.0,1.0
26209,Gorodskie ptichki,5474,0,5474,2016.csv,2016,0.0,1.0
26210,Doidas e Santas,5473,0,5473,2016.csv,2016,0.0,1.0
26211,The Man from Earth: Holocene,5472,5472,0,2017.csv,2017,1.0,0.0
26212,Nu,5471,0,5471,2020.csv,2020,0.0,1.0
26213,706,5469,0,5469,2019.csv,2019,0.0,1.0
26214,That Trip We Took with Dad,5469,0,5469,2017.csv,2017,0.0,1.0
26215,Ensaio,5465,0,5465,2013.csv,2013,0.0,1.0
26216,In Our Name,5464,0,5464,2010.csv,2010,0.0,1.0
26217,Utomlennye solntsem 2 2012 Re-release,5461,0,5461,2012.csv,2012,0.0,1.0
26218,Super Nada 2015 Re-release,5458,0,5458,2015.csv,2015,0.0,1.0
26219,Acts of Godfrey,5458,0,5458,2012.csv,2012,0.0,1.0
26220,A Good American,5457,0,5457,2016.csv,2016,0.0,1.0
26221,Arima,5456,0,5456,2020.csv,2020,0.0,1.0
26222,The Antique: Secret of the Old Books,5450,0,5450,2019.csv,2019,0.0,1.0
26223,Cauce,5449,0,5449,2017.csv,2017,0.0,1.0
26224,The Women 2018 Re-release,5449,0,5449,2018.csv,2018,0.0,1.0
26225,Different from Whom 2011 Re-release,5448,0,5448,2011.csv,2011,0.0,1.0
26226,Old Partner 2010 Re-release,5445,0,5445,2010.csv,2010,0.0,1.0
26227,Cuban Food Stories,5434,5434,0,2018.csv,2018,1.0,0.0
26228,Haunted Hills,5434,0,5434,2020.csv,2020,0.0,1.0
26229,Con Alas Para Volar,5425,0,5425,2017.csv,2017,0.0,1.0
26230,Prova De Artista,5425,0,5425,2011.csv,2011,0.0,1.0
26231,Love in Transit 2012 Re-release,5422,0,5422,2012.csv,2012,0.0,1.0
26232,Heaven Without People,5421,0,5421,2018.csv,2018,0.0,1.0
26233,Flex Is Kings,5418,5418,0,2014.csv,2014,1.0,0.0
26234,Sister of Mine 2018 Re-release,5416,0,5416,2018.csv,2018,0.0,1.0
26235,The Wind Journeys 2011 Re-release,5414,0,5414,2011.csv,2011,0.0,1.0
26236,Ladyworld,5413,0,5413,2019.csv,2019,0.0,1.0
26237,Litla Moskva,5408,0,5408,2018.csv,2018,0.0,1.0
26238,El último Carnaval,5405,0,5405,2011.csv,2011,0.0,1.0
26239,El destierro,5402,0,5402,2016.csv,2016,0.0,1.0
26240,Charlie Casanova,5401,0,5401,2012.csv,2012,0.0,1.0
26241,The Twilight Saga: New Moon 2020 Re-release,5400,0,5400,2020.csv,2020,0.0,1.0
26242,Grazing the Sky,5399,0,5399,2015.csv,2015,0.0,1.0
26243,Los enemigos del dolor,5393,0,5393,2015.csv,2015,0.0,1.0
26244,Whiz Kids,5386,5386,0,2010.csv,2010,1.0,0.0
26245,Içimdeki sessiz nehir,5385,0,5385,2011.csv,2011,0.0,1.0
26246,The Only Real Game,5384,5384,0,2014.csv,2014,1.0,0.0
26247,Swing Time 2020 Re-release,5379,0,5379,2020.csv,2020,0.0,1.0
26248,The Santiso Report,5375,0,5375,2016.csv,2016,0.0,1.0
26249,The Wind Journeys,5374,0,5374,2010.csv,2010,0.0,1.0
26250,Môj dedo spadol z Marsu,5373,0,5373,2019.csv,2019,0.0,1.0
26251,Spólao yfir hafio,5364,0,5364,2017.csv,2017,0.0,1.0
26252,Geri döndü,5364,0,5364,2017.csv,2017,0.0,1.0
26253,The White Devil,5360,0,5360,2019.csv,2019,0.0,1.0
26254,Holding Hands,5356,0,5356,2018.csv,2018,0.0,1.0
26255,Miracle 2019 Re-release,5356,0,5356,2019.csv,2019,0.0,1.0
26256,Operacion Cometee,5355,0,5355,2011.csv,2011,0.0,1.0
26257,Hot Spot,5354,0,5354,2011.csv,2011,0.0,1.0
26258,Creature,5352,0,5352,2014.csv,2014,0.0,1.0
26259,The Glorious Pain,5351,0,5351,2020.csv,2020,0.0,1.0
26260,Ferrari 312B: Where the Revolution Begins,5349,0,5349,2017.csv,2017,0.0,1.0
26261,Sunlight Jr.,5346,0,5346,2014.csv,2014,0.0,1.0
26262,Mayfair,5339,0,5339,2018.csv,2018,0.0,1.0
26263,Non si può morire ballando,5337,0,5337,2019.csv,2019,0.0,1.0
26264,Animal Town,5334,0,5334,2011.csv,2011,0.0,1.0
26265,Casa Propia,5334,0,5334,2018.csv,2018,0.0,1.0
26266,Outing,5329,0,5329,2012.csv,2012,0.0,1.0
26267,Naachle London,5327,0,5327,2012.csv,2012,0.0,1.0
26268,Mission: Impossible - Fallout 2020 Re-release,5322,0,5322,2020.csv,2020,0.0,1.0
26269,321 días en Michigan,5321,0,5321,2014.csv,2014,0.0,1.0
26270,She's Lost Control,5319,5319,0,2015.csv,2015,1.0,0.0
26271,Home,5316,0,5316,2012.csv,2012,0.0,1.0
26272,"Mama, wo ai nin",5316,0,5316,2013.csv,2013,0.0,1.0
26273,A Good Wife,5315,0,5315,2017.csv,2017,0.0,1.0
26274,Journey,5313,0,5313,2017.csv,2017,0.0,1.0
26275,Homo Botanicus,5312,0,5312,2019.csv,2019,0.0,1.0
26276,Goya,5312,0,5312,2010.csv,2010,0.0,1.0
26277,La decisión de Julia,5311,0,5311,2016.csv,2016,0.0,1.0
26278,Cin Deresi: Müsfer,5307,0,5307,2019.csv,2019,0.0,1.0
26279,Queen Lear,5303,0,5303,2019.csv,2019,0.0,1.0
26280,Vital Signs,5302,0,5302,2011.csv,2011,0.0,1.0
26281,Las aventuras de Moriana,5297,0,5297,2015.csv,2015,0.0,1.0
26282,River Road,5295,0,5295,2017.csv,2017,0.0,1.0
26283,5 terapiya,5293,0,5293,2018.csv,2018,0.0,1.0
26284,Echevarriatik Etxeberriara,5289,0,5289,2015.csv,2015,0.0,1.0
26285,Poner a actuar pájaros,5289,0,5289,2017.csv,2017,0.0,1.0
26286,What No One Knows 2013 Re-release,5281,0,5281,2013.csv,2013,0.0,1.0
26287,The Cage of Time,5281,0,5281,2018.csv,2018,0.0,1.0
26288,Ondalla Eradalla,5280,0,5280,2018.csv,2018,0.0,1.0
26289,Red Hot Chili Peppers: I'm with You Live in Theaters,5277,0,5277,2011.csv,2011,0.0,1.0
26290,The Time Being,5274,5274,0,2013.csv,2013,1.0,0.0
26291,Wunderkammer - World of Wonder,5270,0,5270,2019.csv,2019,0.0,1.0
26292,It's Not Yet Dark,5269,1227,4042,2017.csv,2017,0.2328715126209907,0.7671284873790093
26293,There Is No Evil,5268,0,5268,2020.csv,2020,0.0,1.0
26294,Still Here,5268,5268,0,2020.csv,2020,1.0,0.0
26295,Sansho the Bailiff,5267,0,5267,2017.csv,2017,0.0,1.0
26296,Los silencios,5267,0,5267,2019.csv,2019,0.0,1.0
26297,Prokofiev: On the Way,5267,0,5267,2016.csv,2016,0.0,1.0
26298,Lost at Christmas,5262,0,5262,2020.csv,2020,0.0,1.0
26299,The Silent Storm,5260,0,5260,2016.csv,2016,0.0,1.0
26300,This Time Tomorrow,5258,0,5258,2017.csv,2017,0.0,1.0
26301,Mumbai Central,5251,0,5251,2016.csv,2016,0.0,1.0
26302,Killers,5248,0,5248,2014.csv,2014,0.0,1.0
26303,Sarajevo,5247,5247,0,2015.csv,2015,1.0,0.0
26304,Ivanov,5246,0,5246,2019.csv,2019,0.0,1.0
26305,Possible Faces,5246,0,5246,2019.csv,2019,0.0,1.0
26306,Step bay step 2018 Re-release,5241,0,5241,2018.csv,2018,0.0,1.0
26307,Speed-Dating,5240,5240,0,2010.csv,2010,1.0,0.0
26308,Cracks in Concrete 2015 Re-release,5236,0,5236,2015.csv,2015,0.0,1.0
26309,Na stojaka v kine,5236,0,5236,2018.csv,2018,0.0,1.0
26310,Becoming Animal,5236,0,5236,2018.csv,2018,0.0,1.0
26311,Dimmi che destino avrò,5233,0,5233,2012.csv,2012,0.0,1.0
26312,Dacii Liberi,5228,0,5228,2018.csv,2018,0.0,1.0
26313,Kitty Party,5218,0,5218,2019.csv,2019,0.0,1.0
26314,Photocopy,5217,0,5217,2017.csv,2017,0.0,1.0
26315,The Search Engine,5215,0,5215,2016.csv,2016,0.0,1.0
26316,The Venerable W. 2019 Re-release,5214,0,5214,2019.csv,2019,0.0,1.0
26317,Pandora's Box 2018 Re-release,5214,0,5214,2018.csv,2018,0.0,1.0
26318,Hulunbuir City,5214,0,5214,2019.csv,2019,0.0,1.0
26319,The Princess of France,5212,5212,0,2015.csv,2015,1.0,0.0
26320,Death Valley,5211,5211,0,2015.csv,2015,1.0,0.0
26321,Best of Times 2010 Re-release,5211,0,5211,2010.csv,2010,0.0,1.0
26322,In Searching,5210,5210,0,2018.csv,2018,1.0,0.0
26323,Measuring the World 2016 Re-release,5209,0,5209,2016.csv,2016,0.0,1.0
26324,Charlotte The Return,5208,0,5208,2019.csv,2019,0.0,1.0
26325,Lily Lane,5208,0,5208,2016.csv,2016,0.0,1.0
26326,Zombie Bro,5208,5208,0,2021.csv,2021,1.0,0.0
26327,Poslednji Srb na Hrvaskem,5202,0,5202,2019.csv,2019,0.0,1.0
26328,Nobel Son 2010 Re-release,5200,0,5200,2010.csv,2010,0.0,1.0
26329,Chokehold,5200,5200,0,2019.csv,2019,1.0,0.0
26330,Camp Cool Kids,5199,0,5199,2019.csv,2019,0.0,1.0
26331,The Hunting Ground 2016 Re-release,5198,0,5198,2016.csv,2016,0.0,1.0
26332,Stolen Fairytales,5197,0,5197,2018.csv,2018,0.0,1.0
26333,Girls' Encounter,5190,0,5190,2020.csv,2020,0.0,1.0
26334,The Dream,5178,0,5178,2018.csv,2018,0.0,1.0
26335,The Gay Divorcee 2010 Re-release,5176,0,5176,2010.csv,2010,0.0,1.0
26336,"Yo, Lucas",5171,0,5171,2018.csv,2018,0.0,1.0
26337,Last Testimony,5167,0,5167,2016.csv,2016,0.0,1.0
26338,The Gliksmans,5166,5166,0,2019.csv,2019,1.0,0.0
26339,Thirumanam,5165,0,5165,2019.csv,2019,0.0,1.0
26340,Caíto,5165,0,5165,2013.csv,2013,0.0,1.0
26341,Martino's Summer,5165,0,5165,2011.csv,2011,0.0,1.0
26342,Je te survivrai,5162,0,5162,2014.csv,2014,0.0,1.0
26343,110% Honest,5159,0,5159,2019.csv,2019,0.0,1.0
26344,The Over the Hill Band 2012 Re-release,5155,0,5155,2012.csv,2012,0.0,1.0
26345,First Man 2020 Re-release,5155,0,5155,2020.csv,2020,0.0,1.0
26346,And They're Off,5154,5154,0,2011.csv,2011,1.0,0.0
26347,100 Acres of Hell,5152,5152,0,2019.csv,2019,1.0,0.0
26348,Tres Escapularios,5152,0,5152,2018.csv,2018,0.0,1.0
26349,Express Raja,5145,0,5145,2016.csv,2016,0.0,1.0
26350,Land of Hero,5145,0,5145,2016.csv,2016,0.0,1.0
26351,Arena Di Verona: Il Trovatore,5137,0,5137,2020.csv,2020,0.0,1.0
26352,Self Made,5137,0,5137,2011.csv,2011,0.0,1.0
26353,To Joy,5135,0,5135,2018.csv,2018,0.0,1.0
26354,In the Sky... for a Dream,5130,0,5130,2017.csv,2017,0.0,1.0
26355,To Die Is Hard,5129,5129,0,2010.csv,2010,1.0,0.0
26356,Things Don't Stay Fixed,5127,5127,0,2021.csv,2021,1.0,0.0
26357,Login,5126,0,5126,2012.csv,2012,0.0,1.0
26358,Sew the Winter to My Skin,5126,0,5126,2019.csv,2019,0.0,1.0
26359,Gangster Land 2019 Re-release,5124,0,5124,2019.csv,2019,0.0,1.0
26360,Body at Brighton Rock,5123,5123,0,2019.csv,2019,1.0,0.0
26361,Return to Nuke 'Em High Volume 1,5122,5122,0,2014.csv,2014,1.0,0.0
26362,118,5122,0,5122,2019.csv,2019,0.0,1.0
26363,Intersection,5116,5116,0,2018.csv,2018,1.0,0.0
26364,Rolpeulrei,5112,0,5112,2014.csv,2014,0.0,1.0
26365,Deepsea Challenge 2017 Re-release,5111,0,5111,2017.csv,2017,0.0,1.0
26366,Once Upon a Time in the West 2011 Re-release,5109,0,5109,2011.csv,2011,0.0,1.0
26367,Bozkir Kuslara Bak Kuslara,5106,0,5106,2019.csv,2019,0.0,1.0
26368,Chasing the Dragon II: Wild Wild Bunch 2021 Re-release,5105,0,5105,2021.csv,2021,0.0,1.0
26369,Come on Teacher,5101,0,5101,2018.csv,2018,0.0,1.0
26370,Oliver Sherman,5097,0,5097,2012.csv,2012,0.0,1.0
26371,La helada negra,5096,0,5096,2016.csv,2016,0.0,1.0
26372,Stella on Holiday,5095,0,5095,2020.csv,2020,0.0,1.0
26373,Bad Lucky Goat,5088,5088,0,2017.csv,2017,1.0,0.0
26374,On War 2015 Re-release,5086,5086,0,2015.csv,2015,1.0,0.0
26375,Welcome to Happiness,5083,5083,0,2016.csv,2016,1.0,0.0
26376,Tutsak,5083,0,5083,2018.csv,2018,0.0,1.0
26377,Good Luck! Boy,5081,0,5081,2013.csv,2013,0.0,1.0
26378,The Good Death,5080,0,5080,2019.csv,2019,0.0,1.0
26379,Otello,5079,0,5079,2014.csv,2014,0.0,1.0
26380,Neckan,5078,0,5078,2017.csv,2017,0.0,1.0
26381,2307: Winter's Dream,5078,0,5078,2017.csv,2017,0.0,1.0
26382,Der letzte Jude von Drohobytsch,5077,0,5077,2012.csv,2012,0.0,1.0
26383,Kuppathu Raja,5074,0,5074,2019.csv,2019,0.0,1.0
26384,Bidder 70,5074,5074,0,2013.csv,2013,1.0,0.0
26385,Tanner Hall,5073,5073,0,2011.csv,2011,1.0,0.0
26386,Avaroa el sol de la gloria,5066,0,5066,2019.csv,2019,0.0,1.0
26387,Notes on an Appearance,5065,5065,0,2018.csv,2018,1.0,0.0
26388,Beginning of the Great Revival 2016 Re-release,5062,0,5062,2016.csv,2016,0.0,1.0
26389,Black and White Photo Studio,5062,0,5062,2017.csv,2017,0.0,1.0
26390,Nauta,5058,0,5058,2011.csv,2011,0.0,1.0
26391,Los Corroboradores,5055,0,5055,2018.csv,2018,0.0,1.0
26392,Armonías del caos,5054,0,5054,2015.csv,2015,0.0,1.0
26393,Canción de Iguaque,5053,0,5053,2017.csv,2017,0.0,1.0
26394,The Militant,5052,0,5052,2014.csv,2014,0.0,1.0
26395,Zoom Hunting,5050,0,5050,2010.csv,2010,0.0,1.0
26396,Silence Is a Falling Body,5048,0,5048,2018.csv,2018,0.0,1.0
26397,Blooberg,5046,0,5046,2015.csv,2015,0.0,1.0
26398,Behind the Dark Night,5043,0,5043,2018.csv,2018,0.0,1.0
26399,Bang! Bang!,5042,5042,0,2020.csv,2020,1.0,0.0
26400,Into the Dark,5036,0,5036,2012.csv,2012,0.0,1.0
26401,Memory Card,5036,0,5036,2018.csv,2018,0.0,1.0
26402,After School,5035,0,5035,2010.csv,2010,0.0,1.0
26403,Scream for Me Sarajevo,5035,0,5035,2018.csv,2018,0.0,1.0
26404,Luz Obscura,5033,0,5033,2018.csv,2018,0.0,1.0
26405,Arrête ton cinéma!,5033,0,5033,2016.csv,2016,0.0,1.0
26406,Dreamcatcher,5033,0,5033,2021.csv,2021,0.0,1.0
26407,Chulas Fronteras,5021,5021,0,2019.csv,2019,1.0,0.0
26408,Miss Oyu,5020,0,5020,2017.csv,2017,0.0,1.0
26409,Tarzan's Testicles,5017,0,5017,2017.csv,2017,0.0,1.0
26410,In the Garden of Sounds,5017,0,5017,2012.csv,2012,0.0,1.0
26411,My Hunter's Heart,5015,0,5015,2011.csv,2011,0.0,1.0
26412,Macabro,5015,0,5015,2020.csv,2020,0.0,1.0
26413,The Sleepwalker,5012,5012,0,2014.csv,2014,1.0,0.0
26414,Yarim Kalan,5012,0,5012,2017.csv,2017,0.0,1.0
26415,Downtown Express,5010,5010,0,2012.csv,2012,1.0,0.0
26416,The Texture of Falling,5010,5010,0,2018.csv,2018,1.0,0.0
26417,Social Animals,5007,5007,0,2018.csv,2018,1.0,0.0
26418,Yarim ile Yamalak,5006,0,5006,2018.csv,2018,0.0,1.0
26419,The Garden,5006,5006,0,2019.csv,2019,1.0,0.0
26420,Captain Abu Raed 2011 Re-release,5006,0,5006,2011.csv,2011,0.0,1.0
26421,Inches from the Ground,5004,0,5004,2016.csv,2016,0.0,1.0
26422,An L.A. Minute,5004,5004,0,2018.csv,2018,1.0,0.0
26423,Nagasaki: Memories of My Son 2017 Re-release,5001,0,5001,2017.csv,2017,0.0,1.0
26424,Miedzy nami dobrze jest,5001,0,5001,2015.csv,2015,0.0,1.0
26425,Newlyweds,5000,5000,0,2012.csv,2012,1.0,0.0
26426,Aadukalam,4997,0,4997,2011.csv,2011,0.0,1.0
26427,Sseon-ki-seu Pae-mil-li,4996,0,4996,2019.csv,2019,0.0,1.0
26428,The Thief Who Stared at the Thief,4995,0,4995,2018.csv,2018,0.0,1.0
26429,El Almuerzo,4995,0,4995,2015.csv,2015,0.0,1.0
26430,Unsymmetric Battle,4992,0,4992,2019.csv,2019,0.0,1.0
26431,The Baker's Wife,4991,0,4991,2018.csv,2018,0.0,1.0
26432,The Pigeon,4988,0,4988,2018.csv,2018,0.0,1.0
26433,I want to be with you,4984,0,4984,2018.csv,2018,0.0,1.0
26434,Super kids' attack,4979,0,4979,2018.csv,2018,0.0,1.0
26435,Weekend of a Champion,4976,4100,876,2013.csv,2013,0.8239549839228296,0.1760450160771704
26436,Bringing Up Bobby,4975,4975,0,2012.csv,2012,1.0,0.0
26437,Elizabeth Harvest,4973,0,4973,2018.csv,2018,0.0,1.0
26438,Smitty,4973,0,4973,2012.csv,2012,0.0,1.0
26439,Mr. Marumakan,4968,0,4968,2012.csv,2012,0.0,1.0
26440,Joe Pecado,4963,0,4963,2014.csv,2014,0.0,1.0
26441,Dhilluku Dhuddu,4963,0,4963,2016.csv,2016,0.0,1.0
26442,Jackson Durai,4963,0,4963,2016.csv,2016,0.0,1.0
26443,8 hlav sílenství,4962,0,4962,2017.csv,2017,0.0,1.0
26444,An Engineer Imagines,4962,0,4962,2019.csv,2019,0.0,1.0
26445,sxtape,4961,0,4961,2014.csv,2014,0.0,1.0
26446,Futaba kara tooku hanarete,4960,4960,0,2013.csv,2013,1.0,0.0
26447,The Clown 2013 Re-release,4958,0,4958,2013.csv,2013,0.0,1.0
26448,Sleeper's Wake,4956,0,4956,2013.csv,2013,0.0,1.0
26449,Herman's House,4956,4956,0,2013.csv,2013,1.0,0.0
26450,To Die Like a Man,4955,4029,926,2011.csv,2011,0.8131180625630676,0.1868819374369324
26451,SBK: The Movie,4950,4950,0,2015.csv,2015,1.0,0.0
26452,Breaking the Bank,4947,0,4947,2016.csv,2016,0.0,1.0
26453,Alelí,4946,0,4946,2020.csv,2020,0.0,1.0
26454,Axolotl Overkill,4944,0,4944,2017.csv,2017,0.0,1.0
26455,Tournament,4942,4942,0,2017.csv,2017,1.0,0.0
26456,Company Town,4934,4934,0,2017.csv,2017,1.0,0.0
26457,Tralas Luces,4933,0,4933,2011.csv,2011,0.0,1.0
26458,Oh! My God Returns,4928,0,4928,2017.csv,2017,0.0,1.0
26459,God Bless Ozzy Osbourne,4927,0,4927,2011.csv,2011,0.0,1.0
26460,Yarn,4925,0,4925,2016.csv,2016,0.0,1.0
26461,Klinch,4920,0,4920,2015.csv,2015,0.0,1.0
26462,Ekam: Son of Soil,4919,0,4919,2010.csv,2010,0.0,1.0
26463,Greystone Park 2017 Re-release,4918,0,4918,2017.csv,2017,0.0,1.0
26464,Supporting Characters,4917,4917,0,2013.csv,2013,1.0,0.0
26465,El almanaque 2015 Re-release,4916,0,4916,2015.csv,2015,0.0,1.0
26466,However,4915,0,4915,2017.csv,2017,0.0,1.0
26467,Zama Zama,4912,0,4912,2012.csv,2012,0.0,1.0
26468,El peor día de mi vida,4911,0,4911,2016.csv,2016,0.0,1.0
26469,Mambattiyan,4907,0,4907,2011.csv,2011,0.0,1.0
26470,Naciye,4904,0,4904,2016.csv,2016,0.0,1.0
26471,Vulcania,4901,0,4901,2016.csv,2016,0.0,1.0
26472,Ordinary People,4900,0,4900,2010.csv,2010,0.0,1.0
26473,Nekonade,4900,0,4900,2010.csv,2010,0.0,1.0
26474,Guidance,4900,4900,0,2015.csv,2015,1.0,0.0
26475,Malek,4898,4898,0,2019.csv,2019,1.0,0.0
26476,Türkisch für Anfänger 2013 Re-release,4895,0,4895,2013.csv,2013,0.0,1.0
26477,Nandalala,4892,0,4892,2010.csv,2010,0.0,1.0
26478,The Dead,4891,0,4891,2011.csv,2011,0.0,1.0
26479,Offender 2015 Re-release,4891,0,4891,2015.csv,2015,0.0,1.0
26480,Lawrence of Arabia,4883,0,4883,2020.csv,2020,0.0,1.0
26481,El culo del mundo,4881,0,4881,2014.csv,2014,0.0,1.0
26482,On Wheels,4881,0,4881,2018.csv,2018,0.0,1.0
26483,Kids on the Block,4881,0,4881,2019.csv,2019,0.0,1.0
26484,Vivir Contra El Tiempo,4877,0,4877,2012.csv,2012,0.0,1.0
26485,Ev Kira Semt Bizim,4873,0,4873,2018.csv,2018,0.0,1.0
26486,Revelation Road 2: The Sea of Glass and Fire,4871,4871,0,2013.csv,2013,1.0,0.0
26487,Nothing Bad Can Happen,4870,4870,0,2014.csv,2014,1.0,0.0
26488,Women,4864,0,4864,2021.csv,2021,0.0,1.0
26489,Babaannem,4864,0,4864,2016.csv,2016,0.0,1.0
26490,Delírio em Las Vedras,4855,0,4855,2017.csv,2017,0.0,1.0
26491,Virus of Fear,4855,0,4855,2015.csv,2015,0.0,1.0
26492,L'estate d'inverno,4853,0,4853,2010.csv,2010,0.0,1.0
26493,La Soñada,4851,0,4851,2017.csv,2017,0.0,1.0
26494,Hitler in Hollywood,4850,0,4850,2011.csv,2011,0.0,1.0
26495,Landscape of Music,4849,0,4849,2019.csv,2019,0.0,1.0
26496,Crepitus,4846,4846,0,2019.csv,2019,1.0,0.0
26497,Call Her Applebroog,4842,4842,0,2016.csv,2016,1.0,0.0
26498,Project Marathwada,4838,0,4838,2016.csv,2016,0.0,1.0
26499,White People,4838,0,4838,2015.csv,2015,0.0,1.0
26500,Naufragio,4836,0,4836,2011.csv,2011,0.0,1.0
26501,Stretch,4833,0,4833,2015.csv,2015,0.0,1.0
26502,Ballet Blanc,4832,4832,0,2019.csv,2019,1.0,0.0
26503,Yes PyeongChang,4831,0,4831,2018.csv,2018,0.0,1.0
26504,Twice Shy,4831,0,4831,2017.csv,2017,0.0,1.0
26505,Celda 211 2013 Re-release,4831,0,4831,2013.csv,2013,0.0,1.0
26506,Mulheres no Poder,4827,0,4827,2015.csv,2015,0.0,1.0
26507,As Boas Intenções,4826,0,4826,2019.csv,2019,0.0,1.0
26508,La mujer de los perros,4826,0,4826,2015.csv,2015,0.0,1.0
26509,The Earth Is Blue as an Orange,4818,0,4818,2020.csv,2020,0.0,1.0
26510,Chastnoe pionerskoe 3,4817,0,4817,2017.csv,2017,0.0,1.0
26511,Ferlinghetti: A Rebirth of Wonder,4816,4816,0,2013.csv,2013,1.0,0.0
26512,The Three Kings,4811,0,4811,2020.csv,2020,0.0,1.0
26513,Between the Canals,4809,0,4809,2011.csv,2011,0.0,1.0
26514,The Pursuer,4807,0,4807,2010.csv,2010,0.0,1.0
26515,Bestezuelas,4806,0,4806,2011.csv,2011,0.0,1.0
26516,Arena,4800,0,4800,2010.csv,2010,0.0,1.0
26517,An American in Paris 2011 Re-release,4795,0,4795,2011.csv,2011,0.0,1.0
26518,Margarita 2,4795,0,4795,2018.csv,2018,0.0,1.0
26519,Jaffa 2010 Re-release,4792,0,4792,2010.csv,2010,0.0,1.0
26520,Ottam,4791,0,4791,2019.csv,2019,0.0,1.0
26521,Fury 2020 Re-release,4791,0,4791,2020.csv,2020,0.0,1.0
26522,And So It Goes 2018 Re-release,4784,0,4784,2018.csv,2018,0.0,1.0
26523,"Half The Road: The Passion, Pitfalls & Power of Women's Professional Cycling",4783,4783,0,2014.csv,2014,1.0,0.0
26524,Destination Unknown,4782,0,4782,2017.csv,2017,0.0,1.0
26525,Family Instinct,4781,0,4781,2010.csv,2010,0.0,1.0
26526,Last Call,4779,4779,0,2020.csv,2020,1.0,0.0
26527,The Enchanting Phantom,4779,0,4779,2020.csv,2020,0.0,1.0
26528,Bodyguard-Na-Hak (The Protector),4778,0,4778,2020.csv,2020,0.0,1.0
26529,Sella Turcica,4773,0,4773,2018.csv,2018,0.0,1.0
26530,Behind the White Glasses,4770,2223,2547,2016.csv,2016,0.4660377358490566,0.5339622641509434
26531,Lek And The Dogs,4767,0,4767,2018.csv,2018,0.0,1.0
26532,ID2: Shadwell Army,4764,0,4764,2016.csv,2016,0.0,1.0
26533,In My Steps,4755,0,4755,2018.csv,2018,0.0,1.0
26534,Always: Sunset on Third Street 2010 Re-release,4754,0,4754,2010.csv,2010,0.0,1.0
26535,Genocidal Organ,4752,0,4752,2017.csv,2017,0.0,1.0
26536,The Bag of Flour,4751,0,4751,2013.csv,2013,0.0,1.0
26537,Guns and Roses,4745,0,4745,2012.csv,2012,0.0,1.0
26538,The Evil That Men Do,4742,0,4742,2016.csv,2016,0.0,1.0
26539,Rustum,4738,0,4738,2019.csv,2019,0.0,1.0
26540,Licu: A Romanian Story,4738,0,4738,2018.csv,2018,0.0,1.0
26541,The Lost Lion Kingdom,4731,0,4731,2020.csv,2020,0.0,1.0
26542,Tous les rêves du monde,4730,0,4730,2017.csv,2017,0.0,1.0
26543,Goldfinger 2020 Re-release,4729,0,4729,2020.csv,2020,0.0,1.0
26544,Soseongri,4726,0,4726,2018.csv,2018,0.0,1.0
26545,Return of the Atom,4725,0,4725,2015.csv,2015,0.0,1.0
26546,The Ladykillers 2020 Re-release,4722,0,4722,2020.csv,2020,0.0,1.0
26547,Bug 2010 Re-release,4721,0,4721,2010.csv,2010,0.0,1.0
26548,The Sex of the Mothers,4718,0,4718,2012.csv,2012,0.0,1.0
26549,Balakrishnudu,4715,0,4715,2017.csv,2017,0.0,1.0
26550,Umudun Kiyisinda,4714,0,4714,2017.csv,2017,0.0,1.0
26551,Mount St. Elias 2013 Re-release,4713,0,4713,2013.csv,2013,0.0,1.0
26552,Menos que Nada,4710,0,4710,2012.csv,2012,0.0,1.0
26553,Miss Hill: Making Dance Matter,4706,4706,0,2015.csv,2015,1.0,0.0
26554,Russian Libertine,4705,0,4705,2012.csv,2012,0.0,1.0
26555,Shot,4701,4701,0,2017.csv,2017,1.0,0.0
26556,Farewell Ella Bella,4698,0,4698,2018.csv,2018,0.0,1.0
26557,A Shanghai Bride,4698,0,4698,2016.csv,2016,0.0,1.0
26558,Marinoni: The Fire in the Frame,4696,4696,0,2016.csv,2016,1.0,0.0
26559,The German Friend 2014 Re-release,4693,0,4693,2014.csv,2014,0.0,1.0
26560,Casanova Variations,4691,0,4691,2016.csv,2016,0.0,1.0
26561,Las flores de mi familia,4691,0,4691,2012.csv,2012,0.0,1.0
26562,Farewell Amor,4689,4689,0,2020.csv,2020,1.0,0.0
26563,The Other Side of Everything,4685,4685,0,2018.csv,2018,1.0,0.0
26564,Kaali,4684,0,4684,2018.csv,2018,0.0,1.0
26565,Tvminiuni: Zlodej Otazek,4675,0,4675,2019.csv,2019,0.0,1.0
26566,Passing Summer,4674,0,4674,2018.csv,2018,0.0,1.0
26567,Death Metal Angola,4674,4674,0,2014.csv,2014,1.0,0.0
26568,El Barrio De Los Judios,4674,0,4674,2011.csv,2011,0.0,1.0
26569,Anita e Garibaldi,4673,0,4673,2013.csv,2013,0.0,1.0
26570,Dark Encounter,4672,0,4672,2019.csv,2019,0.0,1.0
26571,Birds Without Names,4670,0,4670,2018.csv,2018,0.0,1.0
26572,A Christmas Star,4670,0,4670,2015.csv,2015,0.0,1.0
26573,The Long Dumb Road,4667,4667,0,2018.csv,2018,1.0,0.0
26574,Debaixo do Céu,4665,0,4665,2019.csv,2019,0.0,1.0
26575,Blood on the Mountain,4664,4664,0,2016.csv,2016,1.0,0.0
26576,Night School,4663,4663,0,2017.csv,2017,1.0,0.0
26577,Alaba Zintzoa,4663,0,4663,2013.csv,2013,0.0,1.0
26578,Present Tense,4662,0,4662,2013.csv,2013,0.0,1.0
26579,I Love You Both,4661,4661,0,2017.csv,2017,1.0,0.0
26580,No Ordinary Love,4656,4656,0,2020.csv,2020,1.0,0.0
26581,The Other Man 2013 Re-release,4655,0,4655,2013.csv,2013,0.0,1.0
26582,Alis Ubbo,4651,0,4651,2020.csv,2020,0.0,1.0
26583,Shakespeare-Wallah,4650,4650,0,2017.csv,2017,1.0,0.0
26584,The Last Autumn,4649,0,4649,2019.csv,2019,0.0,1.0
26585,El Topo,4648,0,4648,2020.csv,2020,0.0,1.0
26586,The Lost Reflection: Confessions of a Kept Woman,4646,0,4646,2018.csv,2018,0.0,1.0
26587,Against the Sun,4646,4646,0,2015.csv,2015,1.0,0.0
26588,Richard Linklater: Dream Is Destiny,4641,0,4641,2016.csv,2016,0.0,1.0
26589,Revelator,4633,0,4633,2018.csv,2018,0.0,1.0
26590,Until I Lose My Breath,4631,0,4631,2015.csv,2015,0.0,1.0
26591,All About Secrets,4631,0,4631,2017.csv,2017,0.0,1.0
26592,Seeds of Time,4630,4630,0,2015.csv,2015,1.0,0.0
26593,"From My Window, Without a Home...",4630,0,4630,2010.csv,2010,0.0,1.0
26594,Crossroads,4629,0,4629,2019.csv,2019,0.0,1.0
26595,Moses Without Rod,4618,0,4618,2014.csv,2014,0.0,1.0
26596,Mind Decoding,4616,0,4616,2016.csv,2016,0.0,1.0
26597,Miss Stevens,4611,4611,0,2016.csv,2016,1.0,0.0
26598,Wander,4609,0,4609,2021.csv,2021,0.0,1.0
26599,The Young Girls of Rochefort 2017 Re-release,4606,0,4606,2017.csv,2017,0.0,1.0
26600,Waragat Gamia,4605,0,4605,2020.csv,2020,0.0,1.0
26601,No olho da rua,4604,0,4604,2011.csv,2011,0.0,1.0
26602,Johnny Guitar,4604,0,4604,2016.csv,2016,0.0,1.0
26603,The Automatic Hate,4603,4603,0,2016.csv,2016,1.0,0.0
26604,Rakshasudu,4602,0,4602,2019.csv,2019,0.0,1.0
26605,Operasiones espesiales,4600,0,4600,2014.csv,2014,0.0,1.0
26606,The Bad Nun,4594,0,4594,2018.csv,2018,0.0,1.0
26607,The Best of Times 2010 Re-release,4590,0,4590,2010.csv,2010,0.0,1.0
26608,Propios y extraños,4586,0,4586,2010.csv,2010,0.0,1.0
26609,Les Dames,4583,0,4583,2019.csv,2019,0.0,1.0
26610,Panjaban -Love Rules Hearts,4582,0,4582,2010.csv,2010,0.0,1.0
26611,Mariel espera,4576,0,4576,2017.csv,2017,0.0,1.0
26612,Protector 2010 Re-release,4576,2968,1608,2010.csv,2010,0.6486013986013986,0.3513986013986014
26613,Konvoy,4575,0,4575,2012.csv,2012,0.0,1.0
26614,Rahe Chardi Kala Punjab Di,4574,0,4574,2012.csv,2012,0.0,1.0
26615,Snjór og Salóme,4572,0,4572,2017.csv,2017,0.0,1.0
26616,Talking About Trees,4572,0,4572,2020.csv,2020,0.0,1.0
26617,Search Party 2016 Re-release,4571,4571,0,2016.csv,2016,1.0,0.0
26618,Before,4571,0,4571,2013.csv,2013,0.0,1.0
26619,Reverse,4569,0,4569,2016.csv,2016,0.0,1.0
26620,Özür Dilerim,4567,0,4567,2013.csv,2013,0.0,1.0
26621,"L7: Hrafnar, Sóleyjar og Myrra",4566,0,4566,2011.csv,2011,0.0,1.0
26622,Rem,4565,0,4565,2020.csv,2020,0.0,1.0
26623,13. Miguel Poveda,4563,0,4563,2015.csv,2015,0.0,1.0
26624,Please Love Her,4562,0,4562,2017.csv,2017,0.0,1.0
26625,Smiling Through the Apocalypse,4560,4560,0,2014.csv,2014,1.0,0.0
26626,El Medico: The Cubaton Story,4560,0,4560,2012.csv,2012,0.0,1.0
26627,All Is Bright,4556,4556,0,2013.csv,2013,1.0,0.0
26628,How to Stop Being a Loser,4556,0,4556,2011.csv,2011,0.0,1.0
26629,Being a Human Person,4554,0,4554,2020.csv,2020,0.0,1.0
26630,Chi La Sow?,4551,0,4551,2018.csv,2018,0.0,1.0
26631,A Boy Called Po,4550,4550,0,2017.csv,2017,1.0,0.0
26632,Casper and Emma's Wonderful Christmas 2015 Re-release,4549,0,4549,2015.csv,2015,0.0,1.0
26633,Promised Lands,4546,4546,0,2010.csv,2010,1.0,0.0
26634,Elma Dersem Çik,4544,0,4544,2019.csv,2019,0.0,1.0
26635,Do It Yourself,4541,0,4541,2018.csv,2018,0.0,1.0
26636,Schemes of Affection,4539,0,4539,2010.csv,2010,0.0,1.0
26637,Arlo: The Burping Pig,4539,0,4539,2016.csv,2016,0.0,1.0
26638,Freakonomics 2012 Re-release,4538,0,4538,2012.csv,2012,0.0,1.0
26639,Tokyo! 2011 Re-release,4535,0,4535,2011.csv,2011,0.0,1.0
26640,Here Comes the Devil,4534,4534,0,2013.csv,2013,1.0,0.0
26641,Ata Pata Lapatta,4531,0,4531,2012.csv,2012,0.0,1.0
26642,Chatter,4531,0,4531,2019.csv,2019,0.0,1.0
26643,Weightless,4530,4461,69,2018.csv,2018,0.9847682119205298,0.015231788079470199
26644,Unrelated 2014 Re-release,4529,4529,0,2014.csv,2014,1.0,0.0
26645,Egreti Gelin Ladik,4529,0,4529,2018.csv,2018,0.0,1.0
26646,Manipulated,4527,0,4527,2019.csv,2019,0.0,1.0
26647,Paris Opera Ballet: Giselle,4524,0,4524,2020.csv,2020,0.0,1.0
26648,Cruz del Sur,4522,0,4522,2012.csv,2012,0.0,1.0
26649,On the Dream's Shore,4521,0,4521,2019.csv,2019,0.0,1.0
26650,Valter,4520,0,4520,2012.csv,2012,0.0,1.0
26651,La patente,4517,0,4517,2012.csv,2012,0.0,1.0
26652,The Meerkats 2010 Re-release,4514,0,4514,2010.csv,2010,0.0,1.0
26653,We Are Family 2018 Re-release,4513,0,4513,2018.csv,2018,0.0,1.0
26654,Another Silence,4512,0,4512,2012.csv,2012,0.0,1.0
26655,Golden Youth,4509,0,4509,2019.csv,2019,0.0,1.0
26656,Synchronicity,4505,4505,0,2016.csv,2016,1.0,0.0
26657,Vakfolt,4505,0,4505,2017.csv,2017,0.0,1.0
26658,Axel: The Biggest Little Hero 2016 Re-release,4501,0,4501,2016.csv,2016,0.0,1.0
26659,5 (Cinque),4498,0,4498,2011.csv,2011,0.0,1.0
26660,Retreat,4498,0,4498,2011.csv,2011,0.0,1.0
26661,Motherland or Death,4494,0,4494,2011.csv,2011,0.0,1.0
26662,Gromozeka,4492,0,4492,2011.csv,2011,0.0,1.0
26663,Only God Forgives 2020 Re-release,4490,0,4490,2020.csv,2020,0.0,1.0
26664,Mean Dreams 2019 Re-release,4489,0,4489,2019.csv,2019,0.0,1.0
26665,The Pulitzer at 100,4489,4489,0,2017.csv,2017,1.0,0.0
26666,I'm Leaving Now,4488,4488,0,2019.csv,2019,1.0,0.0
26667,Good Business,4483,0,4483,2010.csv,2010,0.0,1.0
26668,Makino Legend,4483,0,4483,2017.csv,2017,0.0,1.0
26669,The Element of Crime,4483,0,4483,2019.csv,2019,0.0,1.0
26670,West Side Story 2011 Re-release,4472,0,4472,2011.csv,2011,0.0,1.0
26671,Atrocious,4472,0,4472,2011.csv,2011,0.0,1.0
26672,The Song of Scorpions,4470,0,4470,2018.csv,2018,0.0,1.0
26673,German Concentration Camps Factual Survey,4468,4468,0,2017.csv,2017,1.0,0.0
26674,Beloved Sisters 2016 Re-release,4465,0,4465,2016.csv,2016,0.0,1.0
26675,Sprache: Sex,4463,0,4463,2015.csv,2015,0.0,1.0
26676,Cure,4458,0,4458,2011.csv,2011,0.0,1.0
26677,Das Zimmermädchen Lynn,4457,0,4457,2015.csv,2015,0.0,1.0
26678,Agent Sai Srinivasa Athreya,4454,0,4454,2019.csv,2019,0.0,1.0
26679,The Beaches of Agnès 2018 Re-release,4453,0,4453,2018.csv,2018,0.0,1.0
26680,En Uzun Gece,4452,0,4452,2019.csv,2019,0.0,1.0
26681,Make Yourself at Home,4452,0,4452,2010.csv,2010,0.0,1.0
26682,The Air I Breathe 2011 Re-release,4450,0,4450,2011.csv,2011,0.0,1.0
26683,The Passing,4449,0,4449,2016.csv,2016,0.0,1.0
26684,Doggy Man,4449,0,4449,2018.csv,2018,0.0,1.0
26685,"Farewell, Herr Schwarz",4445,4445,0,2015.csv,2015,1.0,0.0
26686,KJ: Music and Life 2011 Re-release,4444,0,4444,2011.csv,2011,0.0,1.0
26687,Generation Iron 2,4439,4439,0,2017.csv,2017,1.0,0.0
26688,Everything Will Be Fine 2011 Re-release,4438,0,4438,2011.csv,2011,0.0,1.0
26689,Ferrari: Race to Immortality,4433,0,4433,2017.csv,2017,0.0,1.0
26690,Ville-Marie,4432,0,4432,2016.csv,2016,0.0,1.0
26691,Change Nothing,4432,0,4432,2010.csv,2010,0.0,1.0
26692,Buddha 2: The Endless Journey,4430,0,4430,2014.csv,2014,0.0,1.0
26693,Kervan 1915,4430,0,4430,2017.csv,2017,0.0,1.0
26694,The Long Night of Francisco Sanctis 2018 Re-release,4425,0,4425,2018.csv,2018,0.0,1.0
26695,Sadakat,4425,0,4425,2016.csv,2016,0.0,1.0
26696,No One Knows About Persian Cats 2011 Re-release,4425,0,4425,2011.csv,2011,0.0,1.0
26697,Child Eater,4422,0,4422,2016.csv,2016,0.0,1.0
26698,The New Watchdogs,4420,0,4420,2012.csv,2012,0.0,1.0
26699,Jukus,4418,0,4418,2018.csv,2018,0.0,1.0
26700,Gözümün nûru,4410,0,4410,2013.csv,2013,0.0,1.0
26701,The Blue Angel,4410,0,4410,2019.csv,2019,0.0,1.0
26702,The Shade Shepherd,4409,4409,0,2020.csv,2020,1.0,0.0
26703,Dead Pigs,4409,0,4409,2019.csv,2019,0.0,1.0
26704,Evolution of Evil,4405,0,4405,2018.csv,2018,0.0,1.0
26705,SGT. Will Gardner,4405,4405,0,2019.csv,2019,1.0,0.0
26706,The Truth About Emanuel,4404,4404,0,2014.csv,2014,1.0,0.0
26707,The Peacemaker,4400,4400,0,2018.csv,2018,1.0,0.0
26708,One Hundred and One Dalmatians 2018 Re-release,4395,0,4395,2018.csv,2018,0.0,1.0
26709,Red Spring,4394,0,4394,2019.csv,2019,0.0,1.0
26710,30-LOVE,4392,4392,0,2017.csv,2017,1.0,0.0
26711,The Sale of Paradise,4390,0,4390,2013.csv,2013,0.0,1.0
26712,Noble 2016 Re-release,4388,0,4388,2016.csv,2016,0.0,1.0
26713,The City of Your Final Destination 2012 Re-release,4387,0,4387,2012.csv,2012,0.0,1.0
26714,Obra 67,4386,0,4386,2014.csv,2014,0.0,1.0
26715,Guard - Ohrana,4384,0,4384,2016.csv,2016,0.0,1.0
26716,Between Us,4380,4380,0,2013.csv,2013,1.0,0.0
26717,The End of Time,4375,4375,0,2013.csv,2013,1.0,0.0
26718,The Catechism Cataclysm,4373,4373,0,2011.csv,2011,1.0,0.0
26719,The Woman Who Left,4373,3974,399,2017.csv,2017,0.9087582895037731,0.09124171049622684
26720,Earth Madness,4372,0,4372,2010.csv,2010,0.0,1.0
26721,Login,4371,0,4371,2016.csv,2016,0.0,1.0
26722,Zohak,4371,0,4371,2018.csv,2018,0.0,1.0
26723,The Party's Just Beginning,4371,4145,226,2018.csv,2018,0.9482955845344315,0.05170441546556852
26724,National Theatre Live: Nation,4369,0,4369,2010.csv,2010,0.0,1.0
26725,Check,4363,0,4363,2021.csv,2021,0.0,1.0
26726,Jinkusu!!!,4363,0,4363,2014.csv,2014,0.0,1.0
26727,The Flower of Kim Jong II,4362,4362,0,2010.csv,2010,1.0,0.0
26728,RCL: Ridotte capacità lavorative,4360,0,4360,2010.csv,2010,0.0,1.0
26729,One Note at a Time,4355,0,4355,2018.csv,2018,0.0,1.0
26730,Tales of Vesperia: The First Strike 2010 Re-release,4351,0,4351,2010.csv,2010,0.0,1.0
26731,El Delirio,4351,0,4351,2017.csv,2017,0.0,1.0
26732,Streaker,4348,0,4348,2018.csv,2018,0.0,1.0
26733,Ivana the Terrible,4345,0,4345,2020.csv,2020,0.0,1.0
26734,I Am Your Father,4338,0,4338,2015.csv,2015,0.0,1.0
26735,Children of Paradise 2017 Re-release,4338,0,4338,2017.csv,2017,0.0,1.0
26736,Tito and the Birds,4332,4332,0,2019.csv,2019,1.0,0.0
26737,The Jungle Book 2020 Re-release,4329,0,4329,2020.csv,2020,0.0,1.0
26738,Terror Strike,4328,0,4328,2018.csv,2018,0.0,1.0
26739,#Moscow on the Beach,4326,0,4326,2019.csv,2019,0.0,1.0
26740,"Animus Animalis (a story about People, Animals and Things)",4326,0,4326,2019.csv,2019,0.0,1.0
26741,Another News Story,4325,0,4325,2018.csv,2018,0.0,1.0
26742,The Greatest Wish 3,4324,0,4324,2012.csv,2012,0.0,1.0
26743,Endless Poetry 2018 Re-release,4323,0,4323,2018.csv,2018,0.0,1.0
26744,Raven the Little Rascal - The Big Race 2018 Re-release,4323,0,4323,2018.csv,2018,0.0,1.0
26745,Shady Lady,4322,0,4322,2012.csv,2012,0.0,1.0
26746,On Meditation,4322,4322,0,2016.csv,2016,1.0,0.0
26747,Bromance,4314,0,4314,2016.csv,2016,0.0,1.0
26748,Alice T.,4312,0,4312,2018.csv,2018,0.0,1.0
26749,El-Deccur,4311,0,4311,2020.csv,2020,0.0,1.0
26750,Merry Men: The Real Yoruba Demons,4309,0,4309,2018.csv,2018,0.0,1.0
26751,Days of Grace 2015 Re-release,4308,4308,0,2015.csv,2015,1.0,0.0
26752,Siyah Karga,4307,0,4307,2016.csv,2016,0.0,1.0
26753,The Tower,4305,1117,3188,2014.csv,2014,0.259465737514518,0.740534262485482
26754,Maleficarum,4303,0,4303,2012.csv,2012,0.0,1.0
26755,The Movement 2018 Re-release,4302,0,4302,2018.csv,2018,0.0,1.0
26756,Auto Shop of Horrors,4300,4300,0,2016.csv,2016,1.0,0.0
26757,Trap for Cinderella,4298,0,4298,2013.csv,2013,0.0,1.0
26758,Perfect Health,4297,0,4297,2017.csv,2017,0.0,1.0
26759,Reshinn: Sangre De Anaconda,4296,0,4296,2011.csv,2011,0.0,1.0
26760,The Fate of Lee Khan,4295,4295,0,2019.csv,2019,1.0,0.0
26761,From the Life of the Marionettes,4293,0,4293,2017.csv,2017,0.0,1.0
26762,Curse of the Demon,4292,0,4292,2016.csv,2016,0.0,1.0
26763,Art Is... The Permanent Revolution,4291,4291,0,2012.csv,2012,1.0,0.0
26764,Isabellino Sunce,4290,0,4290,2018.csv,2018,0.0,1.0
26765,Geçerken Ugradim,4286,0,4286,2020.csv,2020,0.0,1.0
26766,The Basement,4286,0,4286,2018.csv,2018,0.0,1.0
26767,State Like Sleep,4282,4282,0,2019.csv,2019,1.0,0.0
26768,Set Fire to the Stars,4280,4280,0,2015.csv,2015,1.0,0.0
26769,Barter,4279,0,4279,2016.csv,2016,0.0,1.0
26770,Al Mallu,4279,0,4279,2020.csv,2020,0.0,1.0
26771,Man at Bath,4278,0,4278,2010.csv,2010,0.0,1.0
26772,Markens grøde,4272,0,4272,2011.csv,2011,0.0,1.0
26773,The Sky Court,4270,0,4270,2012.csv,2012,0.0,1.0
26774,Murder on the Orient Express 2020 Re-release,4270,0,4270,2020.csv,2020,0.0,1.0
26775,Restaurant from the Sky,4269,0,4269,2020.csv,2020,0.0,1.0
26776,Battle for the City,4267,0,4267,2011.csv,2011,0.0,1.0
26777,"Loimata, The Sweetest Tears",4266,0,4266,2020.csv,2020,0.0,1.0
26778,Xora,4265,0,4265,2012.csv,2012,0.0,1.0
26779,The Knife of Don Juan,4254,4254,0,2015.csv,2015,1.0,0.0
26780,My Father Die,4252,4252,0,2017.csv,2017,1.0,0.0
26781,El cultivo de la flor invisible,4250,0,4250,2012.csv,2012,0.0,1.0
26782,Las tres rosas,4249,0,4249,2018.csv,2018,0.0,1.0
26783,Last Prince of Atlantis,4237,0,4237,2019.csv,2019,0.0,1.0
26784,Aftershock 2013 Re-release,4235,0,4235,2013.csv,2013,0.0,1.0
26785,Abbas'in Melekleri,4234,0,4234,2016.csv,2016,0.0,1.0
26786,Gelo,4234,0,4234,2016.csv,2016,0.0,1.0
26787,Investigación policial,4230,0,4230,2015.csv,2015,0.0,1.0
26788,Sahir Deep Web,4229,0,4229,2019.csv,2019,0.0,1.0
26789,Pha Phan Kor Daeng,4228,0,4228,2012.csv,2012,0.0,1.0
26790,Knistern der Zeit - Christoph Schlingensief und sein Operndorf in Burkina Faso,4226,0,4226,2012.csv,2012,0.0,1.0
26791,Cocote,4224,3815,409,2018.csv,2018,0.9031723484848485,0.09682765151515152
26792,The Earrings of Madame De... 2018 Re-release,4223,0,4223,2018.csv,2018,0.0,1.0
26793,Of Fish and Foe,4223,0,4223,2019.csv,2019,0.0,1.0
26794,The Price of Desire,4223,0,4223,2016.csv,2016,0.0,1.0
26795,Silent Meeting,4222,0,4222,2017.csv,2017,0.0,1.0
26796,Maximum Ride,4218,4218,0,2016.csv,2016,1.0,0.0
26797,The Mystery of D.B. Cooper,4218,0,4218,2020.csv,2020,0.0,1.0
26798,De leur vivant,4215,0,4215,2012.csv,2012,0.0,1.0
26799,Stella's Last Weekend,4215,4215,0,2018.csv,2018,1.0,0.0
26800,Breaking a Monster,4212,4212,0,2016.csv,2016,1.0,0.0
26801,Edith Walks,4209,0,4209,2017.csv,2017,0.0,1.0
26802,Interlude in Prague,4209,0,4209,2017.csv,2017,0.0,1.0
26803,Construção,4200,0,4200,2012.csv,2012,0.0,1.0
26804,9,4199,0,4199,2019.csv,2019,0.0,1.0
26805,Jind Jaan,4199,0,4199,2019.csv,2019,0.0,1.0
26806,Free the Nipple,4198,4198,0,2014.csv,2014,1.0,0.0
26807,Perfect 10,4198,0,4198,2020.csv,2020,0.0,1.0
26808,Yarim Kalan Mucize,4198,0,4198,2013.csv,2013,0.0,1.0
26809,The Dirty Saints,4198,0,4198,2011.csv,2011,0.0,1.0
26810,El padre de mis hijos,4198,0,4198,2018.csv,2018,0.0,1.0
26811,Druzinica,4195,0,4195,2017.csv,2017,0.0,1.0
26812,Heiran,4195,0,4195,2010.csv,2010,0.0,1.0
26813,Slanchevo,4194,0,4194,2013.csv,2013,0.0,1.0
26814,No Place,4194,4194,0,2021.csv,2021,1.0,0.0
26815,Helena from the Wedding,4190,4190,0,2010.csv,2010,1.0,0.0
26816,Among the Believers,4189,4189,0,2016.csv,2016,1.0,0.0
26817,Silent Night 2018 Re-release,4187,0,4187,2018.csv,2018,0.0,1.0
26818,Winds,4185,0,4185,2013.csv,2013,0.0,1.0
26819,Plane Tree,4183,0,4183,2019.csv,2019,0.0,1.0
26820,Kingdom of Ants,4183,0,4183,2012.csv,2012,0.0,1.0
26821,Katapadi Kattappa,4182,0,4182,2019.csv,2019,0.0,1.0
26822,Un amor 2012 Re-release,4177,0,4177,2012.csv,2012,0.0,1.0
26823,3 Geezers!,4175,4175,0,2013.csv,2013,1.0,0.0
26824,Daylight,4171,4171,0,2011.csv,2011,1.0,0.0
26825,Por Onde Escapam As Palavras,4169,0,4169,2017.csv,2017,0.0,1.0
26826,Summer's Over,4166,0,4166,2017.csv,2017,0.0,1.0
26827,Triage 2011 Re-release,4159,0,4159,2011.csv,2011,0.0,1.0
26828,Badsville,4153,4153,0,2017.csv,2017,1.0,0.0
26829,I Wish I Knew,4153,0,4153,2010.csv,2010,0.0,1.0
26830,Modern Life Is Rubbish,4153,0,4153,2018.csv,2018,0.0,1.0
26831,Asphyxia,4151,0,4151,2018.csv,2018,0.0,1.0
26832,Pussy Riot - A Punk Prayer,4148,0,4148,2014.csv,2014,0.0,1.0
26833,I'll come back home,4147,0,4147,2019.csv,2019,0.0,1.0
26834,El método Arrieta,4146,0,4146,2013.csv,2013,0.0,1.0
26835,Zurich,4141,0,4141,2014.csv,2014,0.0,1.0
26836,Pawn,4141,4141,0,2013.csv,2013,1.0,0.0
26837,Asinamali,4141,0,4141,2018.csv,2018,0.0,1.0
26838,Shabab Dayaa,4140,0,4140,2019.csv,2019,0.0,1.0
26839,Chinese Portrait,4140,4140,0,2019.csv,2019,1.0,0.0
26840,The Merchant of Venice,4136,0,4136,2015.csv,2015,0.0,1.0
26841,Motley Crue: The End,4135,0,4135,2016.csv,2016,0.0,1.0
26842,Life Size Memories,4133,0,4133,2012.csv,2012,0.0,1.0
26843,Pibe Chorro,4131,0,4131,2016.csv,2016,0.0,1.0
26844,Aanandam,4131,0,4131,2016.csv,2016,0.0,1.0
26845,Viaje inesperado,4129,0,4129,2018.csv,2018,0.0,1.0
26846,Surdina,4128,0,4128,2020.csv,2020,0.0,1.0
26847,Movie 43 2015 Re-release,4123,0,4123,2015.csv,2015,0.0,1.0
26848,Rolling Elvis,4121,0,4121,2017.csv,2017,0.0,1.0
26849,Finding Jack Charlton,4120,0,4120,2020.csv,2020,0.0,1.0
26850,Female Human Animal,4119,0,4119,2018.csv,2018,0.0,1.0
26851,Hoop It Up,4113,0,4113,2019.csv,2019,0.0,1.0
26852,Nevermind,4111,0,4111,2019.csv,2019,0.0,1.0
26853,La cola,4110,0,4110,2012.csv,2012,0.0,1.0
26854,The Greenaway Alphabet,4110,0,4110,2019.csv,2019,0.0,1.0
26855,Dear Santa,4109,4109,0,2020.csv,2020,1.0,0.0
26856,Roa,4109,0,4109,2013.csv,2013,0.0,1.0
26857,Weekend 2013 Re-release,4107,0,4107,2013.csv,2013,0.0,1.0
26858,Contracted,4105,4105,0,2013.csv,2013,1.0,0.0
26859,Matriarch,4105,0,4105,2020.csv,2020,0.0,1.0
26860,Anton Corbijn Inside Out,4105,0,4105,2012.csv,2012,0.0,1.0
26861,Un cine como tú en un país como éste,4101,0,4101,2010.csv,2010,0.0,1.0
26862,Mattress Men,4098,0,4098,2016.csv,2016,0.0,1.0
26863,Huso astgh,4088,0,4088,2010.csv,2010,0.0,1.0
26864,Ramy Al Ehtesamy,4087,0,4087,2010.csv,2010,0.0,1.0
26865,Anarchy Girls,4085,0,4085,2010.csv,2010,0.0,1.0
26866,Personal Best,4084,0,4084,2012.csv,2012,0.0,1.0
26867,Powder,4082,0,4082,2011.csv,2011,0.0,1.0
26868,Silver Circle,4080,4080,0,2013.csv,2013,1.0,0.0
26869,Jason Becker: Not Dead Yet,4080,1294,2786,2012.csv,2012,0.317156862745098,0.682843137254902
26870,Orthodox,4077,0,4077,2016.csv,2016,0.0,1.0
26871,O Nosso Cônsul em Havana,4077,0,4077,2020.csv,2020,0.0,1.0
26872,Cemento: The Documentary,4077,0,4077,2017.csv,2017,0.0,1.0
26873,438 Days,4076,0,4076,2021.csv,2021,0.0,1.0
26874,Three Night Stand,4076,4076,0,2015.csv,2015,1.0,0.0
26875,Los caminos de la memoria,4075,0,4075,2010.csv,2010,0.0,1.0
26876,Bi Mat Dao Linh Xa,4071,0,4071,2020.csv,2020,0.0,1.0
26877,Your Excellency,4068,0,4068,2019.csv,2019,0.0,1.0
26878,Dancing with Maria,4067,0,4067,2016.csv,2016,0.0,1.0
26879,"To Joey, with Love 2019 Re-release",4066,0,4066,2019.csv,2019,0.0,1.0
26880,Sokak Sinifi,4063,0,4063,2018.csv,2018,0.0,1.0
26881,Not That Funny,4062,0,4062,2014.csv,2014,0.0,1.0
26882,Haldaa,4062,0,4062,2017.csv,2017,0.0,1.0
26883,Coma,4061,0,4061,2010.csv,2010,0.0,1.0
26884,Mr. Chandramouli,4060,0,4060,2018.csv,2018,0.0,1.0
26885,Mathera,4058,0,4058,2020.csv,2020,0.0,1.0
26886,Pakeliui I amzinybe,4056,0,4056,2016.csv,2016,0.0,1.0
26887,The Kitchen,4054,4054,0,2013.csv,2013,1.0,0.0
26888,Come and Find Me,4052,0,4052,2016.csv,2016,0.0,1.0
26889,Julie,4051,0,4051,2016.csv,2016,0.0,1.0
26890,The Mountain,4049,0,4049,2011.csv,2011,0.0,1.0
26891,One Life 2014 Re-release,4045,0,4045,2014.csv,2014,0.0,1.0
26892,Grbavica: The Land of My Dreams 2011 Re-release,4044,0,4044,2011.csv,2011,0.0,1.0
26893,The Nothing Men,4036,0,4036,2010.csv,2010,0.0,1.0
26894,A Window to Rosália,4033,0,4033,2017.csv,2017,0.0,1.0
26895,La Flor,4032,4032,0,2019.csv,2019,1.0,0.0
26896,Yuva,4032,0,4032,2019.csv,2019,0.0,1.0
26897,Damned Summer,4031,0,4031,2017.csv,2017,0.0,1.0
26898,Morning,4029,4029,0,2013.csv,2013,1.0,0.0
26899,Autumn Blood,4024,0,4024,2014.csv,2014,0.0,1.0
26900,Robo-Dog: Airborne 2018 Re-release,4022,0,4022,2018.csv,2018,0.0,1.0
26901,"Amigo Skate, Cuba",4019,4019,0,2020.csv,2020,1.0,0.0
26902,Doorbeen,4016,0,4016,2019.csv,2019,0.0,1.0
26903,Dagaalty,4016,0,4016,2020.csv,2020,0.0,1.0
26904,Robin Hood 2020 Re-release,4015,0,4015,2020.csv,2020,0.0,1.0
26905,Approved for Adoption 2013 Re-release,4015,4015,0,2013.csv,2013,1.0,0.0
26906,C/o Surya,4013,0,4013,2017.csv,2017,0.0,1.0
26907,We'll Never Have Paris,4012,0,4012,2015.csv,2015,0.0,1.0
26908,Yo Te Gusto?,4009,0,4009,2019.csv,2019,0.0,1.0
26909,Demons Hunter - ZhongKui: Nightmare,4008,0,4008,2020.csv,2020,0.0,1.0
26910,Sessiz Ol,4008,0,4008,2018.csv,2018,0.0,1.0
26911,Yangsi,4008,4008,0,2012.csv,2012,1.0,0.0
26912,Dört köseli üçgen,4004,0,4004,2018.csv,2018,0.0,1.0
26913,Adeline,4004,0,4004,2019.csv,2019,0.0,1.0
26914,The Double Life of Véronique 2017 Re-release,4003,0,4003,2017.csv,2017,0.0,1.0
26915,"São Sebastião do Rio de Janeiro, a Formação de uma Cidade",4001,0,4001,2016.csv,2016,0.0,1.0
26916,Campus Radio,4000,4000,0,2011.csv,2011,1.0,0.0
26917,Building Hope,4000,4000,0,2011.csv,2011,1.0,0.0
26918,Pickin' & Grinnin',4000,4000,0,2012.csv,2012,1.0,0.0
26919,Vetrarbræour,3997,0,3997,2017.csv,2017,0.0,1.0
26920,Hi Jack,3996,0,3996,2016.csv,2016,0.0,1.0
26921,I Am Michael,3995,0,3995,2017.csv,2017,0.0,1.0
26922,Once Upon a Time in Amritsar,3995,0,3995,2016.csv,2016,0.0,1.0
26923,Thomas Kinkade's Christmas Cottage 2010 Re-release,3994,0,3994,2010.csv,2010,0.0,1.0
26924,Ms J Contemplates Her Choice,3993,0,3993,2015.csv,2015,0.0,1.0
26925,For Molly,3991,0,3991,2018.csv,2018,0.0,1.0
26926,Hair,3991,0,3991,2010.csv,2010,0.0,1.0
26927,Sister of Mine,3990,0,3990,2017.csv,2017,0.0,1.0
26928,The Swimming Pool,3989,0,3989,2011.csv,2011,0.0,1.0
26929,The Blonde One,3983,0,3983,2019.csv,2019,0.0,1.0
26930,Supercon,3982,0,3982,2018.csv,2018,0.0,1.0
26931,Emily,3982,3982,0,2017.csv,2017,1.0,0.0
26932,Dream Boat,3981,3981,0,2017.csv,2017,1.0,0.0
26933,Skal dere gå allerede?,3980,0,3980,2020.csv,2020,0.0,1.0
26934,Muna,3979,0,3979,2016.csv,2016,0.0,1.0
26935,The Great Utopia,3978,0,3978,2017.csv,2017,0.0,1.0
26936,The American Friend 2017 Re-release,3978,0,3978,2017.csv,2017,0.0,1.0
26937,El país del miedo,3976,0,3976,2016.csv,2016,0.0,1.0
26938,Pickpocket,3967,0,3967,2017.csv,2017,0.0,1.0
26939,Ghett'a Life,3966,0,3966,2011.csv,2011,0.0,1.0
26940,Belle & Sebastian,3965,0,3965,2021.csv,2021,0.0,1.0
26941,Trash 2 Dash,3965,0,3965,2021.csv,2021,0.0,1.0
26942,Vampyres,3959,0,3959,2015.csv,2015,0.0,1.0
26943,Man with a Movie Camera,3959,0,3959,2016.csv,2016,0.0,1.0
26944,The Loft 2017 Re-release,3959,0,3959,2017.csv,2017,0.0,1.0
26945,Up There,3956,0,3956,2012.csv,2012,0.0,1.0
26946,Exit Plan,3955,0,3955,2020.csv,2020,0.0,1.0
26947,Brock: Over the Top,3954,0,3954,2020.csv,2020,0.0,1.0
26948,Like a Dream,3953,0,3953,2010.csv,2010,0.0,1.0
26949,Always: Sunset on Third Street 2 2010 Re-release,3952,0,3952,2010.csv,2010,0.0,1.0
26950,Findik veresiye,3952,0,3952,2018.csv,2018,0.0,1.0
26951,Khaali Peeli,3949,0,3949,2020.csv,2020,0.0,1.0
26952,Armed,3948,3948,0,2018.csv,2018,1.0,0.0
26953,Right Yaaa Wrong,3948,0,3948,2010.csv,2010,0.0,1.0
26954,Eksik sayfalar 2015 Re-release,3946,0,3946,2015.csv,2015,0.0,1.0
26955,Welcome to the Rileys 2013 Re-release,3946,0,3946,2013.csv,2013,0.0,1.0
26956,Just Say Love,3944,3944,0,2010.csv,2010,1.0,0.0
26957,Kaf,3943,0,3943,2019.csv,2019,0.0,1.0
26958,Braoum verour bylting!,3941,0,3941,2018.csv,2018,0.0,1.0
26959,Yazichniki,3934,0,3934,2018.csv,2018,0.0,1.0
26960,L'échange des princesses 2020 Re-release,3933,0,3933,2020.csv,2020,0.0,1.0
26961,The Perfect Kiss,3932,0,3932,2018.csv,2018,0.0,1.0
26962,Korkacak Bi'sey Yok,3931,0,3931,2017.csv,2017,0.0,1.0
26963,Savages Crossing,3928,0,3928,2010.csv,2010,0.0,1.0
26964,Treblinka,3920,0,3920,2017.csv,2017,0.0,1.0
26965,Mother of a Day,3919,3919,0,2019.csv,2019,1.0,0.0
26966,The Longleg,3918,0,3918,2019.csv,2019,0.0,1.0
26967,Late September,3917,0,3917,2012.csv,2012,0.0,1.0
26968,Nocturnal,3915,0,3915,2020.csv,2020,0.0,1.0
26969,Maidan,3909,3909,0,2014.csv,2014,1.0,0.0
26970,Rocket Science 2010 Re-release,3902,0,3902,2010.csv,2010,0.0,1.0
26971,Mar de Fondo,3900,0,3900,2012.csv,2012,0.0,1.0
26972,The Chosen Heaven,3900,0,3900,2012.csv,2012,0.0,1.0
26973,Surviving Life (Theory and Practice) 2011 Re-release,3899,0,3899,2011.csv,2011,0.0,1.0
26974,The Squad 2015 Re-release,3897,0,3897,2015.csv,2015,0.0,1.0
26975,American Dresser,3895,3895,0,2018.csv,2018,1.0,0.0
26976,Seytanin Çocuklari-El Ebyaz,3893,0,3893,2016.csv,2016,0.0,1.0
26977,Your Voice -KIMIKOE-,3891,0,3891,2019.csv,2019,0.0,1.0
26978,Kammatti Paadam,3891,0,3891,2016.csv,2016,0.0,1.0
26979,Bir Gece,3891,0,3891,2015.csv,2015,0.0,1.0
26980,Zona turbulentnosti,3890,0,3890,2011.csv,2011,0.0,1.0
26981,Night Market Hero,3889,0,3889,2011.csv,2011,0.0,1.0
26982,AVICII - True Stories,3887,0,3887,2017.csv,2017,0.0,1.0
26983,For Those in Peril,3886,0,3886,2013.csv,2013,0.0,1.0
26984,Camp Fire Stories,3885,0,3885,2020.csv,2020,0.0,1.0
26985,The Iron Ministry,3885,3340,545,2015.csv,2015,0.8597168597168597,0.1402831402831403
26986,Rahm,3884,0,3884,2017.csv,2017,0.0,1.0
26987,Colorsless Dream,3883,0,3883,2018.csv,2018,0.0,1.0
26988,Eat Locals 2019 Re-release,3883,0,3883,2019.csv,2019,0.0,1.0
26989,Paçi: Av sanati,3879,0,3879,2018.csv,2018,0.0,1.0
26990,Pra Lá do Mundo,3876,0,3876,2013.csv,2013,0.0,1.0
26991,Miss,3874,0,3874,2016.csv,2016,0.0,1.0
26992,One and a Half Prince,3870,0,3870,2018.csv,2018,0.0,1.0
26993,Crown Vic,3868,3868,0,2019.csv,2019,1.0,0.0
26994,Hollidaysburg,3861,3861,0,2014.csv,2014,1.0,0.0
26995,Murder on the Orient Express 2020 Re-release,3860,0,3860,2020.csv,2020,0.0,1.0
26996,Zat-i mahfuz,3857,0,3857,2018.csv,2018,0.0,1.0
26997,A Christmas Star 2018 Re-release,3852,0,3852,2018.csv,2018,0.0,1.0
26998,14 kilómetros 2012 Re-release,3852,0,3852,2012.csv,2012,0.0,1.0
26999,El Sonido de los Tulipanes,3851,0,3851,2019.csv,2019,0.0,1.0
27000,Akenfield,3847,0,3847,2016.csv,2016,0.0,1.0
27001,Senarist,3845,0,3845,2016.csv,2016,0.0,1.0
27002,La sera della prima,3837,0,3837,2019.csv,2019,0.0,1.0
27003,The Second Time Around,3837,3837,0,2018.csv,2018,1.0,0.0
27004,Aashayein,3836,0,3836,2010.csv,2010,0.0,1.0
27005,"High Tech, Low Life",3836,3836,0,2013.csv,2013,1.0,0.0
27006,Peak Warrior,3835,0,3835,2019.csv,2019,0.0,1.0
27007,Humble Politician Nograj,3835,0,3835,2018.csv,2018,0.0,1.0
27008,Rudolf Nureyev. Island of His Dreams,3832,0,3832,2016.csv,2016,0.0,1.0
27009,Box,3824,0,3824,2015.csv,2015,0.0,1.0
27010,Await Further Instructions,3823,0,3823,2018.csv,2018,0.0,1.0
27011,Nithyaharitha Nayakan,3822,0,3822,2019.csv,2019,0.0,1.0
27012,The Man Who Killed Hitler and Then the Bigfoot,3822,0,3822,2019.csv,2019,0.0,1.0
27013,"The Adventures of Priscilla, Queen of the Desert 2019 Re-release",3821,0,3821,2019.csv,2019,0.0,1.0
27014,Mom & Me,3816,0,3816,2016.csv,2016,0.0,1.0
27015,King's Gambit,3816,3816,0,2020.csv,2020,1.0,0.0
27016,Tupaia's Endeavour,3814,0,3814,2020.csv,2020,0.0,1.0
27017,Callback,3814,0,3814,2017.csv,2017,0.0,1.0
27018,Sea Sorrow,3813,0,3813,2017.csv,2017,0.0,1.0
27019,Monty Python and the Holy Grail 2015 Re-release,3811,0,3811,2015.csv,2015,0.0,1.0
27020,Range Runners,3811,0,3811,2020.csv,2020,0.0,1.0
27021,Jellyfish 2012 Re-release,3806,0,3806,2012.csv,2012,0.0,1.0
27022,Forgiveness,3805,0,3805,2017.csv,2017,0.0,1.0
27023,The Terrorizers 2020 Re-release,3804,0,3804,2020.csv,2020,0.0,1.0
27024,Free Radicals: A History of Experimental Film,3804,3804,0,2012.csv,2012,1.0,0.0
27025,Twin Murders: The Silence of the White City 2021 Re-release,3803,0,3803,2021.csv,2021,0.0,1.0
27026,A Kiss for Jed,3802,0,3802,2012.csv,2012,0.0,1.0
27027,Wallflower,3801,3801,0,2019.csv,2019,1.0,0.0
27028,Madam Chief Minister,3797,0,3797,2021.csv,2021,0.0,1.0
27029,Los gringos no comen llajua,3795,0,3795,2011.csv,2011,0.0,1.0
27030,Rabbit Hole 2013 Re-release,3792,0,3792,2013.csv,2013,0.0,1.0
27031,Idgah,3792,0,3792,2018.csv,2018,0.0,1.0
27032,Come to My Voice,3789,0,3789,2014.csv,2014,0.0,1.0
27033,Joker 2017 Re-release,3788,0,3788,2017.csv,2017,0.0,1.0
27034,La última cima 2011 Re-release,3787,0,3787,2011.csv,2011,0.0,1.0
27035,La Dolce Vita 2021 Re-release,3787,0,3787,2020.csv,2020,0.0,1.0
27036,Hotel Infierno,3784,0,3784,2017.csv,2017,0.0,1.0
27037,El padre,3783,0,3783,2016.csv,2016,0.0,1.0
27038,Unfreedom,3778,3778,0,2015.csv,2015,1.0,0.0
27039,They Come to America,3775,3775,0,2012.csv,2012,1.0,0.0
27040,That in Me,3774,0,3774,2017.csv,2017,0.0,1.0
27041,The Gender Card Flip,3774,3774,0,2017.csv,2017,1.0,0.0
27042,Dry Martina,3774,0,3774,2018.csv,2018,0.0,1.0
27043,The Milk of Sorrow 2013 Re-release,3773,0,3773,2013.csv,2013,0.0,1.0
27044,The Left-Handed Woman,3773,0,3773,2017.csv,2017,0.0,1.0
27045,Widerstand in Haiderland,3771,0,3771,2010.csv,2010,0.0,1.0
27046,Django: sangre de mi sangre,3770,0,3770,2018.csv,2018,0.0,1.0
27047,Battleship Potemkin 2016 Re-release,3769,0,3769,2016.csv,2016,0.0,1.0
27048,Kar korsanlari,3767,0,3767,2015.csv,2015,0.0,1.0
27049,Bloodline 2011 Re-release,3764,0,3764,2011.csv,2011,0.0,1.0
27050,Don't Grow Up,3764,0,3764,2016.csv,2016,0.0,1.0
27051,In/Significant Others,3763,3763,0,2010.csv,2010,1.0,0.0
27052,Taka 5,3762,0,3762,2019.csv,2019,0.0,1.0
27053,Zoobilee Zoo: Gotta Dance,3758,0,3758,2010.csv,2010,0.0,1.0
27054,7 Hours to Win Your Heart,3757,0,3757,2020.csv,2020,0.0,1.0
27055,The Hollow,3755,3755,0,2016.csv,2016,1.0,0.0
27056,Mystery Train,3755,0,3755,2018.csv,2018,0.0,1.0
27057,The Kids from the Port,3755,0,3755,2013.csv,2013,0.0,1.0
27058,Clemente,3752,0,3752,2018.csv,2018,0.0,1.0
27059,Nelly,3751,3751,0,2018.csv,2018,1.0,0.0
27060,A Spot of Bother 2012 Re-release,3750,0,3750,2012.csv,2012,0.0,1.0
27061,Bugs,3742,3742,0,2017.csv,2017,1.0,0.0
27062,Rânia,3738,0,3738,2013.csv,2013,0.0,1.0
27063,Virando bicho,3736,0,3736,2012.csv,2012,0.0,1.0
27064,Puthiya Niyamam,3735,0,3735,2016.csv,2016,0.0,1.0
27065,Bad Blood,3731,3731,0,2012.csv,2012,1.0,0.0
27066,Dumbo 2012 Re-release,3731,0,3731,2012.csv,2012,0.0,1.0
27067,Un mundo seguro,3730,0,3730,2012.csv,2012,0.0,1.0
27068,Grafomafiya,3727,0,3727,2017.csv,2017,0.0,1.0
27069,The Free Speech Apocalypse,3726,3726,0,2015.csv,2015,1.0,0.0
27070,Scream 2020 Re-release,3722,0,3722,2020.csv,2020,0.0,1.0
27071,The Night,3720,0,3720,2016.csv,2016,0.0,1.0
27072,Bütün Saadetler Mümkündür,3719,0,3719,2018.csv,2018,0.0,1.0
27073,The Condemned,3718,3718,0,2013.csv,2013,1.0,0.0
27074,Pata Nahi Rabb Kehdeyan Rangan Ch Raazi,3718,0,3718,2012.csv,2012,0.0,1.0
27075,The Bridge of San Luis Rey 2010 Re-release,3716,0,3716,2010.csv,2010,0.0,1.0
27076,Night Watch,3714,0,3714,2017.csv,2017,0.0,1.0
27077,Nawab,3712,0,3712,2018.csv,2018,0.0,1.0
27078,Detki naprokat,3710,0,3710,2017.csv,2017,0.0,1.0
27079,The Harvest/La Cosecha,3709,3709,0,2011.csv,2011,1.0,0.0
27080,"Hijab, mulheres de véu",3706,0,3706,2013.csv,2013,0.0,1.0
27081,Terra de ninguém,3704,0,3704,2013.csv,2013,0.0,1.0
27082,No me mates,3702,0,3702,2016.csv,2016,0.0,1.0
27083,If You Saw His Heart,3700,0,3700,2017.csv,2017,0.0,1.0
27084,The State of Things,3700,0,3700,2017.csv,2017,0.0,1.0
27085,The Men Next Door,3699,0,3699,2010.csv,2010,0.0,1.0
27086,Claudia,3697,0,3697,2019.csv,2019,0.0,1.0
27087,Heartless,3697,3697,0,2010.csv,2010,1.0,0.0
27088,The Family,3696,3696,0,2018.csv,2018,1.0,0.0
27089,Dragones: destino de fuego 2011 Re-release,3696,0,3696,2011.csv,2011,0.0,1.0
27090,Collaborator,3696,0,3696,2012.csv,2012,0.0,1.0
27091,Mes séances de lutte,3696,0,3696,2015.csv,2015,0.0,1.0
27092,Missbehavior,3692,0,3692,2019.csv,2019,0.0,1.0
27093,Lukan Michi,3689,0,3689,2019.csv,2019,0.0,1.0
27094,Jungleland,3688,0,3688,2020.csv,2020,0.0,1.0
27095,Mary Poppins 2020 Re-release,3680,0,3680,2020.csv,2020,0.0,1.0
27096,Dead Good,3679,0,3679,2019.csv,2019,0.0,1.0
27097,Into the Inferno,3679,0,3679,2016.csv,2016,0.0,1.0
27098,Marilyn,3676,0,3676,2018.csv,2018,0.0,1.0
27099,Avengers: Age of Ultron 2020 Re-release,3672,0,3672,2020.csv,2020,0.0,1.0
27100,Eternal Winter,3671,0,3671,2018.csv,2018,0.0,1.0
27101,The Song of the Angels,3670,0,3670,2018.csv,2018,0.0,1.0
27102,Brother Pig is Coming,3665,0,3665,2018.csv,2018,0.0,1.0
27103,Richness of Internal Space,3664,0,3664,2014.csv,2014,0.0,1.0
27104,Moira,3663,0,3663,2019.csv,2019,0.0,1.0
27105,The Upside 2020 Re-release,3663,0,3663,2020.csv,2020,0.0,1.0
27106,Footloose 2020 Re-release,3662,0,3662,2020.csv,2020,0.0,1.0
27107,The Quarry,3661,0,3661,2020.csv,2020,0.0,1.0
27108,Center of My World,3656,0,3656,2017.csv,2017,0.0,1.0
27109,The Word,3648,3648,0,2014.csv,2014,1.0,0.0
27110,Top Funny Comedian: The Movie,3645,0,3645,2014.csv,2014,0.0,1.0
27111,Smash His Camera,3644,3644,0,2010.csv,2010,1.0,0.0
27112,Stop The Pounding Heart,3642,3642,0,2014.csv,2014,1.0,0.0
27113,Respira: Transgenesis,3640,0,3640,2020.csv,2020,0.0,1.0
27114,Born to Be King,3639,0,3639,2016.csv,2016,0.0,1.0
27115,Born to Be Free,3638,0,3638,2017.csv,2017,0.0,1.0
27116,The Delinquent Season 2019 Re-release,3635,0,3635,2019.csv,2019,0.0,1.0
27117,Muezzin,3634,0,3634,2010.csv,2010,0.0,1.0
27118,Abhiyude Katha Anuvinteyum,3631,0,3631,2018.csv,2018,0.0,1.0
27119,Mother's Milk,3628,0,3628,2012.csv,2012,0.0,1.0
27120,Jogo das Decapitações,3625,0,3625,2014.csv,2014,0.0,1.0
27121,The Wandering Soap Opera,3624,3624,0,2019.csv,2019,1.0,0.0
27122,Vincent,3623,0,3623,2016.csv,2016,0.0,1.0
27123,Mr. Nobody 2013 Re-release,3622,3622,0,2013.csv,2013,1.0,0.0
27124,Tuscan Wedding 2015 Re-release,3621,0,3621,2015.csv,2015,0.0,1.0
27125,Dating Amber,3618,0,3618,2020.csv,2020,0.0,1.0
27126,Going Vertical: The Shortboard Revolution,3617,0,3617,2010.csv,2010,0.0,1.0
27127,Moon Dogs,3616,0,3616,2017.csv,2017,0.0,1.0
27128,The Anniversary,3616,0,3616,2017.csv,2017,0.0,1.0
27129,Theevandi,3614,0,3614,2018.csv,2018,0.0,1.0
27130,The Act of Killing 2016 Re-release,3610,0,3610,2016.csv,2016,0.0,1.0
27131,3D Sun,3609,0,3609,2010.csv,2010,0.0,1.0
27132,Backseat Fighter,3608,0,3608,2017.csv,2017,0.0,1.0
27133,Naa Nuvve,3606,0,3606,2018.csv,2018,0.0,1.0
27134,The Last Waltz 2011 Re-release,3602,0,3602,2011.csv,2011,0.0,1.0
27135,Line of Descent,3599,0,3599,2021.csv,2021,0.0,1.0
27136,It Stains the Sands Red,3599,0,3599,2017.csv,2017,0.0,1.0
27137,Vergel,3598,0,3598,2018.csv,2018,0.0,1.0
27138,Favio: Chronicle of a Director,3596,0,3596,2016.csv,2016,0.0,1.0
27139,Toward Nowa Huta,3596,0,3596,2012.csv,2012,0.0,1.0
27140,Jeannette: The Childhood of Joan of Arc,3592,0,3592,2018.csv,2018,0.0,1.0
27141,Angela,3589,0,3589,2020.csv,2020,0.0,1.0
27142,Sevgi tasi,3587,0,3587,2013.csv,2013,0.0,1.0
27143,Cuckoo,3587,0,3587,2010.csv,2010,0.0,1.0
27144,Candyman 2020 Re-release,3587,0,3587,2020.csv,2020,0.0,1.0
27145,Hyena,3586,3401,185,2015.csv,2015,0.9484104852203011,0.05158951477969883
27146,Zuloak,3585,0,3585,2012.csv,2012,0.0,1.0
27147,Sharkwise,3582,0,3582,2011.csv,2011,0.0,1.0
27148,The Girl In the Orange Dress,3580,0,3580,2019.csv,2019,0.0,1.0
27149,Hirngespinster,3577,0,3577,2014.csv,2014,0.0,1.0
27150,Gerhard Richter Painting 2013 Re-release,3576,0,3576,2013.csv,2013,0.0,1.0
27151,Hide Your Smiling Faces,3576,3576,0,2014.csv,2014,1.0,0.0
27152,Pickpocket 2018 Re-release,3574,0,3574,2018.csv,2018,0.0,1.0
27153,Let's Talk 2018 Re-release,3573,0,3573,2018.csv,2018,0.0,1.0
27154,Ma famille t'adore déjà 2018 Re-release,3571,0,3571,2018.csv,2018,0.0,1.0
27155,Evolution of a Criminal,3568,3568,0,2014.csv,2014,1.0,0.0
27156,Brown Willy,3565,0,3565,2016.csv,2016,0.0,1.0
27157,Real,3564,0,3564,2020.csv,2020,0.0,1.0
27158,Werewolf,3564,0,3564,2019.csv,2019,0.0,1.0
27159,Some Girls,3564,0,3564,2016.csv,2016,0.0,1.0
27160,Seytan Papuçta,3562,0,3562,2016.csv,2016,0.0,1.0
27161,The Fish Child 2010 Re-release,3562,0,3562,2010.csv,2010,0.0,1.0
27162,Girls Lost,3561,0,3561,2016.csv,2016,0.0,1.0
27163,Rocky III 2020 Re-release,3561,0,3561,2020.csv,2020,0.0,1.0
27164,The Last Film Festival,3558,3558,0,2016.csv,2016,1.0,0.0
27165,Cycle,3555,0,3555,2013.csv,2013,0.0,1.0
27166,Fourplay,3550,3550,0,2018.csv,2018,1.0,0.0
27167,Erase and Forget,3546,0,3546,2018.csv,2018,0.0,1.0
27168,Durak,3546,0,3546,2015.csv,2015,0.0,1.0
27169,The Thieves 2015 Re-release,3543,0,3543,2015.csv,2015,0.0,1.0
27170,Jada,3542,0,3542,2019.csv,2019,0.0,1.0
27171,Genco,3541,0,3541,2017.csv,2017,0.0,1.0
27172,Kümes,3541,0,3541,2016.csv,2016,0.0,1.0
27173,Champa Flower,3541,0,3541,2019.csv,2019,0.0,1.0
27174,The Beautiful Troublemaker 2017 Re-release,3540,3540,0,2017.csv,2017,1.0,0.0
27175,The Nights of Zayandeh-Rood,3536,0,3536,2017.csv,2017,0.0,1.0
27176,Vigil in August,3534,0,3534,2019.csv,2019,0.0,1.0
27177,Turn of the Screw,3533,0,3533,2021.csv,2021,0.0,1.0
27178,Tricked,3533,3533,0,2013.csv,2013,1.0,0.0
27179,La hermandad 2019 Re-release,3532,0,3532,2019.csv,2019,0.0,1.0
27180,The Revelation of the Pyramids,3530,0,3530,2011.csv,2011,0.0,1.0
27181,Our Day Will Come,3528,0,3528,2011.csv,2011,0.0,1.0
27182,The Prodigies 2012 Re-release,3526,0,3526,2012.csv,2012,0.0,1.0
27183,Almost Heaven,3525,0,3525,2017.csv,2017,0.0,1.0
27184,See You Soon Again,3522,0,3522,2012.csv,2012,0.0,1.0
27185,The Loving Story 2016 Re-release,3518,3518,0,2016.csv,2016,1.0,0.0
27186,Love Still,3517,0,3517,2013.csv,2013,0.0,1.0
27187,"Lovely, Still 2012 Re-release",3517,0,3517,2012.csv,2012,0.0,1.0
27188,Where Got Ghost? 2010 Re-release,3516,0,3516,2010.csv,2010,0.0,1.0
27189,Blood Brothers: Civil War,3514,3514,0,2021.csv,2021,1.0,0.0
27190,We Look Good in Death,3511,0,3511,2020.csv,2020,0.0,1.0
27191,Final Kill,3511,0,3511,2020.csv,2020,0.0,1.0
27192,Porobashinee,3510,0,3510,2017.csv,2017,0.0,1.0
27193,Teesklejad,3509,0,3509,2017.csv,2017,0.0,1.0
27194,Blue Vasilissa,3506,0,3506,2018.csv,2018,0.0,1.0
27195,Ready Player One 2020 Re-release,3499,0,3499,2020.csv,2020,0.0,1.0
27196,Who's Crazy?,3497,3497,0,2017.csv,2017,1.0,0.0
27197,El cuidado de los otros,3497,0,3497,2019.csv,2019,0.0,1.0
27198,Locker 13,3496,3496,0,2014.csv,2014,1.0,0.0
27199,Paraiso: Tatlong kwento ng pag-asa 2017 Re-release,3495,0,3495,2017.csv,2017,0.0,1.0
27200,The Citizen 2018 Re-release,3495,3495,0,2018.csv,2018,1.0,0.0
27201,My Friend the Polish Girl,3492,0,3492,2019.csv,2019,0.0,1.0
27202,Blood and Bone,3492,0,3492,2010.csv,2010,0.0,1.0
27203,Jour de Fête 2017 Re-release,3485,0,3485,2017.csv,2017,0.0,1.0
27204,Dead Awake,3484,0,3484,2010.csv,2010,0.0,1.0
27205,Yeni baslayanlar için hayatta kalma sanati,3483,0,3483,2017.csv,2017,0.0,1.0
27206,Anina: Un misterioso viaje de ida y vuelta,3482,0,3482,2017.csv,2017,0.0,1.0
27207,"Love, Sweat and Tears",3482,3482,0,2017.csv,2017,1.0,0.0
27208,Bus Palladium 2011 Re-release,3478,0,3478,2011.csv,2011,0.0,1.0
27209,QTH,3477,0,3477,2017.csv,2017,0.0,1.0
27210,Metal Messiah,3476,3476,0,2010.csv,2010,1.0,0.0
27211,Wives on Strike: The Revolution,3476,0,3476,2018.csv,2018,0.0,1.0
27212,Strangeways Here We Come,3473,0,3473,2018.csv,2018,0.0,1.0
27213,Postcards from the Zoo,3471,0,3471,2013.csv,2013,0.0,1.0
27214,The Hacker Wars,3470,3470,0,2014.csv,2014,1.0,0.0
27215,The Full Picture,3467,3467,0,2010.csv,2010,1.0,0.0
27216,Head Hands Heart,3466,0,3466,2010.csv,2010,0.0,1.0
27217,Dva nula,3465,0,3465,2012.csv,2012,0.0,1.0
27218,Street Days,3463,0,3463,2010.csv,2010,0.0,1.0
27219,Bad Hair 2016 Re-release,3456,0,3456,2016.csv,2016,0.0,1.0
27220,Einmal mehr als nur reden,3455,0,3455,2010.csv,2010,0.0,1.0
27221,Aftermath,3451,3451,0,2014.csv,2014,1.0,0.0
27222,Life's a Breeze 2014 Re-release,3450,3450,0,2014.csv,2014,1.0,0.0
27223,2010 Moscow Film Retrospective,3440,0,3440,2010.csv,2010,0.0,1.0
27224,Be Kind,3438,0,3438,2019.csv,2019,0.0,1.0
27225,Mental Madhilo,3435,0,3435,2017.csv,2017,0.0,1.0
27226,What the Waters Left Behind 2019 Re-release,3434,0,3434,2019.csv,2019,0.0,1.0
27227,Scenic Route,3434,3434,0,2013.csv,2013,1.0,0.0
27228,Urban Games,3434,0,3434,2014.csv,2014,0.0,1.0
27229,Hill of Ilha Verde,3434,0,3434,2015.csv,2015,0.0,1.0
27230,Mahogany Sunrise,3432,3432,0,2014.csv,2014,1.0,0.0
27231,Deu-lae-gon-bil-li-ji,3431,0,3431,2017.csv,2017,0.0,1.0
27232,La afinadora de árboles,3429,0,3429,2019.csv,2019,0.0,1.0
27233,Restored Me 2016 Re-release,3428,3428,0,2016.csv,2016,1.0,0.0
27234,Mandrill 2011 Re-release,3425,0,3425,2011.csv,2011,0.0,1.0
27235,Speed Sisters,3423,3423,0,2017.csv,2017,1.0,0.0
27236,"Neither God, Nor Master or Husband",3422,0,3422,2010.csv,2010,0.0,1.0
27237,Peranbu,3417,0,3417,2019.csv,2019,0.0,1.0
27238,Like Minds 2014 Re-release,3416,0,3416,2014.csv,2014,0.0,1.0
27239,Rebuilding Paradise,3414,0,3414,2020.csv,2020,0.0,1.0
27240,Falling in Love,3413,0,3413,2017.csv,2017,0.0,1.0
27241,Agnes,3413,0,3413,2020.csv,2020,0.0,1.0
27242,Beyond Brotherhood,3410,0,3410,2017.csv,2017,0.0,1.0
27243,The Witch: Part 1 - The Subversion 2019 Re-release,3406,0,3406,2019.csv,2019,0.0,1.0
27244,Amazon Obhijaan,3403,0,3403,2018.csv,2018,0.0,1.0
27245,We Are Fine,3402,0,3402,2016.csv,2016,0.0,1.0
27246,Degistir Bakalim,3401,0,3401,2016.csv,2016,0.0,1.0
27247,The Happy Poet,3400,3400,0,2013.csv,2013,1.0,0.0
27248,The Tall Men 2016 Re-release,3399,0,3399,2016.csv,2016,0.0,1.0
27249,Mario,3394,0,3394,2018.csv,2018,0.0,1.0
27250,Democracy: Im Rausch der Daten,3393,0,3393,2016.csv,2016,0.0,1.0
27251,School of Seduction,3392,0,3392,2020.csv,2020,0.0,1.0
27252,The Cage Fighter,3392,3392,0,2018.csv,2018,1.0,0.0
27253,My Life in Ruins 2012 Re-release,3391,0,3391,2012.csv,2012,0.0,1.0
27254,Ibiza: The Silent Movie,3391,0,3391,2019.csv,2019,0.0,1.0
27255,May I Be Happy,3391,0,3391,2019.csv,2019,0.0,1.0
27256,Lo que no se perdona,3389,0,3389,2017.csv,2017,0.0,1.0
27257,Rottentail,3383,3383,0,2019.csv,2019,1.0,0.0
27258,Sentimental Education,3381,0,3381,2013.csv,2013,0.0,1.0
27259,Barrefondo,3376,0,3376,2018.csv,2018,0.0,1.0
27260,Apprentice,3375,0,3375,2017.csv,2017,0.0,1.0
27261,Karingunnam 6's,3375,0,3375,2016.csv,2016,0.0,1.0
27262,"Mrs.B., a North Korean Woman",3375,0,3375,2018.csv,2018,0.0,1.0
27263,One for the Money 2014 Re-release,3373,0,3373,2014.csv,2014,0.0,1.0
27264,Bad Lieutenant: Port of Call New Orleans 2013 Re-release,3373,0,3373,2013.csv,2013,0.0,1.0
27265,Takovej barevnej vocas letící komety,3367,0,3367,2015.csv,2015,0.0,1.0
27266,Sweet River,3365,0,3365,2021.csv,2021,0.0,1.0
27267,Tosca Live from the Royal Opera House,3365,0,3365,2011.csv,2011,0.0,1.0
27268,Aquela Loura,3363,0,3363,2018.csv,2018,0.0,1.0
27269,The Grump 2017 Re-release,3361,0,3361,2017.csv,2017,0.0,1.0
27270,A Woman's Revenge,3361,0,3361,2016.csv,2016,0.0,1.0
27271,Future Baby,3360,0,3360,2016.csv,2016,0.0,1.0
27272,Ran 2020 Re-release,3359,0,3359,2020.csv,2020,0.0,1.0
27273,A Oscuras,3359,0,3359,2019.csv,2019,0.0,1.0
27274,Rock On,3358,0,3358,2010.csv,2010,0.0,1.0
27275,#Odindenleta,3356,0,3356,2018.csv,2018,0.0,1.0
27276,Amanda & Jack Go Glamping,3352,3352,0,2017.csv,2017,1.0,0.0
27277,Bad Match,3351,3351,0,2017.csv,2017,1.0,0.0
27278,Sajjan: The Real Friend,3350,0,3350,2013.csv,2013,0.0,1.0
27279,Followers,3350,3350,0,2018.csv,2018,1.0,0.0
27280,Brokers - Eroi per gioco,3349,0,3349,2011.csv,2011,0.0,1.0
27281,Chelsea on the Rocks 2011 Re-release,3349,0,3349,2011.csv,2011,0.0,1.0
27282,Zigortzaileak,3348,0,3348,2011.csv,2011,0.0,1.0
27283,Fashion Victim,3346,3346,0,2010.csv,2010,1.0,0.0
27284,Left Hand and Right Hand,3346,0,3346,2018.csv,2018,0.0,1.0
27285,Looking for Lan Xiaocao,3343,0,3343,2019.csv,2019,0.0,1.0
27286,One Day: Justice Delivered,3340,0,3340,2019.csv,2019,0.0,1.0
27287,The Loss Adjuster,3339,0,3339,2020.csv,2020,0.0,1.0
27288,Swerve,3338,3338,0,2013.csv,2013,1.0,0.0
27289,My Father Was Right,3337,0,3337,2018.csv,2018,0.0,1.0
27290,Debt,3334,0,3334,2018.csv,2018,0.0,1.0
27291,L'uomo fiammifero 2011 Re-release,3333,0,3333,2011.csv,2011,0.0,1.0
27292,Mi America,3330,3330,0,2015.csv,2015,1.0,0.0
27293,Marti,3330,0,3330,2018.csv,2018,0.0,1.0
27294,The Confession 2018 Re-release,3330,0,3330,2018.csv,2018,0.0,1.0
27295,Sinamkol,3330,0,3330,2020.csv,2020,0.0,1.0
27296,Nartanasala,3323,0,3323,2018.csv,2018,0.0,1.0
27297,Know How,3323,3323,0,2015.csv,2015,1.0,0.0
27298,Tableau noir,3323,0,3323,2015.csv,2015,0.0,1.0
27299,El Bosque de Karadima 2016 Re-release,3321,0,3321,2016.csv,2016,0.0,1.0
27300,Close Relations,3321,0,3321,2017.csv,2017,0.0,1.0
27301,New World 2014 Re-release,3321,0,3321,2014.csv,2014,0.0,1.0
27302,Anahtar,3320,0,3320,2012.csv,2012,0.0,1.0
27303,Kind Hearts and Coronets 2020 Re-release,3320,0,3320,2020.csv,2020,0.0,1.0
27304,Desechos,3318,0,3318,2012.csv,2012,0.0,1.0
27305,Siren's Call,3315,0,3315,2018.csv,2018,0.0,1.0
27306,Soldier Grandpa,3314,0,3314,2017.csv,2017,0.0,1.0
27307,Diamond of Boyana,3311,0,3311,2017.csv,2017,0.0,1.0
27308,Jens Bjørneboe & det ondes problem,3310,0,3310,2020.csv,2020,0.0,1.0
27309,Sanctuary: Population One,3308,0,3308,2019.csv,2019,0.0,1.0
27310,Milla,3304,0,3304,2018.csv,2018,0.0,1.0
27311,MindGamers 2018 Re-release,3303,0,3303,2018.csv,2018,0.0,1.0
27312,El azote,3302,0,3302,2018.csv,2018,0.0,1.0
27313,Drunk Wedding,3301,3301,0,2015.csv,2015,1.0,0.0
27314,Cold Souls 2012 Re-release,3301,0,3301,2012.csv,2012,0.0,1.0
27315,Water and Salt,3299,0,3299,2012.csv,2012,0.0,1.0
27316,Like a Dream,3299,0,3299,2010.csv,2010,0.0,1.0
27317,Farewell Restaurant,3298,0,3298,2020.csv,2020,0.0,1.0
27318,Portable Life,3290,0,3290,2011.csv,2011,0.0,1.0
27319,Adiós querido Pep,3289,0,3289,2017.csv,2017,0.0,1.0
27320,Burning Bodhi,3289,3289,0,2016.csv,2016,1.0,0.0
27321,Vijay Superum Pournamiyum,3288,0,3288,2019.csv,2019,0.0,1.0
27322,Axe Giant: The Wrath of Paul Bunyan,3287,3287,0,2013.csv,2013,1.0,0.0
27323,Nosotras sin mamá,3286,0,3286,2012.csv,2012,0.0,1.0
27324,La guardería,3286,0,3286,2014.csv,2014,0.0,1.0
27325,God Bless Ozzy Osbourne 2016 Re-release,3272,0,3272,2016.csv,2016,0.0,1.0
27326,El Superstar: The Unlikely Rise of Juan Frances,3271,3271,0,2010.csv,2010,1.0,0.0
27327,Burning Palms,3271,0,3271,2011.csv,2011,0.0,1.0
27328,Merry Men 2,3270,0,3270,2019.csv,2019,0.0,1.0
27329,La sombra de Evita: Volveré y seré millones,3267,0,3267,2011.csv,2011,0.0,1.0
27330,Eliksir,3266,0,3266,2016.csv,2016,0.0,1.0
27331,Aruvam,3263,0,3263,2019.csv,2019,0.0,1.0
27332,Justice,3259,3259,0,2017.csv,2017,1.0,0.0
27333,Capriccio of Tracking Down the Treasure,3257,0,3257,2018.csv,2018,0.0,1.0
27334,Kallemni Choukran,3257,0,3257,2010.csv,2010,0.0,1.0
27335,Windsor Drive,3256,3256,0,2015.csv,2015,1.0,0.0
27336,Amigos eran los de antes,3252,0,3252,2017.csv,2017,0.0,1.0
27337,An African Election,3251,0,3251,2011.csv,2011,0.0,1.0
27338,Matky,3251,0,3251,2020.csv,2020,0.0,1.0
27339,How to Become a Sex Giant,3250,0,3250,2014.csv,2014,0.0,1.0
27340,Ornamento e Crime,3244,0,3244,2017.csv,2017,0.0,1.0
27341,Over the Limit,3243,3243,0,2018.csv,2018,1.0,0.0
27342,Sing 2020 Re-release,3243,0,3243,2020.csv,2020,0.0,1.0
27343,The Sons of Tennessee Williams,3242,3242,0,2011.csv,2011,1.0,0.0
27344,Club Sandwich,3242,0,3242,2014.csv,2014,0.0,1.0
27345,Land of Storms,3241,0,3241,2014.csv,2014,0.0,1.0
27346,Hora menos,3241,0,3241,2012.csv,2012,0.0,1.0
27347,Iruttu,3241,0,3241,2019.csv,2019,0.0,1.0
27348,Gray Matters,3239,0,3239,2016.csv,2016,0.0,1.0
27349,On the Road,3237,0,3237,2017.csv,2017,0.0,1.0
27350,Der Kaiserschmarrn,3235,0,3235,2013.csv,2013,0.0,1.0
27351,As Cool as I Am,3234,3234,0,2013.csv,2013,1.0,0.0
27352,Along the Roadside,3234,0,3234,2013.csv,2013,0.0,1.0
27353,How to Re-Establish a Vodka Empire,3226,0,3226,2012.csv,2012,0.0,1.0
27354,Yasmine,3225,0,3225,2014.csv,2014,0.0,1.0
27355,The Amber Light,3225,0,3225,2019.csv,2019,0.0,1.0
27356,Twa Timoun,3224,0,3224,2013.csv,2013,0.0,1.0
27357,Beyond the Walls,3223,0,3223,2013.csv,2013,0.0,1.0
27358,Kral Yolu,3222,0,3222,2013.csv,2013,0.0,1.0
27359,Ojalá vivas tiempos interesantes,3220,0,3220,2016.csv,2016,0.0,1.0
27360,Blackhats,3216,3216,0,2015.csv,2015,1.0,0.0
27361,This Prison Where I Live,3215,0,3215,2010.csv,2010,0.0,1.0
27362,Luna verde,3215,0,3215,2010.csv,2010,0.0,1.0
27363,"Entre santos, cholas y morenos",3214,0,3214,2019.csv,2019,0.0,1.0
27364,Subte: Polska,3214,0,3214,2016.csv,2016,0.0,1.0
27365,Reevolution,3209,0,3209,2019.csv,2019,0.0,1.0
27366,Quell'estate,3208,0,3208,2016.csv,2016,0.0,1.0
27367,Hija única,3208,0,3208,2016.csv,2016,0.0,1.0
27368,Land Without God,3205,0,3205,2019.csv,2019,0.0,1.0
27369,The Steam Engines of Oz,3205,0,3205,2020.csv,2020,0.0,1.0
27370,Liebig,3205,0,3205,2017.csv,2017,0.0,1.0
27371,Carlito's Way 2015 Re-release,3205,0,3205,2015.csv,2015,0.0,1.0
27372,Young-blooded Vine,3204,0,3204,2020.csv,2020,0.0,1.0
27373,Kino Caravan,3202,0,3202,2010.csv,2010,0.0,1.0
27374,Willy Wonka & the Chocolate Factory 2020 Re-release,3200,0,3200,2020.csv,2020,0.0,1.0
27375,Ao Oni: The Animation,3200,0,3200,2018.csv,2018,0.0,1.0
27376,A la deriva 2013 Re-release,3196,0,3196,2013.csv,2013,0.0,1.0
27377,Salala Mobiles,3196,0,3196,2014.csv,2014,0.0,1.0
27378,2001: mientras Kubrick estaba en el espacio,3195,0,3195,2016.csv,2016,0.0,1.0
27379,Wild Life 2016 Re-release,3189,0,3189,2016.csv,2016,0.0,1.0
27380,Les Perseides,3189,0,3189,2019.csv,2019,0.0,1.0
27381,Sententia,3188,0,3188,2020.csv,2020,0.0,1.0
27382,Natural Resistance,3188,0,3188,2015.csv,2015,0.0,1.0
27383,I Am Breathing,3188,0,3188,2013.csv,2013,0.0,1.0
27384,What the Health,3187,0,3187,2017.csv,2017,0.0,1.0
27385,Sink,3187,0,3187,2018.csv,2018,0.0,1.0
27386,India vs England,3187,0,3187,2020.csv,2020,0.0,1.0
27387,Orillas,3186,0,3186,2011.csv,2011,0.0,1.0
27388,Humorisimas Variete,3186,0,3186,2017.csv,2017,0.0,1.0
27389,After the Wizard,3184,3184,0,2012.csv,2012,1.0,0.0
27390,Raphael - Lord of the Arts 2020 Re-release,3182,0,3182,2020.csv,2020,0.0,1.0
27391,Women Are Heroes 2012 Re-release,3182,0,3182,2012.csv,2012,0.0,1.0
27392,Too Much Info Clouding Over My Head,3181,0,3181,2018.csv,2018,0.0,1.0
27393,"Sockeye Salmon, Red Fish",3181,0,3181,2020.csv,2020,0.0,1.0
27394,The Last Passage,3180,0,3180,2011.csv,2011,0.0,1.0
27395,Brooklyn's Finest 2012 Re-release,3176,0,3176,2012.csv,2012,0.0,1.0
27396,Elisa Katafha Jamil,3166,0,3166,2014.csv,2014,0.0,1.0
27397,The Last Look 2011 Re-release,3166,0,3166,2011.csv,2011,0.0,1.0
27398,La Sabiduria,3165,0,3165,2019.csv,2019,0.0,1.0
27399,Hard Kaur,3164,0,3164,2017.csv,2017,0.0,1.0
27400,I Think We're Alone Now,3162,0,3162,2018.csv,2018,0.0,1.0
27401,Ikimize Bir Dunya,3162,0,3162,2016.csv,2016,0.0,1.0
27402,Undisputed 3: Redemption 2013 Re-release,3161,0,3161,2013.csv,2013,0.0,1.0
27403,Apart,3161,3161,0,2012.csv,2012,1.0,0.0
27404,El legado estratégico de Juan Perón,3161,0,3161,2016.csv,2016,0.0,1.0
27405,Son Oyun,3159,0,3159,2018.csv,2018,0.0,1.0
27406,Babonki,3152,0,3152,2016.csv,2016,0.0,1.0
27407,Undying Youth,3151,0,3151,2017.csv,2017,0.0,1.0
27408,Angry Buddha,3144,0,3144,2016.csv,2016,0.0,1.0
27409,Game Changers,3142,3142,0,2018.csv,2018,1.0,0.0
27410,Min Elskede,3141,0,3141,2012.csv,2012,0.0,1.0
27411,Ride Along 2 2020 Re-release,3141,0,3141,2020.csv,2020,0.0,1.0
27412,Cilgin Kolej,3141,0,3141,2017.csv,2017,0.0,1.0
27413,Balls to the Wall,3140,3140,0,2011.csv,2011,1.0,0.0
27414,Ardara,3134,0,3134,2019.csv,2019,0.0,1.0
27415,Hot to Trot,3133,3133,0,2018.csv,2018,1.0,0.0
27416,For the Sake of Vicious,3131,0,3131,2021.csv,2021,0.0,1.0
27417,Drama 2018 Re-release,3129,0,3129,2018.csv,2018,0.0,1.0
27418,"Family Romance, LLC",3126,0,3126,2020.csv,2020,0.0,1.0
27419,The Girl on the Train,3124,3124,0,2014.csv,2014,1.0,0.0
27420,Thiruthani,3123,0,3123,2012.csv,2012,0.0,1.0
27421,Brando Unauthorized,3123,0,3123,2011.csv,2011,0.0,1.0
27422,Horoz Bayram,3120,0,3120,2018.csv,2018,0.0,1.0
27423,The Woman in the Fifth 2014 Re-release,3118,0,3118,2014.csv,2014,0.0,1.0
27424,Hawaa,3118,0,3118,2019.csv,2019,0.0,1.0
27425,Tokyo Sonata 2012 Re-release,3117,0,3117,2012.csv,2012,0.0,1.0
27426,Romeo + Juliet 2020 Re-release,3116,0,3116,2020.csv,2020,0.0,1.0
27427,Sucio y desprolijo: El heavy metal en Argentina,3114,0,3114,2016.csv,2016,0.0,1.0
27428,A Distant Place 2011 Re-release,3107,0,3107,2011.csv,2011,0.0,1.0
27429,In Case of Love,3105,0,3105,2010.csv,2010,0.0,1.0
27430,Some Like It Hot 2016 Re-release,3103,0,3103,2017.csv,2017,0.0,1.0
27431,Tríada,3101,0,3101,2016.csv,2016,0.0,1.0
27432,Neve,3101,0,3101,2016.csv,2016,0.0,1.0
27433,Night Shifts,3100,0,3100,2012.csv,2012,0.0,1.0
27434,Showrunners,3100,3100,0,2014.csv,2014,1.0,0.0
27435,Masal,3099,0,3099,2016.csv,2016,0.0,1.0
27436,Blessed Madness 2019 Re-release,3094,0,3094,2019.csv,2019,0.0,1.0
27437,Los Asombrosos Días de Guillermino,3090,0,3090,2016.csv,2016,0.0,1.0
27438,Ashes Over Sun,3089,0,3089,2020.csv,2020,0.0,1.0
27439,What Now? Remind Me,3089,3089,0,2014.csv,2014,1.0,0.0
27440,The Class 2010 Re-release,3088,0,3088,2010.csv,2010,0.0,1.0
27441,The Flower of Kim Jong II 2011 Re-release,3085,0,3085,2011.csv,2011,0.0,1.0
27442,Gogita's New Life,3084,0,3084,2017.csv,2017,0.0,1.0
27443,Dream and Silence 2013 Re-release,3084,0,3084,2013.csv,2013,0.0,1.0
27444,She and Politics,3081,0,3081,2014.csv,2014,0.0,1.0
27445,"Bostofrio, où le ciel rejoint la terre",3080,0,3080,2019.csv,2019,0.0,1.0
27446,Hombre de fe,3079,0,3079,2018.csv,2018,0.0,1.0
27447,Drew: The Man Behind the Poster,3078,3078,0,2013.csv,2013,1.0,0.0
27448,Tales of the Lockdown,3078,0,3078,2020.csv,2020,0.0,1.0
27449,She Never Died,3078,0,3078,2020.csv,2020,0.0,1.0
27450,The Life Sublime,3076,0,3076,2011.csv,2011,0.0,1.0
27451,Chasing Portraits,3076,3076,0,2019.csv,2019,1.0,0.0
27452,El sacrificio de Nehuén Puyelli,3074,0,3074,2016.csv,2016,0.0,1.0
27453,El hombre de las mariposas,3071,0,3071,2012.csv,2012,0.0,1.0
27454,Jóhanna Síðasta orrustan,3066,0,3066,2015.csv,2015,0.0,1.0
27455,Barrage,3064,0,3064,2018.csv,2018,0.0,1.0
27456,Dum Laga Ke Haisha,3064,0,3064,2016.csv,2016,0.0,1.0
27457,The Weird World of Blowfly,3062,3062,0,2011.csv,2011,1.0,0.0
27458,Planet of the Apes 2020 Re-release,3061,0,3061,2020.csv,2020,0.0,1.0
27459,The Afterlight,3059,3059,0,2010.csv,2010,1.0,0.0
27460,The Last Witness,3058,0,3058,2018.csv,2018,0.0,1.0
27461,Unidad XV,3047,0,3047,2018.csv,2018,0.0,1.0
27462,Icarus. The Legend of Mietek Kosz,3042,0,3042,2020.csv,2020,0.0,1.0
27463,Money,3041,0,3041,2017.csv,2017,0.0,1.0
27464,The Squad,3040,0,3040,2012.csv,2012,0.0,1.0
27465,Salvadora,3039,0,3039,2017.csv,2017,0.0,1.0
27466,Max Steel Team Turbo: Fusion Tek,3039,0,3039,2016.csv,2016,0.0,1.0
27467,Bolshoi Ballet: Giselle,3035,0,3035,2020.csv,2020,0.0,1.0
27468,Mulher do Pai,3034,0,3034,2017.csv,2017,0.0,1.0
27469,The Seventh Day,3027,0,3027,2021.csv,2021,0.0,1.0
27470,The Moo Man,3026,0,3026,2013.csv,2013,0.0,1.0
27471,The Adopters,3026,0,3026,2019.csv,2019,0.0,1.0
27472,Hodja Fra Pjort - Hodja Og Töfrateppio,3026,0,3026,2019.csv,2019,0.0,1.0
27473,House for Mermaids,3024,0,3024,2016.csv,2016,0.0,1.0
27474,A French Gigolo 2014 Re-release,3021,3021,0,2014.csv,2014,1.0,0.0
27475,Su Su Sudhi Vathmeekam,3021,0,3021,2015.csv,2015,0.0,1.0
27476,A Girl and a Gun,3018,3018,0,2013.csv,2013,1.0,0.0
27477,Family Games,3018,0,3018,2016.csv,2016,0.0,1.0
27478,Best and Most Beautiful Things,3016,3016,0,2016.csv,2016,1.0,0.0
27479,Likemeback,3015,0,3015,2019.csv,2019,0.0,1.0
27480,Historietas Assombradas: O Filme,3012,0,3012,2018.csv,2018,0.0,1.0
27481,Brazil 2017 Re-release,3010,0,3010,2017.csv,2017,0.0,1.0
27482,Trains of Thoughts,3009,0,3009,2012.csv,2012,0.0,1.0
27483,Tajemství podzemní továrny v Chebu,3007,0,3007,2012.csv,2012,0.0,1.0
27484,Fora Do Figurino: As Medidas Do Jeitinho Brasileiro,3006,0,3006,2013.csv,2013,0.0,1.0
27485,My Father's Bones,3005,0,3005,2019.csv,2019,0.0,1.0
27486,Under the Sky,3005,0,3005,2017.csv,2017,0.0,1.0
27487,No Shade,3003,0,3003,2018.csv,2018,0.0,1.0
27488,One Day Ahead,3001,0,3001,2020.csv,2020,0.0,1.0
27489,101 Weddings,3001,0,3001,2012.csv,2012,0.0,1.0
27490,Zokkomon,3000,3000,0,2011.csv,2011,1.0,0.0
27491,The Lie,3000,3000,0,2011.csv,2011,1.0,0.0
27492,Fatal Assistance,3000,3000,0,2014.csv,2014,1.0,0.0
27493,The Ghosts of Johnson Woods,3000,3000,0,2016.csv,2016,1.0,0.0
27494,11.25: The Day He Chose His Own Fate,2999,0,2999,2012.csv,2012,0.0,1.0
27495,Vennila Kabaddi Kuzhu 2,2999,0,2999,2019.csv,2019,0.0,1.0
27496,Kanaa,2997,0,2997,2018.csv,2018,0.0,1.0
27497,Delicia,2994,0,2994,2017.csv,2017,0.0,1.0
27498,Moana,2993,2993,0,2015.csv,2015,1.0,0.0
27499,Until Judge Do Us Part,2985,0,2985,2018.csv,2018,0.0,1.0
27500,Fenomen 2018 Re-release,2984,0,2984,2018.csv,2018,0.0,1.0
27501,Tuesdays and Fridays,2983,0,2983,2021.csv,2021,0.0,1.0
27502,"Cadete Amarilla, mi hijo",2982,0,2982,2019.csv,2019,0.0,1.0
27503,An Ordinary Man,2980,0,2980,2012.csv,2012,0.0,1.0
27504,Last Fool Show,2979,0,2979,2019.csv,2019,0.0,1.0
27505,Rondo 2011 Re-release,2979,0,2979,2011.csv,2011,0.0,1.0
27506,The Daughters of Fire,2978,0,2978,2018.csv,2018,0.0,1.0
27507,No Comment,2975,0,2975,2015.csv,2015,0.0,1.0
27508,Losing Alaska,2974,0,2974,2019.csv,2019,0.0,1.0
27509,Rauf,2973,0,2973,2016.csv,2016,0.0,1.0
27510,Miracolul din Tekir,2968,0,2968,2016.csv,2016,0.0,1.0
27511,The Cardboard Village 2013 Re-release,2965,0,2965,2013.csv,2013,0.0,1.0
27512,Pink or Bell,2963,0,2963,2020.csv,2020,0.0,1.0
27513,The Woman of My Life,2963,0,2963,2016.csv,2016,0.0,1.0
27514,Boys from the Mountains,2963,0,2963,2018.csv,2018,0.0,1.0
27515,Stranded,2961,0,2961,2019.csv,2019,0.0,1.0
27516,Project Nim 2013 Re-release,2959,0,2959,2013.csv,2013,0.0,1.0
27517,Mi pasión por David,2958,0,2958,2020.csv,2020,0.0,1.0
27518,Gupyoshka,2952,0,2952,2018.csv,2018,0.0,1.0
27519,Nabab,2945,0,2945,2017.csv,2017,0.0,1.0
27520,Gunman,2943,0,2943,2019.csv,2019,0.0,1.0
27521,Free to Run,2943,0,2943,2016.csv,2016,0.0,1.0
27522,Las constituyentes,2942,0,2942,2012.csv,2012,0.0,1.0
27523,Welcome to Norway 2017 Re-release,2942,0,2942,2017.csv,2017,0.0,1.0
27524,13 Graves,2938,0,2938,2020.csv,2020,0.0,1.0
27525,Il mundial dimenticato,2936,0,2936,2012.csv,2012,0.0,1.0
27526,Biet Doi Tu Than 2017 Re-release,2935,0,2935,2017.csv,2017,0.0,1.0
27527,Piano Mudo,2933,0,2933,2010.csv,2010,0.0,1.0
27528,To Sing in Piter,2933,0,2933,2018.csv,2018,0.0,1.0
27529,Hvað er svona merkilegt við það?,2932,0,2932,2015.csv,2015,0.0,1.0
27530,"Jacques Leonard, el payo Chac",2930,0,2930,2011.csv,2011,0.0,1.0
27531,Two Weddings and a Funeral,2928,0,2928,2013.csv,2013,0.0,1.0
27532,Angels Never Cry,2926,0,2926,2019.csv,2019,0.0,1.0
27533,The Debt,2924,0,2924,2019.csv,2019,0.0,1.0
27534,Aska Geldik,2924,0,2924,2017.csv,2017,0.0,1.0
27535,Kepler's Dream,2923,2923,0,2017.csv,2017,1.0,0.0
27536,Foxfire: Confessions of a Girl Gang 2016 Re-release,2921,0,2921,2016.csv,2016,0.0,1.0
27537,The Comedian,2921,0,2921,2013.csv,2013,0.0,1.0
27538,The Matchmaker,2920,0,2920,2012.csv,2012,0.0,1.0
27539,Sakurada Reset Part I,2913,0,2913,2017.csv,2017,0.0,1.0
27540,Bambaska,2912,0,2912,2017.csv,2017,0.0,1.0
27541,"You, the Living 2011 Re-release",2911,0,2911,2011.csv,2011,0.0,1.0
27542,Valliyum Thetti Pulliyum Thetti,2911,0,2911,2016.csv,2016,0.0,1.0
27543,içerdekiler,2910,0,2910,2019.csv,2019,0.0,1.0
27544,Drôle de père,2909,0,2909,2019.csv,2019,0.0,1.0
27545,A Secret 2013 Re-release,2908,0,2908,2013.csv,2013,0.0,1.0
27546,Majnu,2906,0,2906,2016.csv,2016,0.0,1.0
27547,Teacher and Stray Cat,2906,0,2906,2020.csv,2020,0.0,1.0
27548,Dream of Youth,2904,0,2904,2016.csv,2016,0.0,1.0
27549,Le problème d'infiltration,2903,0,2903,2019.csv,2019,0.0,1.0
27550,Yoddha The Warrior,2903,0,2903,2014.csv,2014,0.0,1.0
27551,Kaake Da Viyah,2903,0,2903,2019.csv,2019,0.0,1.0
27552,Chieri and Cherry,2902,0,2902,2018.csv,2018,0.0,1.0
27553,Laputa,2902,0,2902,2015.csv,2015,0.0,1.0
27554,After.Life 2013 Re-release,2901,0,2901,2013.csv,2013,0.0,1.0
27555,Demons,2900,2900,0,2017.csv,2017,1.0,0.0
27556,New York November,2897,0,2897,2011.csv,2011,0.0,1.0
27557,The Savior,2894,0,2894,2019.csv,2019,0.0,1.0
27558,Respirar,2889,0,2889,2018.csv,2018,0.0,1.0
27559,Spirit of Jaguar,2888,0,2888,2018.csv,2018,0.0,1.0
27560,Finding Fela 2016 Re-release,2882,0,2882,2016.csv,2016,0.0,1.0
27561,Il Regno,2880,0,2880,2020.csv,2020,0.0,1.0
27562,Desi Munde,2879,0,2879,2016.csv,2016,0.0,1.0
27563,Taxi zum Klo,2878,0,2878,2011.csv,2011,0.0,1.0
27564,The Darkest Universe,2875,0,2875,2016.csv,2016,0.0,1.0
27565,Northless 2012 Re-release,2872,0,2872,2012.csv,2012,0.0,1.0
27566,The Boonies,2872,2872,0,2021.csv,2021,1.0,0.0
27567,Gurkha,2870,0,2870,2019.csv,2019,0.0,1.0
27568,Sonata for Cello,2869,0,2869,2015.csv,2015,0.0,1.0
27569,The Wolberg Family,2867,0,2867,2010.csv,2010,0.0,1.0
27570,Harmony,2867,0,2867,2019.csv,2019,0.0,1.0
27571,La guía del silencio,2862,0,2862,2011.csv,2011,0.0,1.0
27572,Voces desde Mozambique,2856,0,2856,2011.csv,2011,0.0,1.0
27573,The Man Who Saved the World,2855,0,2855,2018.csv,2018,0.0,1.0
27574,Viyah 70 Km,2853,0,2853,2013.csv,2013,0.0,1.0
27575,Heads and Tails,2853,0,2853,2019.csv,2019,0.0,1.0
27576,The Professor: Tai Chi's Journey West,2852,2852,0,2016.csv,2016,1.0,0.0
27577,"Yo Sandro, La película",2849,0,2849,2018.csv,2018,0.0,1.0
27578,Shtetlers,2849,0,2849,2020.csv,2020,0.0,1.0
27579,Thale 2013 Re-release,2848,0,2848,2013.csv,2013,0.0,1.0
27580,Dinner with My Sisters,2848,0,2848,2012.csv,2012,0.0,1.0
27581,"Oh, quina joia!",2847,0,2847,2016.csv,2016,0.0,1.0
27582,Thimiru Pudichavan,2841,0,2841,2018.csv,2018,0.0,1.0
27583,Europolis,2839,0,2839,2010.csv,2010,0.0,1.0
27584,Purano Dunga,2836,0,2836,2017.csv,2017,0.0,1.0
27585,Sokagin Çocuklari,2833,0,2833,2019.csv,2019,0.0,1.0
27586,Asas,2833,0,2833,2018.csv,2018,0.0,1.0
27587,Present Perfect,2831,0,2831,2017.csv,2017,0.0,1.0
27588,Pool 2010 Re-release,2831,0,2831,2010.csv,2010,0.0,1.0
27589,Alone at My Wedding,2829,0,2829,2018.csv,2018,0.0,1.0
27590,Parallelnye pryamye peresekayutsya v beskonechnosti,2827,0,2827,2016.csv,2016,0.0,1.0
27591,Little Nicholas 2015 Re-release,2827,0,2827,2015.csv,2015,0.0,1.0
27592,Ahora o nunca 2016 Re-release,2824,0,2824,2016.csv,2016,0.0,1.0
27593,She Comes Back on Thursday,2823,0,2823,2016.csv,2016,0.0,1.0
27594,The Perfect Host 2013 Re-release,2823,0,2823,2013.csv,2013,0.0,1.0
27595,Irina,2821,0,2821,2019.csv,2019,0.0,1.0
27596,Ata tu arado a una estrella,2815,0,2815,2018.csv,2018,0.0,1.0
27597,Obvorozhitelnaya planeta,2814,0,2814,2019.csv,2019,0.0,1.0
27598,Naked Beauty,2813,0,2813,2016.csv,2016,0.0,1.0
27599,Simone,2812,0,2812,2013.csv,2013,0.0,1.0
27600,Atenas,2806,0,2806,2019.csv,2019,0.0,1.0
27601,Poligamy 2013 Re-release,2806,0,2806,2013.csv,2013,0.0,1.0
27602,Chamada a Cobrar,2805,0,2805,2013.csv,2013,0.0,1.0
27603,Boudu Saved from Drowning,2805,0,2805,2010.csv,2010,0.0,1.0
27604,The Last Shot 2018 Re-release,2804,0,2804,2018.csv,2018,0.0,1.0
27605,Pretham,2804,0,2804,2016.csv,2016,0.0,1.0
27606,Approaching Midnight,2795,2795,0,2013.csv,2013,1.0,0.0
27607,The Prime Minister,2793,0,2793,2017.csv,2017,0.0,1.0
27608,The Bikes of Wrath,2792,0,2792,2019.csv,2019,0.0,1.0
27609,Wonderful Town 2010 Re-release,2791,0,2791,2010.csv,2010,0.0,1.0
27610,Taanashah,2791,0,2791,2020.csv,2020,0.0,1.0
27611,Amélie 2011 Re-release,2788,0,2788,2011.csv,2011,0.0,1.0
27612,Zoom,2784,0,2784,2016.csv,2016,0.0,1.0
27613,Nana,2784,2784,0,2018.csv,2018,1.0,0.0
27614,Indie-AniFest 2010,2782,0,2782,2010.csv,2010,0.0,1.0
27615,Red Sonja 2018 Re-release,2782,0,2782,2018.csv,2018,0.0,1.0
27616,Body of Water,2777,0,2777,2020.csv,2020,0.0,1.0
27617,Evanukku Engeyo Matcham Irukku,2776,0,2776,2018.csv,2018,0.0,1.0
27618,Le criquet,2775,0,2775,2011.csv,2011,0.0,1.0
27619,Multoboz,2772,0,2772,2018.csv,2018,0.0,1.0
27620,Detective Conan: Crimson Love Letter 2018 Re-release,2771,0,2771,2018.csv,2018,0.0,1.0
27621,SACA: O filme de Tiago Pires,2767,0,2767,2016.csv,2016,0.0,1.0
27622,What Just Happened 2014 Re-release,2767,0,2767,2014.csv,2014,0.0,1.0
27623,Desmadre,2764,0,2764,2012.csv,2012,0.0,1.0
27624,Frontera,2762,0,2762,2013.csv,2013,0.0,1.0
27625,Blood Ties,2760,2760,0,2011.csv,2011,1.0,0.0
27626,Rampaat,2760,0,2760,2019.csv,2019,0.0,1.0
27627,White Lies 2016 Re-release,2760,2760,0,2016.csv,2016,1.0,0.0
27628,The Big Dipper,2759,0,2759,2019.csv,2019,0.0,1.0
27629,Pororoca 2019 Re-release,2758,0,2758,2019.csv,2019,0.0,1.0
27630,Bustin' Chops: The Movie,2758,0,2758,2013.csv,2013,0.0,1.0
27631,Excision,2757,0,2757,2012.csv,2012,0.0,1.0
27632,Tere Ishq Nachaya,2756,0,2756,2010.csv,2010,0.0,1.0
27633,Billy Elliot 2020 Re-release,2755,0,2755,2020.csv,2020,0.0,1.0
27634,A Man Who Is Obsessed With Donkey,2754,0,2754,2019.csv,2019,0.0,1.0
27635,Ünye de Fatsa arasi,2752,0,2752,2011.csv,2011,0.0,1.0
27636,New York in New York,2743,0,2743,2019.csv,2019,0.0,1.0
27637,Retaliation,2741,0,2741,2017.csv,2017,0.0,1.0
27638,Phase 7 2014 Re-release,2740,0,2740,2014.csv,2014,0.0,1.0
27639,I Dream in Another Language,2739,2739,0,2017.csv,2017,1.0,0.0
27640,Abhrahaminte Santhathikal,2735,0,2735,2018.csv,2018,0.0,1.0
27641,Black Out 2014 Re-release,2734,2734,0,2014.csv,2014,1.0,0.0
27642,The Lesser Blessed,2732,2732,0,2013.csv,2013,1.0,0.0
27643,Vinyl Days,2730,0,2730,2013.csv,2013,0.0,1.0
27644,Valley of the Forgotten,2730,0,2730,2012.csv,2012,0.0,1.0
27645,Late Spring 2018 Re-release,2724,0,2724,2018.csv,2018,0.0,1.0
27646,Lad Gaya Pecha,2719,0,2719,2010.csv,2010,0.0,1.0
27647,Veredas,2717,0,2717,2017.csv,2017,0.0,1.0
27648,Agir Kelepce,2715,0,2715,2017.csv,2017,0.0,1.0
27649,Requiem for Mrs. J,2713,0,2713,2018.csv,2018,0.0,1.0
27650,Shining Inheritance,2712,0,2712,2011.csv,2011,0.0,1.0
27651,Rak Leaw Feaw,2710,0,2710,2012.csv,2012,0.0,1.0
27652,Julia,2710,2710,0,2015.csv,2015,1.0,0.0
27653,Chocolat 2015 Re-release,2710,2710,0,2015.csv,2015,1.0,0.0
27654,Yemekteydik ve Karar Verdim,2707,0,2707,2016.csv,2016,0.0,1.0
27655,Eichmann,2706,2706,0,2010.csv,2010,1.0,0.0
27656,Six Million and One,2704,0,2704,2012.csv,2012,0.0,1.0
27657,Una Comedia Macabra,2702,0,2702,2018.csv,2018,0.0,1.0
27658,Burning Men,2702,0,2702,2019.csv,2019,0.0,1.0
27659,Coracao Do Brasil,2701,0,2701,2013.csv,2013,0.0,1.0
27660,Back to the Fatherland,2697,2697,0,2019.csv,2019,1.0,0.0
27661,À ciel ouvert,2696,0,2696,2011.csv,2011,0.0,1.0
27662,Medzi nami,2695,0,2695,2017.csv,2017,0.0,1.0
27663,Justice League 2020 Re-release,2692,0,2692,2020.csv,2020,0.0,1.0
27664,The Pigeon Thieves,2692,0,2692,2019.csv,2019,0.0,1.0
27665,Tokiori - Dobras do Tempo,2686,0,2686,2013.csv,2013,0.0,1.0
27666,Santoalla,2684,2684,0,2017.csv,2017,1.0,0.0
27667,Straight Into a Storm,2684,2684,0,2018.csv,2018,1.0,0.0
27668,Banana Island Ghost,2683,0,2683,2017.csv,2017,0.0,1.0
27669,Els records glaçats,2682,0,2682,2013.csv,2013,0.0,1.0
27670,Division 19,2680,1699,981,2019.csv,2019,0.633955223880597,0.366044776119403
27671,Holiday,2678,0,2678,2019.csv,2019,0.0,1.0
27672,Setembro a vida inteira,2674,0,2674,2018.csv,2018,0.0,1.0
27673,To Love a Woman,2674,0,2674,2010.csv,2010,0.0,1.0
27674,Queerama,2672,0,2672,2017.csv,2017,0.0,1.0
27675,Catfight,2666,0,2666,2017.csv,2017,0.0,1.0
27676,The Odd One Out,2666,0,2666,2010.csv,2010,0.0,1.0
27677,Restitution,2664,2664,0,2011.csv,2011,1.0,0.0
27678,Gangsters Gamblers Geezers,2662,0,2662,2016.csv,2016,0.0,1.0
27679,United Red Army 2011 Re-release,2659,2659,0,2011.csv,2011,1.0,0.0
27680,The Man from the Future,2659,0,2659,2016.csv,2016,0.0,1.0
27681,Festival TV. Achtung Berlin: Crashkurs/Der Pabst ist kein Jeansboy,2656,0,2656,2013.csv,2013,0.0,1.0
27682,4 Metros,2654,0,2654,2019.csv,2019,0.0,1.0
27683,Mussolini va a morir,2653,0,2653,2013.csv,2013,0.0,1.0
27684,Limbo 2015 Re-release,2650,0,2650,2015.csv,2015,0.0,1.0
27685,All Must Die,2650,0,2650,2020.csv,2020,0.0,1.0
27686,Bocksprünge,2649,0,2649,2014.csv,2014,0.0,1.0
27687,Daughter of the Nile,2640,2640,0,2017.csv,2017,1.0,0.0
27688,Family Members,2638,0,2638,2019.csv,2019,0.0,1.0
27689,El derrotado,2638,0,2638,2011.csv,2011,0.0,1.0
27690,Dan in Real Life 2013 Re-release,2636,0,2636,2013.csv,2013,0.0,1.0
27691,Body,2634,2634,0,2015.csv,2015,1.0,0.0
27692,Brava,2632,0,2632,2017.csv,2017,0.0,1.0
27693,Alpha: The Right to Kill,2632,0,2632,2019.csv,2019,0.0,1.0
27694,Everything Will Not Be Fine,2631,0,2631,2020.csv,2020,0.0,1.0
27695,Refuge,2631,2631,0,2014.csv,2014,1.0,0.0
27696,Jayantabhai Ki Luv Story,2628,0,2628,2013.csv,2013,0.0,1.0
27697,Bordertown 2010 Re-release,2628,0,2628,2010.csv,2010,0.0,1.0
27698,Estação Liberdade,2627,0,2627,2014.csv,2014,0.0,1.0
27699,A Nightmare on Elm Street 2020 Re-release,2624,0,2624,2020.csv,2020,0.0,1.0
27700,Kalavani 2,2623,0,2623,2019.csv,2019,0.0,1.0
27701,Mar,2623,0,2623,2019.csv,2019,0.0,1.0
27702,Dai leung to sa,2621,0,2621,2015.csv,2015,0.0,1.0
27703,Indigo Children,2621,2621,0,2014.csv,2014,1.0,0.0
27704,ACORN and the Firestorm,2621,2621,0,2018.csv,2018,1.0,0.0
27705,Sophichka,2617,0,2617,2017.csv,2017,0.0,1.0
27706,Winter Smells,2616,0,2616,2011.csv,2011,0.0,1.0
27707,Reading by Justino,2614,0,2614,2019.csv,2019,0.0,1.0
27708,Finders Keepers,2613,0,2613,2017.csv,2017,0.0,1.0
27709,Made in Hungaria 2011 Re-release,2611,0,2611,2011.csv,2011,0.0,1.0
27710,Batman v Superman: Dawn of Justice 2020 Re-release,2609,0,2609,2020.csv,2020,0.0,1.0
27711,Dot.com 2011 Re-release,2604,0,2604,2011.csv,2011,0.0,1.0
27712,Sparrows Dance,2602,2602,0,2013.csv,2013,1.0,0.0
27713,Anandi Gopal Joshi,2602,0,2602,2019.csv,2019,0.0,1.0
27714,Las olas,2598,0,2598,2018.csv,2018,0.0,1.0
27715,Last Flight of the Champion,2597,2597,0,2013.csv,2013,1.0,0.0
27716,Rockfield: The Studio on the Farm,2597,0,2597,2020.csv,2020,0.0,1.0
27717,Acorazado,2596,0,2596,2012.csv,2012,0.0,1.0
27718,Carl,2592,2592,0,2012.csv,2012,1.0,0.0
27719,Jake Squared,2592,2592,0,2014.csv,2014,1.0,0.0
27720,My Way 2013 Re-release,2590,0,2590,2013.csv,2013,0.0,1.0
27721,Fellini of the Spirits,2586,0,2586,2021.csv,2021,0.0,1.0
27722,Scossa,2586,0,2586,2012.csv,2012,0.0,1.0
27723,Take Me,2583,2583,0,2017.csv,2017,1.0,0.0
27724,Government of Children 3D x Romania,2581,0,2581,2019.csv,2019,0.0,1.0
27725,Impulso,2580,0,2580,2018.csv,2018,0.0,1.0
27726,Siddah,2579,0,2579,2019.csv,2019,0.0,1.0
27727,Hyde & Seek,2577,0,2577,2016.csv,2016,0.0,1.0
27728,Moon Hotel Kabul,2577,0,2577,2018.csv,2018,0.0,1.0
27729,McCanick,2572,2572,0,2014.csv,2014,1.0,0.0
27730,Héroe Corriente,2572,0,2572,2017.csv,2017,0.0,1.0
27731,Hayride 2,2571,2571,0,2015.csv,2015,1.0,0.0
27732,Ray Harryhausen: Special Effects Titan,2571,0,2571,2012.csv,2012,0.0,1.0
27733,Deadly Daphne's Revenge,2570,0,2570,2016.csv,2016,0.0,1.0
27734,Munthiri Monchan,2568,0,2568,2020.csv,2020,0.0,1.0
27735,Joan the Maid 1: The Battles,2562,2562,0,2019.csv,2019,1.0,0.0
27736,Oru Muthassi Gadha,2560,0,2560,2016.csv,2016,0.0,1.0
27737,The Full Monteverdi,2560,0,2560,2010.csv,2010,0.0,1.0
27738,Light Years,2555,0,2555,2016.csv,2016,0.0,1.0
27739,Nude,2555,0,2555,2018.csv,2018,0.0,1.0
27740,Kids in Love,2553,0,2553,2016.csv,2016,0.0,1.0
27741,Forever Chape,2552,0,2552,2018.csv,2018,0.0,1.0
27742,Jihne Mera Dil Luteya,2551,0,2551,2011.csv,2011,0.0,1.0
27743,Finisterrae,2550,0,2550,2010.csv,2010,0.0,1.0
27744,The Brave,2548,0,2548,2019.csv,2019,0.0,1.0
27745,Durj,2547,0,2547,2019.csv,2019,0.0,1.0
27746,Cassadaga,2544,2544,0,2013.csv,2013,1.0,0.0
27747,Robert Mitchum Is Dead,2542,0,2542,2011.csv,2011,0.0,1.0
27748,French Cancan 2018 Re-release,2540,0,2540,2018.csv,2018,0.0,1.0
27749,Two-Bit Waltz,2540,2540,0,2014.csv,2014,1.0,0.0
27750,The Con Artist,2538,0,2538,2011.csv,2011,0.0,1.0
27751,Com Um Pouco de Fé,2537,0,2537,2016.csv,2016,0.0,1.0
27752,Miles,2537,2537,0,2017.csv,2017,1.0,0.0
27753,Precious Life,2534,0,2534,2011.csv,2011,0.0,1.0
27754,A Impossibilidade de Estar Só,2532,0,2532,2020.csv,2020,0.0,1.0
27755,The Grass Is Greener,2530,0,2530,2010.csv,2010,0.0,1.0
27756,"Buen día, día",2529,0,2529,2011.csv,2011,0.0,1.0
27757,Darra,2529,0,2529,2016.csv,2016,0.0,1.0
27758,Two Men in Manhattan,2527,0,2527,2018.csv,2018,0.0,1.0
27759,The Avengers 2020 Re-release,2527,0,2527,2020.csv,2020,0.0,1.0
27760,Kusina Kings,2526,0,2526,2018.csv,2018,0.0,1.0
27761,Another Forever,2523,0,2523,2017.csv,2017,0.0,1.0
27762,Los Vagos,2523,0,2523,2018.csv,2018,0.0,1.0
27763,Lynn + Lucy,2518,0,2518,2020.csv,2020,0.0,1.0
27764,Twenty8k,2517,0,2517,2012.csv,2012,0.0,1.0
27765,Connect,2511,0,2511,2019.csv,2019,0.0,1.0
27766,Magic Paris 2,2511,0,2511,2011.csv,2011,0.0,1.0
27767,Kritik,2510,0,2510,2020.csv,2020,0.0,1.0
27768,Condemned to Remember,2510,0,2510,2017.csv,2017,0.0,1.0
27769,Almost in Love,2510,2510,0,2013.csv,2013,1.0,0.0
27770,Pear Blossom,2508,0,2508,2019.csv,2019,0.0,1.0
27771,Praça Paris,2506,0,2506,2018.csv,2018,0.0,1.0
27772,La nit que va morir l'Elvis,2506,0,2506,2011.csv,2011,0.0,1.0
27773,Pendular,2505,0,2505,2018.csv,2018,0.0,1.0
27774,The Disenchanted,2504,0,2504,2017.csv,2017,0.0,1.0
27775,Redacted 2010 Re-release,2502,0,2502,2010.csv,2010,0.0,1.0
27776,Mekong Hotel,2502,2502,0,2016.csv,2016,1.0,0.0
27777,Winterlong,2499,0,2499,2019.csv,2019,0.0,1.0
27778,La otra piel,2498,0,2498,2018.csv,2018,0.0,1.0
27779,Roman,2498,0,2498,2018.csv,2018,0.0,1.0
27780,High-Rise 2017 Re-release,2498,0,2498,2017.csv,2017,0.0,1.0
27781,Toda esta sangre en el monte,2496,0,2496,2018.csv,2018,0.0,1.0
27782,Naked Youth,2496,0,2496,2018.csv,2018,0.0,1.0
27783,Bend It Like Beckham 2020 Re-release,2495,0,2495,2020.csv,2020,0.0,1.0
27784,Here for Life,2493,0,2493,2019.csv,2019,0.0,1.0
27785,The Metropolitan Opera HD Live: Wagner: Götterdämmerung 2012 Re-release,2493,0,2493,2012.csv,2012,0.0,1.0
27786,Roberta 2013 Re-release,2493,0,2493,2013.csv,2013,0.0,1.0
27787,The Last Day of August,2492,2492,0,2013.csv,2013,1.0,0.0
27788,Being Venice,2492,0,2492,2013.csv,2013,0.0,1.0
27789,Homeland (Iraq Year Zero),2491,2491,0,2016.csv,2016,1.0,0.0
27790,Cuando Brillan las Estrellas,2490,0,2490,2018.csv,2018,0.0,1.0
27791,Salute 2012 Re-release,2486,0,2486,2012.csv,2012,0.0,1.0
27792,Yemaali,2486,0,2486,2018.csv,2018,0.0,1.0
27793,Super Models,2483,0,2483,2015.csv,2015,0.0,1.0
27794,Thoppil Joppan,2483,0,2483,2016.csv,2016,0.0,1.0
27795,Men at Lunch,2483,2483,0,2013.csv,2013,1.0,0.0
27796,The Wait,2480,2480,0,2014.csv,2014,1.0,0.0
27797,Gun Shy,2480,0,2480,2018.csv,2018,0.0,1.0
27798,Du und ich,2478,0,2478,2011.csv,2011,0.0,1.0
27799,Aandavan Kattalai,2476,0,2476,2016.csv,2016,0.0,1.0
27800,Isra en het magische boek,2472,0,2472,2017.csv,2017,0.0,1.0
27801,The Shock of the Future,2469,0,2469,2019.csv,2019,0.0,1.0
27802,Portrait of Animal Behavior,2468,0,2468,2015.csv,2015,0.0,1.0
27803,Prorub,2465,0,2465,2017.csv,2017,0.0,1.0
27804,TINY: The Life of Erin Blackwell,2465,2465,0,2019.csv,2019,1.0,0.0
27805,The Truth Commissioner,2464,0,2464,2016.csv,2016,0.0,1.0
27806,You Can't Escape Lithuania,2464,0,2464,2016.csv,2016,0.0,1.0
27807,Lacuna,2463,0,2463,2012.csv,2012,0.0,1.0
27808,Of Loves And Lies,2463,0,2463,2019.csv,2019,0.0,1.0
27809,Love 1. Dog,2462,0,2462,2018.csv,2018,0.0,1.0
27810,The Young Offenders 2018 Re-release,2460,0,2460,2018.csv,2018,0.0,1.0
27811,Callback 2018 Re-release,2456,0,2456,2018.csv,2018,0.0,1.0
27812,Life Feels Good 2015 Re-release,2454,0,2454,2015.csv,2015,0.0,1.0
27813,Several Conversations About a Very Tall Girl,2450,0,2450,2018.csv,2018,0.0,1.0
27814,Ladder to Damascus,2450,0,2450,2015.csv,2015,0.0,1.0
27815,Cody the Robosapien 2015 Re-release,2447,0,2447,2015.csv,2015,0.0,1.0
27816,Örümcek,2445,0,2445,2017.csv,2017,0.0,1.0
27817,Labirinty lyubvi,2444,0,2444,2017.csv,2017,0.0,1.0
27818,Oldboy,2443,0,2443,2020.csv,2020,0.0,1.0
27819,Ballroom Dancer,2442,0,2442,2013.csv,2013,0.0,1.0
27820,Zhaleika,2438,0,2438,2016.csv,2016,0.0,1.0
27821,Boleto al paraíso,2438,0,2438,2011.csv,2011,0.0,1.0
27822,The Ghastly Love of Johnny X,2436,2436,0,2012.csv,2012,1.0,0.0
27823,Nela Ticket,2435,0,2435,2018.csv,2018,0.0,1.0
27824,"Tango in Paris, Memories of Astor Piazzolla",2432,0,2432,2017.csv,2017,0.0,1.0
27825,Why Stop Now?,2432,2432,0,2012.csv,2012,1.0,0.0
27826,Iyi ki Dogdun Abla,2431,0,2431,2018.csv,2018,0.0,1.0
27827,Tetragrammaton,2431,0,2431,2017.csv,2017,0.0,1.0
27828,El amor amargo de Chavela,2428,0,2428,2013.csv,2013,0.0,1.0
27829,The Symmetry of Love,2425,0,2425,2011.csv,2011,0.0,1.0
27830,Al final todos mueren,2425,0,2425,2013.csv,2013,0.0,1.0
27831,The Reflektor Tapes,2424,0,2424,2015.csv,2015,0.0,1.0
27832,L.A. Slasher,2421,2421,0,2015.csv,2015,1.0,0.0
27833,Za kulisami,2419,0,2419,2019.csv,2019,0.0,1.0
27834,Penny Slinger: Out of the Shadows,2405,0,2405,2019.csv,2019,0.0,1.0
27835,The Tayo Movie: Mission Ace,2404,0,2404,2019.csv,2019,0.0,1.0
27836,Ek Hazarachi Note,2404,2404,0,2016.csv,2016,1.0,0.0
27837,The Incident,2401,0,2401,2016.csv,2016,0.0,1.0
27838,Rosso Mille Miglia,2400,0,2400,2016.csv,2016,0.0,1.0
27839,17 Girls 2018 Re-release,2398,0,2398,2018.csv,2018,0.0,1.0
27840,Uti ao Aka: A Reykspuandi Kadilakk yfir Ameriku,2396,0,2396,2016.csv,2016,0.0,1.0
27841,Sera,2395,0,2395,2018.csv,2018,0.0,1.0
27842,Queridísimos intelectuales (del placer y del dolor),2394,0,2394,2012.csv,2012,0.0,1.0
27843,The Hateful Eight 2020 Re-release,2393,0,2393,2020.csv,2020,0.0,1.0
27844,Packing Heavy,2389,0,2389,2018.csv,2018,0.0,1.0
27845,Escuela trashumante,2387,0,2387,2017.csv,2017,0.0,1.0
27846,Black Diamond,2384,0,2384,2011.csv,2011,0.0,1.0
27847,Ramante Edenthottam,2383,0,2383,2017.csv,2017,0.0,1.0
27848,Rak fang khiao,2381,0,2381,2014.csv,2014,0.0,1.0
27849,Parthenon,2380,0,2380,2019.csv,2019,0.0,1.0
27850,Al centro de la Tierra,2379,0,2379,2017.csv,2017,0.0,1.0
27851,Tudo,2374,0,2374,2016.csv,2016,0.0,1.0
27852,The Buoy,2374,0,2374,2018.csv,2018,0.0,1.0
27853,Daniel and Ana,2372,2372,0,2010.csv,2010,1.0,0.0
27854,Break My Fall,2372,0,2372,2011.csv,2011,0.0,1.0
27855,The Condemned 2014 Re-release,2372,0,2372,2014.csv,2014,0.0,1.0
27856,True Mothers,2371,0,2371,2020.csv,2020,0.0,1.0
27857,Moondance,2371,2371,0,2020.csv,2020,1.0,0.0
27858,Rebecca 2016 Re-release,2370,0,2370,2016.csv,2016,0.0,1.0
27859,Mission: Impossible - Rogue Nation 2020 Re-release,2369,0,2369,2020.csv,2020,0.0,1.0
27860,Yahan Sabhi Gyani Hain,2368,0,2368,2020.csv,2020,0.0,1.0
27861,Playing for Charlie,2367,0,2367,2010.csv,2010,0.0,1.0
27862,As Hiper Mulheres,2367,0,2367,2013.csv,2013,0.0,1.0
27863,12 Paces Without a Head 2012 Re-release,2366,0,2366,2012.csv,2012,0.0,1.0
27864,Dino Cazzola: Uma Filmografia de Brasília,2365,0,2365,2012.csv,2012,0.0,1.0
27865,Act of Valor 2014 Re-release,2364,0,2364,2014.csv,2014,0.0,1.0
27866,Evergreen: The Road to Legalization,2363,2363,0,2014.csv,2014,1.0,0.0
27867,Six Musicians and the City,2361,0,2361,2017.csv,2017,0.0,1.0
27868,Castle in the Sky 2020 Re-release,2361,0,2361,2020.csv,2020,0.0,1.0
27869,The Conspirator 2014 Re-release,2361,0,2361,2014.csv,2014,0.0,1.0
27870,Porfirio 2013 Re-release,2358,0,2358,2013.csv,2013,0.0,1.0
27871,A Gentle Creature,2356,0,2356,2019.csv,2019,0.0,1.0
27872,I Lost Albert 2019 Re-release,2354,2354,0,2019.csv,2019,1.0,0.0
27873,Králové videa,2353,0,2353,2020.csv,2020,0.0,1.0
27874,2177: The San Francisco Love Hacker Crimes,2350,0,2350,2020.csv,2020,0.0,1.0
27875,Vellai Pookal,2349,0,2349,2019.csv,2019,0.0,1.0
27876,A Comedy of Tears,2346,0,2346,2017.csv,2017,0.0,1.0
27877,Goodland 2019 Re-release,2343,0,2343,2019.csv,2019,0.0,1.0
27878,A German Youth,2343,2343,0,2019.csv,2019,1.0,0.0
27879,45th Parallel,2342,0,2342,2016.csv,2016,0.0,1.0
27880,The Killing Jar,2339,0,2339,2010.csv,2010,0.0,1.0
27881,Dog Flesh,2335,0,2335,2013.csv,2013,0.0,1.0
27882,Kande,2333,0,2333,2018.csv,2018,0.0,1.0
27883,The Marriage,2330,0,2330,2012.csv,2012,0.0,1.0
27884,Anida and a Floating Circus,2329,0,2329,2017.csv,2017,0.0,1.0
27885,Curator,2329,0,2329,2020.csv,2020,0.0,1.0
27886,Load,2328,0,2328,2013.csv,2013,0.0,1.0
27887,Emma,2326,0,2326,2018.csv,2018,0.0,1.0
27888,Enfant Terrible,2326,0,2326,2020.csv,2020,0.0,1.0
27889,Lotus Eaters,2325,2325,0,2013.csv,2013,1.0,0.0
27890,Victory Day,2324,0,2324,2018.csv,2018,0.0,1.0
27891,Multistorii,2324,0,2324,2018.csv,2018,0.0,1.0
27892,Khatre Da Ghuggu,2324,0,2324,2020.csv,2020,0.0,1.0
27893,321 Action,2319,0,2319,2020.csv,2020,0.0,1.0
27894,The Rhythm of Chopsticks,2315,0,2315,2010.csv,2010,0.0,1.0
27895,Salvador Dali: In Search of Immortality,2315,0,2315,2020.csv,2020,0.0,1.0
27896,Procesul,2314,0,2314,2018.csv,2018,0.0,1.0
27897,The Happy House,2311,2311,0,2013.csv,2013,1.0,0.0
27898,Esa sensación,2310,0,2310,2016.csv,2016,0.0,1.0
27899,The Rezort,2309,0,2309,2016.csv,2016,0.0,1.0
27900,Goldie,2302,2302,0,2020.csv,2020,1.0,0.0
27901,Hit,2298,0,2298,2018.csv,2018,0.0,1.0
27902,Serendipity,2298,2298,0,2019.csv,2019,1.0,0.0
27903,Love of My Loves 2016 Re-release,2293,0,2293,2016.csv,2016,0.0,1.0
27904,The Murder Farm 2012 Re-release,2293,0,2293,2012.csv,2012,0.0,1.0
27905,The Thing 2020 Re-release,2293,0,2293,2020.csv,2020,0.0,1.0
27906,Rascal,2293,0,2293,2017.csv,2017,0.0,1.0
27907,The Train of Salt and Sugar,2293,0,2293,2017.csv,2017,0.0,1.0
27908,Little Baby Jesus of Flandr,2290,0,2290,2010.csv,2010,0.0,1.0
27909,Tous au Larzac,2289,0,2289,2012.csv,2012,0.0,1.0
27910,La Cena Blanca de Romina,2286,0,2286,2017.csv,2017,0.0,1.0
27911,The Red and the Blue 2015 Re-release,2284,0,2284,2015.csv,2015,0.0,1.0
27912,In Rahon Se,2277,0,2277,2016.csv,2016,0.0,1.0
27913,The Girl 2010 Re-release,2273,2201,72,2010.csv,2010,0.9683238011438627,0.03167619885613726
27914,The Panti Sisters,2272,0,2272,2019.csv,2019,0.0,1.0
27915,Malcriados,2272,0,2272,2016.csv,2016,0.0,1.0
27916,Una hermana,2270,0,2270,2018.csv,2018,0.0,1.0
27917,The Pool Boys,2269,2269,0,2011.csv,2011,1.0,0.0
27918,Eso Que Nos Enamora,2269,0,2269,2018.csv,2018,0.0,1.0
27919,Ishq My Religion,2263,0,2263,2019.csv,2019,0.0,1.0
27920,Sabaash Naidu,2261,0,2261,2017.csv,2017,0.0,1.0
27921,A Cidade é Uma Só?,2260,0,2260,2013.csv,2013,0.0,1.0
27922,Umut Avcilari,2259,0,2259,2018.csv,2018,0.0,1.0
27923,A Árvore da Discórdia,2259,0,2259,2019.csv,2019,0.0,1.0
27924,The Mother,2259,0,2259,2016.csv,2016,0.0,1.0
27925,Joaquim,2256,0,2256,2018.csv,2018,0.0,1.0
27926,Doutores Palhaços,2256,0,2256,2018.csv,2018,0.0,1.0
27927,Red Christmas,2255,2255,0,2017.csv,2017,1.0,0.0
27928,Golden Door 2010 Re-release,2253,0,2253,2010.csv,2010,0.0,1.0
27929,Udaharanam Sujatha,2252,0,2252,2017.csv,2017,0.0,1.0
27930,Mother to Earth,2250,2250,0,2021.csv,2021,1.0,0.0
27931,Anita Ho,2250,2250,0,2015.csv,2015,1.0,0.0
27932,Sousa Martins,2249,0,2249,2019.csv,2019,0.0,1.0
27933,Lobanovskiy Forever,2249,0,2249,2017.csv,2017,0.0,1.0
27934,Luz: The Flower of Evil,2248,0,2248,2020.csv,2020,0.0,1.0
27935,Treacle Jr.,2248,0,2248,2011.csv,2011,0.0,1.0
27936,Safari,2244,0,2244,2017.csv,2017,0.0,1.0
27937,Never Forever 2010 Re-release,2244,0,2244,2010.csv,2010,0.0,1.0
27938,Asleep in the Sun 2013 Re-release,2244,0,2244,2013.csv,2013,0.0,1.0
27939,Veronika Decides to Die 2012 Re-release,2243,0,2243,2012.csv,2012,0.0,1.0
27940,Memoria,2242,2242,0,2016.csv,2016,1.0,0.0
27941,"I'll Love You, Can I?",2241,0,2241,2017.csv,2017,0.0,1.0
27942,Into the Mind,2241,0,2241,2014.csv,2014,0.0,1.0
27943,NOTFILM,2241,0,2241,2016.csv,2016,0.0,1.0
27944,Vigilia,2240,0,2240,2017.csv,2017,0.0,1.0
27945,You Wont Miss Me,2240,2240,0,2010.csv,2010,1.0,0.0
27946,Cleveland Versus Wall Street,2239,0,2239,2011.csv,2011,0.0,1.0
27947,Vapor,2239,0,2239,2017.csv,2017,0.0,1.0
27948,Darvinte Parinamam,2239,0,2239,2016.csv,2016,0.0,1.0
27949,Kissing Candice,2238,0,2238,2018.csv,2018,0.0,1.0
27950,A Glitch in the Matrix,2238,2238,0,2021.csv,2021,1.0,0.0
27951,Hurt by Paradise,2238,0,2238,2020.csv,2020,0.0,1.0
27952,Molly in Springtime,2233,0,2233,2015.csv,2015,0.0,1.0
27953,Colossal Youth 2019 Re-release,2233,0,2233,2019.csv,2019,0.0,1.0
27954,Fresh Flesh,2232,0,2232,2011.csv,2011,0.0,1.0
27955,All Good Things 2014 Re-release,2232,0,2232,2014.csv,2014,0.0,1.0
27956,Cubanas. Mujeres En Revolución,2228,0,2228,2018.csv,2018,0.0,1.0
27957,Versailles 2011 Re-release,2227,0,2227,2011.csv,2011,0.0,1.0
27958,Alexander Nevsky,2226,0,2226,2016.csv,2016,0.0,1.0
27959,The Old Gun,2225,0,2225,2018.csv,2018,0.0,1.0
27960,The Vasulka Effect,2225,0,2225,2019.csv,2019,0.0,1.0
27961,La memoria de los huesos,2223,0,2223,2017.csv,2017,0.0,1.0
27962,After Everything,2222,0,2222,2018.csv,2018,0.0,1.0
27963,Bahtsiz Bedri,2221,0,2221,2019.csv,2019,0.0,1.0
27964,Fairytale of New York,2220,0,2220,2017.csv,2017,0.0,1.0
27965,The Night Watchman,2219,2219,0,2012.csv,2012,1.0,0.0
27966,Double,2218,0,2218,2016.csv,2016,0.0,1.0
27967,Don't Walk Away,2217,0,2217,2019.csv,2019,0.0,1.0
27968,Ciclo Las (casi) no estrenadas,2215,0,2215,2017.csv,2017,0.0,1.0
27969,Opera Australia: Madama Butterfly,2214,0,2214,2020.csv,2020,0.0,1.0
27970,Amando a Carolina,2213,0,2213,2018.csv,2018,0.0,1.0
27971,The Last Parties,2210,0,2210,2018.csv,2018,0.0,1.0
27972,Kingfisher,2208,0,2208,2010.csv,2010,0.0,1.0
27973,9 meses 2012 Re-release,2208,0,2208,2012.csv,2012,0.0,1.0
27974,Alias Maria,2208,0,2208,2016.csv,2016,0.0,1.0
27975,7 from Etheria,2208,2208,0,2017.csv,2017,1.0,0.0
27976,InSpectres,2207,2207,0,2013.csv,2013,1.0,0.0
27977,La Hija,2206,0,2206,2017.csv,2017,0.0,1.0
27978,Our Paradise,2206,0,2206,2012.csv,2012,0.0,1.0
27979,Scorn,2206,2206,0,2012.csv,2012,1.0,0.0
27980,Last Summer,2205,0,2205,2019.csv,2019,0.0,1.0
27981,Uncle Howard,2204,0,2204,2016.csv,2016,0.0,1.0
27982,Original Sin,2202,0,2202,2019.csv,2019,0.0,1.0
27983,Life Just Is,2200,0,2200,2012.csv,2012,0.0,1.0
27984,Nora,2198,0,2198,2018.csv,2018,0.0,1.0
27985,Family Relics,2194,0,2194,2016.csv,2016,0.0,1.0
27986,Shongram,2193,0,2193,2019.csv,2019,0.0,1.0
27987,Donkeyote 2018 Re-release,2192,0,2192,2018.csv,2018,0.0,1.0
27988,Casi inocentes,2191,0,2191,2014.csv,2014,0.0,1.0
27989,Road to Paloma,2191,0,2191,2017.csv,2017,0.0,1.0
27990,Apneia,2190,0,2190,2014.csv,2014,0.0,1.0
27991,Swapna Sanchari,2188,0,2188,2011.csv,2011,0.0,1.0
27992,Ori,2186,0,2186,2011.csv,2011,0.0,1.0
27993,Taekwondo,2186,0,2186,2016.csv,2016,0.0,1.0
27994,The Return 2012 Re-release,2181,0,2181,2012.csv,2012,0.0,1.0
27995,Varnarlioio,2179,0,2179,2017.csv,2017,0.0,1.0
27996,The Other Side of Sleep,2179,0,2179,2012.csv,2012,0.0,1.0
27997,"Heaven, Hell",2178,0,2178,2010.csv,2010,0.0,1.0
27998,Ustad Hotel,2178,0,2178,2012.csv,2012,0.0,1.0
27999,El Deseo de Domingo,2178,0,2178,2016.csv,2016,0.0,1.0
28000,National Parks Adventure,2175,0,2175,2016.csv,2016,0.0,1.0
28001,Zhauzhürek myng bala,2172,0,2172,2014.csv,2014,0.0,1.0
28002,Little Baby Jesus of Flandr 2013 Re-release,2171,0,2171,2013.csv,2013,0.0,1.0
28003,Love or Quest,2167,0,2167,2019.csv,2019,0.0,1.0
28004,Redención,2165,0,2165,2010.csv,2010,0.0,1.0
28005,"Teros, sueño mundial",2165,0,2165,2015.csv,2015,0.0,1.0
28006,A Woman Without Love,2163,0,2163,2019.csv,2019,0.0,1.0
28007,Maryam of Tsyon - Cap I Escape to Ephesus,2162,0,2162,2019.csv,2019,0.0,1.0
28008,North by Northwest 2020 Re-release,2161,0,2161,2020.csv,2020,0.0,1.0
28009,Oray,2161,0,2161,2019.csv,2019,0.0,1.0
28010,All That I Love 2012 Re-release,2160,0,2160,2012.csv,2012,0.0,1.0
28011,The Great Sardaar,2160,0,2160,2017.csv,2017,0.0,1.0
28012,Putin's Witnesses,2157,0,2157,2019.csv,2019,0.0,1.0
28013,"Us, Them and Me",2157,0,2157,2016.csv,2016,0.0,1.0
28014,Cellar Door,2156,0,2156,2019.csv,2019,0.0,1.0
28015,Barney's Version 2014 Re-release,2156,0,2156,2014.csv,2014,0.0,1.0
28016,Happy Birthday,2156,0,2156,2018.csv,2018,0.0,1.0
28017,Four Hands,2155,0,2155,2019.csv,2019,0.0,1.0
28018,The Voice,2154,0,2154,2020.csv,2020,0.0,1.0
28019,Wood Eyes,2154,0,2154,2017.csv,2017,0.0,1.0
28020,A Yellow Animal,2154,0,2154,2020.csv,2020,0.0,1.0
28021,Ballast 2011 Re-release,2154,0,2154,2011.csv,2011,0.0,1.0
28022,The Other Boleyn Girl 2012 Re-release,2151,0,2151,2012.csv,2012,0.0,1.0
28023,"7, 8, 9, Boniface 2015 Re-release",2149,0,2149,2015.csv,2015,0.0,1.0
28024,Passion Island,2147,0,2147,2012.csv,2012,0.0,1.0
28025,The Little Man,2147,0,2147,2015.csv,2015,0.0,1.0
28026,Pawno,2142,0,2142,2016.csv,2016,0.0,1.0
28027,Yo sé lo que envenena,2142,0,2142,2017.csv,2017,0.0,1.0
28028,My Sexual Life,2138,0,2138,2011.csv,2011,0.0,1.0
28029,My Magic 2011 Re-release,2136,0,2136,2011.csv,2011,0.0,1.0
28030,Il Sogno Mio d'Amore,2134,0,2134,2019.csv,2019,0.0,1.0
28031,Georgetown,2132,0,2132,2020.csv,2020,0.0,1.0
28032,Icarus XB 1,2130,0,2130,2016.csv,2016,0.0,1.0
28033,Helicopters,2130,0,2130,2019.csv,2019,0.0,1.0
28034,Ricky 2014 Re-release,2129,0,2129,2014.csv,2014,0.0,1.0
28035,Ghost in the Shell: Stand Alone Complex - Solid State Society 2012 Re-release,2127,0,2127,2012.csv,2012,0.0,1.0
28036,NoBody's Perfect 2010 Re-release,2122,2122,0,2010.csv,2010,1.0,0.0
28037,Missionary,2120,2120,0,2014.csv,2014,1.0,0.0
28038,Soft Rains Will Come,2119,0,2119,2018.csv,2018,0.0,1.0
28039,Ne Olur Gitme,2119,0,2119,2019.csv,2019,0.0,1.0
28040,Justo en lo mejor de mi vida,2117,0,2117,2016.csv,2016,0.0,1.0
28041,Stay Still,2117,0,2117,2020.csv,2020,0.0,1.0
28042,Conversazioni atomiche,2116,0,2116,2018.csv,2018,0.0,1.0
28043,Poveda 2018 Re-release,2116,0,2116,2018.csv,2018,0.0,1.0
28044,La inocencia,2115,0,2115,2016.csv,2016,0.0,1.0
28045,Halal police d'État 2012 Re-release,2115,0,2115,2012.csv,2012,0.0,1.0
28046,Perseverance,2114,0,2114,2018.csv,2018,0.0,1.0
28047,Os dias com ele,2114,0,2114,2014.csv,2014,0.0,1.0
28048,Last Hijack,2113,0,2113,2016.csv,2016,0.0,1.0
28049,Hatchet Hour,2112,0,2112,2016.csv,2016,0.0,1.0
28050,Love Island,2110,0,2110,2015.csv,2015,0.0,1.0
28051,What Nobody Can See,2109,0,2109,2019.csv,2019,0.0,1.0
28052,Cat in the Wall,2108,0,2108,2020.csv,2020,0.0,1.0
28053,Secrets from the Past,2108,0,2108,2017.csv,2017,0.0,1.0
28054,Me You and Five Bucks,2105,2105,0,2015.csv,2015,1.0,0.0
28055,Jihadists,2104,2104,0,2019.csv,2019,1.0,0.0
28056,Trash on Mars,2103,0,2103,2018.csv,2018,0.0,1.0
28057,Astro: An Urban Fable in a Magical Rio de Janeiro,2099,0,2099,2012.csv,2012,0.0,1.0
28058,Carturan,2099,0,2099,2019.csv,2019,0.0,1.0
28059,Nagan,2097,0,2097,2016.csv,2016,0.0,1.0
28060,"O Cinema, Manoel de Oliveira e Eu",2095,0,2095,2016.csv,2016,0.0,1.0
28061,Captive,2089,0,2089,2013.csv,2013,0.0,1.0
28062,El abismo... todavía estamos,2089,0,2089,2011.csv,2011,0.0,1.0
28063,Samanchan,2088,0,2088,2010.csv,2010,0.0,1.0
28064,Sunbeat,2087,0,2087,2018.csv,2018,0.0,1.0
28065,20 anni,2087,0,2087,2012.csv,2012,0.0,1.0
28066,Cordelia,2085,0,2085,2020.csv,2020,0.0,1.0
28067,A Skjon (Askew) - Verk Og Dagar Magnusar Palssonar,2085,0,2085,2019.csv,2019,0.0,1.0
28068,Dead Europe,2084,0,2084,2012.csv,2012,0.0,1.0
28069,91.1,2081,0,2081,2016.csv,2016,0.0,1.0
28070,Red Cliff 2011 Re-release,2081,0,2081,2011.csv,2011,0.0,1.0
28071,Clown Motel: Spirits Arise,2080,0,2080,2019.csv,2019,0.0,1.0
28072,Dayveon,2077,2077,0,2017.csv,2017,1.0,0.0
28073,Kings' Shift,2077,0,2077,2016.csv,2016,0.0,1.0
28074,Rubberneck,2075,2075,0,2013.csv,2013,1.0,0.0
28075,Red Flag,2075,2075,0,2013.csv,2013,1.0,0.0
28076,Yancho Mikeulrosyu Exhibition,2074,0,2074,2010.csv,2010,0.0,1.0
28077,Sadak 2,2073,0,2073,2020.csv,2020,0.0,1.0
28078,The Evil Dead 2018 Re-release,2073,0,2073,2018.csv,2018,0.0,1.0
28079,Quick Gun Murugun: Misadventures of an Indian Cowboy,2070,0,2070,2010.csv,2010,0.0,1.0
28080,Patagonia Rising,2064,2064,0,2012.csv,2012,1.0,0.0
28081,Primero enero,2064,0,2064,2017.csv,2017,0.0,1.0
28082,The Fake,2060,0,2060,2014.csv,2014,0.0,1.0
28083,Papatya,2057,0,2057,2017.csv,2017,0.0,1.0
28084,Frankenstein V2,2056,0,2056,2012.csv,2012,0.0,1.0
28085,Ishq Garaari,2055,0,2055,2013.csv,2013,0.0,1.0
28086,That Obscure Object of Desire 2020 Re-release,2055,0,2055,2020.csv,2020,0.0,1.0
28087,Arirang,2055,0,2055,2012.csv,2012,0.0,1.0
28088,A Pain in the Ass 2010 Re-release,2053,0,2053,2010.csv,2010,0.0,1.0
28089,The Killer Inside Me 2012 Re-release,2051,0,2051,2012.csv,2012,0.0,1.0
28090,Sequìa,2051,0,2051,2018.csv,2018,0.0,1.0
28091,Bottom of the 9th,2049,0,2049,2019.csv,2019,0.0,1.0
28092,Sin Mañana,2047,0,2047,2019.csv,2019,0.0,1.0
28093,An Unfinished Piece for Mechanical Piano,2047,0,2047,2016.csv,2016,0.0,1.0
28094,Panda Days 2011 Re-release,2046,0,2046,2011.csv,2011,0.0,1.0
28095,The Shawshank Redemption 2020 Re-release,2046,0,2046,2020.csv,2020,0.0,1.0
28096,Horizon,2045,0,2045,2015.csv,2015,0.0,1.0
28097,Blockbuster,2044,0,2044,2014.csv,2014,0.0,1.0
28098,Nearest and Dearest,2043,0,2043,2017.csv,2017,0.0,1.0
28099,Blanka,2042,0,2042,2016.csv,2016,0.0,1.0
28100,The Transcendents,2041,2041,0,2020.csv,2020,1.0,0.0
28101,Goat,2038,0,2038,2015.csv,2015,0.0,1.0
28102,In Touch,2037,0,2037,2019.csv,2019,0.0,1.0
28103,Gul Makai,2035,0,2035,2020.csv,2020,0.0,1.0
28104,Blindness,2035,0,2035,2017.csv,2017,0.0,1.0
28105,Amar es bendito,2033,0,2033,2014.csv,2014,0.0,1.0
28106,John From,2031,0,2031,2016.csv,2016,0.0,1.0
28107,Monty Python and the Holy Grail 2020 Re-release,2029,0,2029,2020.csv,2020,0.0,1.0
28108,O Homem-Pykante - Diálogos kom Pimenta,2028,0,2028,2019.csv,2019,0.0,1.0
28109,Route Irish 2018 Re-release,2026,0,2026,2018.csv,2018,0.0,1.0
28110,Ot,2026,0,2026,2016.csv,2016,0.0,1.0
28111,Nana 2013 Re-release,2024,0,2024,2013.csv,2013,0.0,1.0
28112,Cyrano de Bergerac 2018 Re-release,2021,0,2021,2018.csv,2018,0.0,1.0
28113,Algorithms,2021,2021,0,2014.csv,2014,1.0,0.0
28114,Una mujer,2021,0,2021,2017.csv,2017,0.0,1.0
28115,Relationology,2020,0,2020,2020.csv,2020,0.0,1.0
28116,Golmaal: Fun Unlimited 2017 Re-release,2020,0,2020,2017.csv,2017,0.0,1.0
28117,"Arpeggio of the Blue Steel: Ars Nova, DC Movie 2",2020,0,2020,2016.csv,2016,0.0,1.0
28118,Escuela normal,2018,0,2018,2013.csv,2013,0.0,1.0
28119,When Sun Meets Moon 2019 Re-release,2017,0,2017,2019.csv,2019,0.0,1.0
28120,Upside Down: The Creation Records Story,2017,0,2017,2011.csv,2011,0.0,1.0
28121,Lázaro,2016,0,2016,2020.csv,2020,0.0,1.0
28122,Island Songs,2016,0,2016,2017.csv,2017,0.0,1.0
28123,Hadi ya!,2011,0,2011,2018.csv,2018,0.0,1.0
28124,Day Release,2009,0,2009,2015.csv,2015,0.0,1.0
28125,Francesca,2008,0,2008,2017.csv,2017,0.0,1.0
28126,Göç Yolu (Elveda Balkanlar),2007,0,2007,2018.csv,2018,0.0,1.0
28127,Enter the Dragon 2020 Re-release,2003,0,2003,2020.csv,2020,0.0,1.0
28128,Split: A Deeper Divide,2000,2000,0,2012.csv,2012,1.0,0.0
28129,Raídos,1999,0,1999,2017.csv,2017,0.0,1.0
28130,Sea of Shadows,1996,0,1996,2019.csv,2019,0.0,1.0
28131,Historias de Dhallywood,1995,0,1995,2011.csv,2011,0.0,1.0
28132,The Horseman,1993,0,1993,2010.csv,2010,0.0,1.0
28133,Hollow,1991,0,1991,2015.csv,2015,0.0,1.0
28134,3 vakte kadar,1990,0,1990,2018.csv,2018,0.0,1.0
28135,The Hurt Business,1990,0,1990,2016.csv,2016,0.0,1.0
28136,The Watermelon Woman,1989,1989,0,2016.csv,2016,1.0,0.0
28137,Enclave,1985,0,1985,2016.csv,2016,0.0,1.0
28138,Contra Paraguay,1985,0,1985,2016.csv,2016,0.0,1.0
28139,The World's End 2020 Re-release,1984,0,1984,2020.csv,2020,0.0,1.0
28140,Errors of the Human Body,1984,0,1984,2013.csv,2013,0.0,1.0
28141,Reus 2012 Re-release,1983,0,1983,2012.csv,2012,0.0,1.0
28142,Monger,1980,0,1980,2017.csv,2017,0.0,1.0
28143,Falling Awake,1978,1978,0,2010.csv,2010,1.0,0.0
28144,Avenida Almirante Reis em 3 andamentos,1972,0,1972,2019.csv,2019,0.0,1.0
28145,The Wolf House,1970,0,1970,2019.csv,2019,0.0,1.0
28146,Lejos de Pekín,1969,0,1969,2019.csv,2019,0.0,1.0
28147,The Exam,1968,0,1968,2014.csv,2014,0.0,1.0
28148,Rock Kid,1968,0,1968,2018.csv,2018,0.0,1.0
28149,Sul vulcano,1965,0,1965,2016.csv,2016,0.0,1.0
28150,Tormentero,1964,0,1964,2019.csv,2019,0.0,1.0
28151,"Idrissa, Chronicle of an Ordinary Death",1964,0,1964,2019.csv,2019,0.0,1.0
28152,The Temptation of St. Tony,1963,1963,0,2010.csv,2010,1.0,0.0
28153,Los sentidos,1962,0,1962,2017.csv,2017,0.0,1.0
28154,My Talk with Florence,1961,0,1961,2016.csv,2016,0.0,1.0
28155,Serie B,1959,0,1959,2013.csv,2013,0.0,1.0
28156,Two Brothers 2010 Re-release,1958,0,1958,2010.csv,2010,0.0,1.0
28157,Lisbon Revisited,1951,0,1951,2016.csv,2016,0.0,1.0
28158,Uncle Vanya,1950,0,1950,2016.csv,2016,0.0,1.0
28159,ärtico,1949,0,1949,2014.csv,2014,0.0,1.0
28160,The Assassin Next Door,1948,0,1948,2010.csv,2010,0.0,1.0
28161,Il solengo,1946,0,1946,2016.csv,2016,0.0,1.0
28162,Position Among the Stars,1946,0,1946,2012.csv,2012,0.0,1.0
28163,El cielo escondido,1944,0,1944,2016.csv,2016,0.0,1.0
28164,Visaaranai,1943,0,1943,2016.csv,2016,0.0,1.0
28165,Sem pyanits,1943,0,1943,2019.csv,2019,0.0,1.0
28166,Correspondences,1942,0,1942,2018.csv,2018,0.0,1.0
28167,Clustered Colours,1942,0,1942,2019.csv,2019,0.0,1.0
28168,"Accidental Courtesy: Daryl Davis, Race & America",1940,1940,0,2017.csv,2017,1.0,0.0
28169,The Luring,1939,0,1939,2019.csv,2019,0.0,1.0
28170,Best Man Down,1938,1938,0,2013.csv,2013,1.0,0.0
28171,Snowman's Land 2014 Re-release,1938,0,1938,2014.csv,2014,0.0,1.0
28172,What We Do in the Shadows 2020 Re-release,1934,0,1934,2020.csv,2020,0.0,1.0
28173,Space Chimps 2: Zartog Strikes Back 2012 Re-release,1931,0,1931,2012.csv,2012,0.0,1.0
28174,Schubert und Ich,1927,0,1927,2014.csv,2014,0.0,1.0
28175,One Breath 2017 Re-release,1926,0,1926,2017.csv,2017,0.0,1.0
28176,West Of The Jordan River,1926,1926,0,2018.csv,2018,1.0,0.0
28177,The Reports on Sarah and Saleem 2020 Re-release,1925,0,1925,2020.csv,2020,0.0,1.0
28178,My Mummy is in America and She Met Buffalo Bill,1922,0,1922,2014.csv,2014,0.0,1.0
28179,Another Sky,1919,0,1919,2010.csv,2010,0.0,1.0
28180,I've Loved You So Long 2011 Re-release,1919,0,1919,2011.csv,2011,0.0,1.0
28181,Siete instantes,1917,0,1917,2010.csv,2010,0.0,1.0
28182,Memleket,1917,0,1917,2016.csv,2016,0.0,1.0
28183,A Mother's Courage: Talking Back to Autism 2010 Re-release,1916,1916,0,2010.csv,2010,1.0,0.0
28184,Ekk Albela,1915,0,1915,2016.csv,2016,0.0,1.0
28185,In the Same Boat,1914,0,1914,2016.csv,2016,0.0,1.0
28186,The Foundation of Criminal Excellence,1912,0,1912,2019.csv,2019,0.0,1.0
28187,Mitti: Virasat Babbaran Di,1911,0,1911,2019.csv,2019,0.0,1.0
28188,Fragments of Kubelka,1908,0,1908,2013.csv,2013,0.0,1.0
28189,Gósenlandio (The Bountiful Land),1906,0,1906,2019.csv,2019,0.0,1.0
28190,Compenetrados,1905,0,1905,2017.csv,2017,0.0,1.0
28191,Sneakerheadz,1903,1903,0,2015.csv,2015,1.0,0.0
28192,We Are Not Animals,1902,0,1902,2017.csv,2017,0.0,1.0
28193,Il Professore,1899,0,1899,2012.csv,2012,0.0,1.0
28194,Tales from the Rabbit Hole: A Curious Kitsch Novel,1899,0,1899,2020.csv,2020,0.0,1.0
28195,Veneno,1897,0,1897,2018.csv,2018,0.0,1.0
28196,Visa/Vie,1894,0,1894,2011.csv,2011,0.0,1.0
28197,Calzones Rotos,1893,0,1893,2018.csv,2018,0.0,1.0
28198,Where I Grow Old,1892,0,1892,2020.csv,2020,0.0,1.0
28199,Kao Krian,1891,0,1891,2012.csv,2012,0.0,1.0
28200,The Visitor,1890,0,1890,2016.csv,2016,0.0,1.0
28201,Home in the Ice,1889,0,1889,2017.csv,2017,0.0,1.0
28202,War,1887,0,1887,2016.csv,2016,0.0,1.0
28203,Payback,1887,0,1887,2013.csv,2013,0.0,1.0
28204,Cleo from 5 to 7,1886,0,1886,2018.csv,2018,0.0,1.0
28205,Touch of Evil 2010 Re-release,1884,0,1884,2010.csv,2010,0.0,1.0
28206,Bepo,1882,0,1882,2017.csv,2017,0.0,1.0
28207,La muerte no duele,1882,0,1882,2017.csv,2017,0.0,1.0
28208,Zack and Miri Make a Porno 2012 Re-release,1881,0,1881,2012.csv,2012,0.0,1.0
28209,RSC Live: Henry V,1880,0,1880,2015.csv,2015,0.0,1.0
28210,The Recount of the Damages,1880,0,1880,2010.csv,2010,0.0,1.0
28211,¡Yallah! ¡Yallah!,1880,0,1880,2018.csv,2018,0.0,1.0
28212,Queen to Play 2013 Re-release,1879,0,1879,2013.csv,2013,0.0,1.0
28213,Trivandrum Lodge,1877,0,1877,2012.csv,2012,0.0,1.0
28214,Vía crucis,1877,0,1877,2018.csv,2018,0.0,1.0
28215,Mother and Daughter,1876,0,1876,2012.csv,2012,0.0,1.0
28216,Home for Christmas 2011 Re-release,1875,0,1875,2011.csv,2011,0.0,1.0
28217,In the Dark Half,1873,0,1873,2012.csv,2012,0.0,1.0
28218,We Were Here,1873,0,1873,2011.csv,2011,0.0,1.0
28219,Línea de cuatro,1873,0,1873,2017.csv,2017,0.0,1.0
28220,Sesión 1.16,1872,0,1872,2012.csv,2012,0.0,1.0
28221,Kasap havasi,1870,0,1870,2016.csv,2016,0.0,1.0
28222,Tempting Devils,1869,0,1869,2018.csv,2018,0.0,1.0
28223,The Outsider,1869,0,1869,2018.csv,2018,0.0,1.0
28224,Opus Zero,1869,0,1869,2019.csv,2019,0.0,1.0
28225,The Gift 2019 Re-release,1868,0,1868,2019.csv,2019,0.0,1.0
28226,"Hetalia: Axis Powers - Paint It, White! 2018 Re-release",1866,0,1866,2018.csv,2018,0.0,1.0
28227,Kill Keith,1866,0,1866,2011.csv,2011,0.0,1.0
28228,Hungry Bear Tales,1865,0,1865,2020.csv,2020,0.0,1.0
28229,Jojo's Magic,1863,0,1863,2017.csv,2017,0.0,1.0
28230,The Moving Creatures,1863,0,1863,2013.csv,2013,0.0,1.0
28231,Invasion of the Body Snatchers,1861,0,1861,2016.csv,2016,0.0,1.0
28232,Anchors Up: Boat to the Rescue 2019 Re-release,1860,0,1860,2019.csv,2019,0.0,1.0
28233,Abalos: Una Historia de 5 Hermanos,1858,0,1858,2017.csv,2017,0.0,1.0
28234,A Walker in Darkness,1858,0,1858,2019.csv,2019,0.0,1.0
28235,My Father's Menu,1858,0,1858,2013.csv,2013,0.0,1.0
28236,Case: Osterberg,1856,0,1856,2016.csv,2016,0.0,1.0
28237,Noum Talat,1854,0,1854,2015.csv,2015,0.0,1.0
28238,Sagrado Segredo,1852,0,1852,2012.csv,2012,0.0,1.0
28239,"Fontana, the Interior Frontier",1851,0,1851,2011.csv,2011,0.0,1.0
28240,United Nation Three Decades of Drum & Bass,1851,0,1851,2020.csv,2020,0.0,1.0
28241,Testament of Orpheus,1850,0,1850,2018.csv,2018,0.0,1.0
28242,Murder Sisters,1850,0,1850,2011.csv,2011,0.0,1.0
28243,Ptitsa,1849,0,1849,2016.csv,2016,0.0,1.0
28244,The Violators,1848,0,1848,2016.csv,2016,0.0,1.0
28245,Bloom,1847,0,1847,2012.csv,2012,0.0,1.0
28246,The Occupant,1845,0,1845,2019.csv,2019,0.0,1.0
28247,Blindrahundur,1842,0,1842,2017.csv,2017,0.0,1.0
28248,Finding Happiness,1841,1841,0,2018.csv,2018,1.0,0.0
28249,Vergara,1841,0,1841,2018.csv,2018,0.0,1.0
28250,Rita and Li,1838,0,1838,2011.csv,2011,0.0,1.0
28251,Cuatreros,1835,0,1835,2017.csv,2017,0.0,1.0
28252,Onna Ga Nemurutoki 2017 Re-release,1834,0,1834,2017.csv,2017,0.0,1.0
28253,Home,1833,0,1833,2019.csv,2019,0.0,1.0
28254,Bing's Christmas & Other Stories,1831,0,1831,2020.csv,2020,0.0,1.0
28255,Felicitas 2010 Re-release,1829,0,1829,2010.csv,2010,0.0,1.0
28256,Dilettante,1828,0,1828,2010.csv,2010,0.0,1.0
28257,Blockers 2020 Re-release,1826,0,1826,2020.csv,2020,0.0,1.0
28258,"Silvered Water, Syria Self-Portrait",1825,0,1825,2015.csv,2015,0.0,1.0
28259,Avant 2016 Re-release,1821,0,1821,2016.csv,2016,0.0,1.0
28260,Bald Mountain,1820,0,1820,2013.csv,2013,0.0,1.0
28261,Inside America,1819,0,1819,2011.csv,2011,0.0,1.0
28262,Jimi Hendrix Electric Church,1818,0,1818,2019.csv,2019,0.0,1.0
28263,From Afar 2018 Re-release,1813,0,1813,2018.csv,2018,0.0,1.0
28264,Kanimambo,1812,0,1812,2013.csv,2013,0.0,1.0
28265,A Tale of Ululu's Wonderful Forest 2011 Re-release,1812,0,1812,2011.csv,2011,0.0,1.0
28266,Dursun Çavus,1810,0,1810,2014.csv,2014,0.0,1.0
28267,Now & Later,1808,1808,0,2011.csv,2011,1.0,0.0
28268,Love Me Not,1808,0,1808,2019.csv,2019,0.0,1.0
28269,Mr. Nobody 2012 Re-release,1807,0,1807,2012.csv,2012,0.0,1.0
28270,Bridget Jones's Diary 2020 Re-release,1806,0,1806,2020.csv,2020,0.0,1.0
28271,The Wind Comes Up From the Plateau,1804,0,1804,2019.csv,2019,0.0,1.0
28272,My Name Is Now,1803,0,1803,2019.csv,2019,0.0,1.0
28273,Blue Pleated Skirt,1801,0,1801,2019.csv,2019,0.0,1.0
28274,Caisa,1800,0,1800,2019.csv,2019,0.0,1.0
28275,Modern Times 2016 Re-release,1799,0,1799,2016.csv,2016,0.0,1.0
28276,MSG the Warrior: Lion Heart,1798,0,1798,2016.csv,2016,0.0,1.0
28277,Cape No. 7 2010 Re-release,1796,0,1796,2010.csv,2010,0.0,1.0
28278,I Kissed a Vampire,1794,1794,0,2012.csv,2012,1.0,0.0
28279,Detour,1788,1788,0,2017.csv,2017,1.0,0.0
28280,Parêdo,1788,0,1788,2010.csv,2010,0.0,1.0
28281,03.ByPass,1783,0,1783,2016.csv,2016,0.0,1.0
28282,Not Without Us,1783,0,1783,2018.csv,2018,0.0,1.0
28283,Age of Panic,1782,0,1782,2013.csv,2013,0.0,1.0
28284,"Never Steady, Never Still",1782,0,1782,2018.csv,2018,0.0,1.0
28285,Guest of Honour,1780,0,1780,2020.csv,2020,0.0,1.0
28286,The Lost Village,1780,1780,0,2018.csv,2018,1.0,0.0
28287,Detention of the Dead,1777,1777,0,2013.csv,2013,1.0,0.0
28288,Seasons 2018 Re-release,1775,0,1775,2018.csv,2018,0.0,1.0
28289,Love Live! Sunshine!! Hakodate Unit Carnival,1772,0,1772,2018.csv,2018,0.0,1.0
28290,Speed Is My Need,1769,0,1769,2019.csv,2019,0.0,1.0
28291,Grandes ondes 2015 Re-release,1767,0,1767,2015.csv,2015,0.0,1.0
28292,Volt egyszer egy téka,1766,0,1766,2018.csv,2018,0.0,1.0
28293,Parapolicial Negro: Apuntes para una prehistoria de la triple A,1760,0,1760,2012.csv,2012,0.0,1.0
28294,L'Ours Et Le Magicien,1758,0,1758,2010.csv,2010,0.0,1.0
28295,The ABCs of Death 2014 Re-release,1757,0,1757,2014.csv,2014,0.0,1.0
28296,Eralash,1756,0,1756,2016.csv,2016,0.0,1.0
28297,Rouge Brésil,1756,0,1756,2014.csv,2014,0.0,1.0
28298,Big Is Beautiful 2013 Re-release,1756,0,1756,2013.csv,2013,0.0,1.0
28299,Hotel Milan,1755,0,1755,2018.csv,2018,0.0,1.0
28300,Mr. Zhai,1755,0,1755,2011.csv,2011,0.0,1.0
28301,Eden,1755,0,1755,2021.csv,2021,0.0,1.0
28302,Where I Belong 2015 Re-release,1755,0,1755,2015.csv,2015,0.0,1.0
28303,The Demons,1755,0,1755,2017.csv,2017,0.0,1.0
28304,Siberiade,1753,0,1753,2016.csv,2016,0.0,1.0
28305,Butch Cassidy and the Sundance Kid 2018 Re-release,1750,0,1750,2018.csv,2018,0.0,1.0
28306,Historias de nuestro cine,1749,0,1749,2019.csv,2019,0.0,1.0
28307,Illet,1747,0,1747,2016.csv,2016,0.0,1.0
28308,Horse Money 2016 Re-release,1747,0,1747,2016.csv,2016,0.0,1.0
28309,Panic Attack!,1747,0,1747,2017.csv,2017,0.0,1.0
28310,The Other Man: F.W. de Klerk and the End of Apartheid,1747,1747,0,2015.csv,2015,1.0,0.0
28311,El (im)posible olvido,1746,0,1746,2016.csv,2016,0.0,1.0
28312,False Trail 2012 Re-release,1745,0,1745,2012.csv,2012,0.0,1.0
28313,Noites de Reis,1744,0,1744,2013.csv,2013,0.0,1.0
28314,Through the Fire 2020 Re-release,1741,0,1741,2020.csv,2020,0.0,1.0
28315,Dark Forest,1739,1739,0,2015.csv,2015,1.0,0.0
28316,Sweetgrass 2011 Re-release,1731,0,1731,2011.csv,2011,0.0,1.0
28317,Deer Wars,1730,0,1730,2020.csv,2020,0.0,1.0
28318,Olmedo: El rey de la risa,1730,0,1730,2019.csv,2019,0.0,1.0
28319,Breathless 2020 Re-release,1725,0,1725,2020.csv,2020,0.0,1.0
28320,The Omission,1724,0,1724,2018.csv,2018,0.0,1.0
28321,Johnny English Strikes Again 2020 Re-release,1723,0,1723,2020.csv,2020,0.0,1.0
28322,Tigre,1722,0,1722,2017.csv,2017,0.0,1.0
28323,Flatland,1720,0,1720,2020.csv,2020,0.0,1.0
28324,You Don't Need Feet to Dance,1719,1719,0,2013.csv,2013,1.0,0.0
28325,Moonwalkers 2017 Re-release,1719,0,1719,2017.csv,2017,0.0,1.0
28326,Magnetick Pathways,1717,0,1717,2019.csv,2019,0.0,1.0
28327,Eldorado XXI,1716,0,1716,2017.csv,2017,0.0,1.0
28328,A Beautiful Now,1714,1714,0,2016.csv,2016,1.0,0.0
28329,Mr Gay Syria,1713,0,1713,2018.csv,2018,0.0,1.0
28330,Bloody Fox,1713,0,1713,2010.csv,2010,0.0,1.0
28331,Sharkwater Extinction,1712,0,1712,2019.csv,2019,0.0,1.0
28332,Katre,1712,0,1712,2017.csv,2017,0.0,1.0
28333,The Looking Glass,1711,1711,0,2015.csv,2015,1.0,0.0
28334,Jawan of Vellimala,1710,0,1710,2012.csv,2012,0.0,1.0
28335,Kondo no nichiyôbi ni,1709,0,1709,2010.csv,2010,0.0,1.0
28336,Dystopia: 2013,1708,1708,0,2012.csv,2012,1.0,0.0
28337,The Leopard 2010 Re-release,1706,0,1706,2010.csv,2010,0.0,1.0
28338,Withered Green,1705,0,1705,2017.csv,2017,0.0,1.0
28339,Ciudad Oculta,1704,0,1704,2011.csv,2011,0.0,1.0
28340,Docile Bodies,1704,0,1704,2016.csv,2016,0.0,1.0
28341,Mission in 7 Days,1703,0,1703,2019.csv,2019,0.0,1.0
28342,Family Business,1703,0,1703,2016.csv,2016,0.0,1.0
28343,Rehenes,1702,0,1702,2010.csv,2010,0.0,1.0
28344,Carlos Jauregui: The Unforgettable Fag,1702,0,1702,2017.csv,2017,0.0,1.0
28345,Kariyer,1702,0,1702,2015.csv,2015,0.0,1.0
28346,Brothers,1701,0,1701,2018.csv,2018,0.0,1.0
28347,La Fontaine fait son cinéma,1701,0,1701,2017.csv,2017,0.0,1.0
28348,Iceberg,1701,0,1701,2012.csv,2012,0.0,1.0
28349,35 Shots of Rum 2012 Re-release,1698,0,1698,2012.csv,2012,0.0,1.0
28350,El rocio,1698,0,1698,2019.csv,2019,0.0,1.0
28351,Wagah,1693,0,1693,2016.csv,2016,0.0,1.0
28352,Coco 2020 Re-release,1692,0,1692,2017.csv,2017,0.0,1.0
28353,Infierno grande,1690,0,1690,2019.csv,2019,0.0,1.0
28354,An Affair to Remember 2020 Re-release,1689,0,1689,2020.csv,2020,0.0,1.0
28355,Eyes Without a Face 2018 Re-release,1689,0,1689,2018.csv,2018,0.0,1.0
28356,Gajalu,1686,0,1686,2016.csv,2016,0.0,1.0
28357,Cara sucia,1685,0,1685,2019.csv,2019,0.0,1.0
28358,Ya schastliv,1684,0,1684,2018.csv,2018,0.0,1.0
28359,5 Minutes Too Late,1683,0,1683,2020.csv,2020,0.0,1.0
28360,La lapidation de Saint Étienne,1682,0,1682,2013.csv,2013,0.0,1.0
28361,Animal Kingdom 2013 Re-release,1681,0,1681,2013.csv,2013,0.0,1.0
28362,Forbidden,1680,0,1680,2017.csv,2017,0.0,1.0
28363,Cantoras do Brasil: Gaby Amarantos Canta Clementina De Jesus,1679,0,1679,2012.csv,2012,0.0,1.0
28364,Sharknado 3: Oh Hell No!,1677,0,1677,2015.csv,2015,0.0,1.0
28365,More Than the Rainbow,1677,1677,0,2014.csv,2014,1.0,0.0
28366,Love Me Once Again,1675,0,1675,2010.csv,2010,0.0,1.0
28367,"Lula, the Son of Brazil 2018 Re-release",1674,0,1674,2018.csv,2018,0.0,1.0
28368,Jora 10 Numbaria,1673,0,1673,2017.csv,2017,0.0,1.0
28369,Scruff En Halloween,1670,0,1670,2011.csv,2011,0.0,1.0
28370,Zavera,1670,0,1670,2019.csv,2019,0.0,1.0
28371,The Gold Bug,1669,0,1669,2014.csv,2014,0.0,1.0
28372,Bullying 2012 Re-release,1666,0,1666,2012.csv,2012,0.0,1.0
28373,Résiste - Aufstand der Praktikanten,1666,0,1666,2011.csv,2011,0.0,1.0
28374,Agoraphobia,1665,0,1665,2015.csv,2015,0.0,1.0
28375,Darkness,1665,0,1665,2020.csv,2020,0.0,1.0
28376,Hunters,1664,0,1664,2016.csv,2016,0.0,1.0
28377,Jungle Fish 2,1664,0,1664,2011.csv,2011,0.0,1.0
28378,Mi Mamá Lora,1661,0,1661,2017.csv,2017,0.0,1.0
28379,Cumbia callera 2010 Re-release,1661,0,1661,2010.csv,2010,0.0,1.0
28380,Guido Models,1660,0,1660,2016.csv,2016,0.0,1.0
28381,Emigrant Blues: a Road Movie in 2 1/2 Chapters,1659,0,1659,2019.csv,2019,0.0,1.0
28382,Psí láska,1657,0,1657,2020.csv,2020,0.0,1.0
28383,Rotas,1656,0,1656,2016.csv,2016,0.0,1.0
28384,"Ivan the Terrible, Part II",1655,0,1655,2016.csv,2016,0.0,1.0
28385,They're Out of the Business,1655,1655,0,2011.csv,2011,1.0,0.0
28386,Bad Movie: The Movie,1655,0,1655,2017.csv,2017,0.0,1.0
28387,Zum dritten Pol,1650,0,1650,2010.csv,2010,0.0,1.0
28388,Anna's Life,1649,0,1649,2017.csv,2017,0.0,1.0
28389,Days of Darkness 2010 Re-release,1647,0,1647,2010.csv,2010,0.0,1.0
28390,FATTORUSO,1647,0,1647,2017.csv,2017,0.0,1.0
28391,Son & Moon: diario de un astronauta,1645,0,1645,2010.csv,2010,0.0,1.0
28392,Lost in Karastan,1641,0,1641,2016.csv,2016,0.0,1.0
28393,Meu Nome é Jacque,1640,0,1640,2016.csv,2016,0.0,1.0
28394,Te pido un taxi,1640,0,1640,2019.csv,2019,0.0,1.0
28395,Kung Fu Panda 2015 Re-release,1637,0,1637,2015.csv,2015,0.0,1.0
28396,Dharala Prabhu,1636,0,1636,2020.csv,2020,0.0,1.0
28397,Margen de error,1636,0,1636,2019.csv,2019,0.0,1.0
28398,The Prisoner of Sakura,1635,0,1635,2020.csv,2020,0.0,1.0
28399,Niòato,1634,0,1634,2017.csv,2017,0.0,1.0
28400,La Casa del Eco,1632,0,1632,2018.csv,2018,0.0,1.0
28401,Drown,1631,1631,0,2015.csv,2015,1.0,0.0
28402,Rosa & Dara a jejich dobrodruzství,1629,0,1629,2015.csv,2015,0.0,1.0
28403,Frankenstein 2020 Re-release,1626,0,1626,2020.csv,2020,0.0,1.0
28404,Cut Snake,1625,1625,0,2015.csv,2015,1.0,0.0
28405,Passenger Side,1625,0,1625,2011.csv,2011,0.0,1.0
28406,The Dark Sea 2010 Re-release,1624,0,1624,2010.csv,2010,0.0,1.0
28407,Game Day,1624,1624,0,2019.csv,2019,1.0,0.0
28408,Familia Blondina,1624,0,1624,2019.csv,2019,0.0,1.0
28409,Mute Fire,1623,0,1623,2020.csv,2020,0.0,1.0
28410,Kirikou and the Wild Beasts,1623,0,1623,2010.csv,2010,0.0,1.0
28411,Svarta Gengio,1622,0,1622,2016.csv,2016,0.0,1.0
28412,Future My Love,1621,0,1621,2013.csv,2013,0.0,1.0
28413,Dreaming the Quiet Man,1621,0,1621,2012.csv,2012,0.0,1.0
28414,The Most Important Thing in Life Is Not Being Dead,1619,0,1619,2011.csv,2011,0.0,1.0
28415,The Task,1619,0,1619,2011.csv,2011,0.0,1.0
28416,Open 24h,1615,0,1615,2011.csv,2011,0.0,1.0
28417,Little Lion,1612,0,1612,2013.csv,2013,0.0,1.0
28418,Broken Lines,1611,0,1611,2011.csv,2011,0.0,1.0
28419,La ilusión de Noemí,1611,0,1611,2016.csv,2016,0.0,1.0
28420,Kadere Tutsak,1610,0,1610,2016.csv,2016,0.0,1.0
28421,Yankuba,1608,0,1608,2011.csv,2011,0.0,1.0
28422,Death Defying Acts 2012 Re-release,1606,0,1606,2012.csv,2012,0.0,1.0
28423,Dead Volume,1605,0,1605,2020.csv,2020,0.0,1.0
28424,Back to the Future Part III 2020 Re-release,1603,0,1603,2020.csv,2020,0.0,1.0
28425,David and Goliath,1598,0,1598,2017.csv,2017,0.0,1.0
28426,Forever,1598,1598,0,2015.csv,2015,1.0,0.0
28427,Miss India America,1598,1598,0,2016.csv,2016,1.0,0.0
28428,Poisonous Love,1597,0,1597,2018.csv,2018,0.0,1.0
28429,El Bosque de los Perros,1596,0,1596,2019.csv,2019,0.0,1.0
28430,La Pointe Courte,1596,0,1596,2018.csv,2018,0.0,1.0
28431,Angustia,1595,0,1595,2018.csv,2018,0.0,1.0
28432,El mensajero,1594,0,1594,2017.csv,2017,0.0,1.0
28433,Above the Shadows,1594,0,1594,2020.csv,2020,0.0,1.0
28434,Amigos: Meksika Hazinesi,1593,0,1593,2017.csv,2017,0.0,1.0
28435,Las Acacias 2018 Re-release,1588,0,1588,2018.csv,2018,0.0,1.0
28436,La sombra del sol,1587,0,1587,2011.csv,2011,0.0,1.0
28437,Gun,1586,0,1586,2014.csv,2014,0.0,1.0
28438,Violet,1586,0,1586,2014.csv,2014,0.0,1.0
28439,Estigmas,1586,0,1586,2010.csv,2010,0.0,1.0
28440,Relámpago en la Oscuridad: Lightning in the Dark,1584,0,1584,2015.csv,2015,0.0,1.0
28441,Fantastic Mr. Fox 2020 Re-release,1583,0,1583,2020.csv,2020,0.0,1.0
28442,American Playhouse: The Killing Floor,1583,1583,0,2019.csv,2019,1.0,0.0
28443,Manuela and Manuel,1582,1582,0,2010.csv,2010,1.0,0.0
28444,La del Chango,1582,0,1582,2016.csv,2016,0.0,1.0
28445,El invierno llega después del otoño,1582,0,1582,2017.csv,2017,0.0,1.0
28446,Jonas Kaufmann: My Italy,1578,0,1578,2017.csv,2017,0.0,1.0
28447,The Fox Hunter,1577,1577,0,2020.csv,2020,1.0,0.0
28448,This Consuming Love,1576,0,1576,2013.csv,2013,0.0,1.0
28449,The Nun 2020 Re-release,1575,0,1575,2020.csv,2020,0.0,1.0
28450,Next to Her,1575,0,1575,2016.csv,2016,0.0,1.0
28451,Hemsire,1573,0,1573,2018.csv,2018,0.0,1.0
28452,Ypatingas poreikis,1571,0,1571,2015.csv,2015,0.0,1.0
28453,Anclados,1567,0,1567,2010.csv,2010,0.0,1.0
28454,Once Upon a Time in London,1567,0,1567,2019.csv,2019,0.0,1.0
28455,Quemando suerte,1565,0,1565,2011.csv,2011,0.0,1.0
28456,Brand: A Second Coming,1562,0,1562,2015.csv,2015,0.0,1.0
28457,Easier with Practice,1558,0,1558,2010.csv,2010,0.0,1.0
28458,Yasuni - dos segundos de vida,1557,0,1557,2011.csv,2011,0.0,1.0
28459,The Soviet Revolution Told Through its Cinema,1551,0,1551,2017.csv,2017,0.0,1.0
28460,Tre nøtter til Askepott på Bordalsvis,1548,0,1548,2017.csv,2017,0.0,1.0
28461,Cherry 2012 Re-release,1547,0,1547,2012.csv,2012,0.0,1.0
28462,Apnea,1547,0,1547,2012.csv,2012,0.0,1.0
28463,Demon Inside 2016 Re-release,1546,0,1546,2016.csv,2016,0.0,1.0
28464,The Host 2010 Re-release,1546,0,1546,2010.csv,2010,0.0,1.0
28465,A Serbian Film,1541,0,1541,2011.csv,2011,0.0,1.0
28466,The We and the I 2015 Re-release,1539,0,1539,2015.csv,2015,0.0,1.0
28467,Again Once Again,1538,0,1538,2019.csv,2019,0.0,1.0
28468,Io & Marilyn 2012 Re-release,1534,0,1534,2012.csv,2012,0.0,1.0
28469,Adopt a Daddy 2021 Re-release,1533,0,1533,2021.csv,2021,0.0,1.0
28470,The Tunnel,1532,1532,0,2011.csv,2011,1.0,0.0
28471,Rhymes for Young Ghouls,1529,1529,0,2014.csv,2014,1.0,0.0
28472,Unless,1527,0,1527,2018.csv,2018,0.0,1.0
28473,White Shadow,1522,0,1522,2015.csv,2015,0.0,1.0
28474,The Hidden Tiger,1521,0,1521,2016.csv,2016,0.0,1.0
28475,Central Station 2019 Re-release,1520,0,1520,2019.csv,2019,0.0,1.0
28476,Missed Out,1517,0,1517,2015.csv,2015,0.0,1.0
28477,Behind the Mirror: The Secret War of Nica,1517,0,1517,2012.csv,2012,0.0,1.0
28478,Skjól og skart,1517,0,1517,2017.csv,2017,0.0,1.0
28479,Hachi: A Dog's Tale 2012 Re-release,1515,0,1515,2012.csv,2012,0.0,1.0
28480,Okka Kshanam,1514,0,1514,2017.csv,2017,0.0,1.0
28481,El Caído del Cielo,1514,0,1514,2016.csv,2016,0.0,1.0
28482,"Carmo, Hit the Road 2010 Re-release",1512,1512,0,2010.csv,2010,1.0,0.0
28483,The Tree,1512,0,1512,2018.csv,2018,0.0,1.0
28484,Bad Day for the Cut,1510,0,1510,2017.csv,2017,0.0,1.0
28485,A German Life,1509,0,1509,2020.csv,2020,0.0,1.0
28486,In the Name of the Son,1508,0,1508,2013.csv,2013,0.0,1.0
28487,Room on the Broom,1506,0,1506,2013.csv,2013,0.0,1.0
28488,Arraianos 2015 Re-release,1503,0,1503,2015.csv,2015,0.0,1.0
28489,Asche Abar Shabor,1503,0,1503,2018.csv,2018,0.0,1.0
28490,Historias breves 14,1503,0,1503,2017.csv,2017,0.0,1.0
28491,El hijo bastardo de Dios,1502,0,1502,2015.csv,2015,0.0,1.0
28492,The Forest of the Lost Souls,1502,0,1502,2017.csv,2017,0.0,1.0
28493,Temporal,1501,0,1501,2013.csv,2013,0.0,1.0
28494,A Brand New Life 2012 Re-release,1501,0,1501,2012.csv,2012,0.0,1.0
28495,"Casanova, identitate femininã",1501,0,1501,2010.csv,2010,0.0,1.0
28496,Souldier,1500,1500,0,2014.csv,2014,1.0,0.0
28497,Cul-de-sac,1500,0,1500,2010.csv,2010,0.0,1.0
28498,Before Opening Night,1499,0,1499,2011.csv,2011,0.0,1.0
28499,Fellini Satyricon 2010 Re-release,1499,0,1499,2010.csv,2010,0.0,1.0
28500,Chavez Infinito,1499,0,1499,2017.csv,2017,0.0,1.0
28501,Ah Yalan Dünyada,1498,0,1498,2015.csv,2015,0.0,1.0
28502,The Christening 2014 Re-release,1494,0,1494,2014.csv,2014,0.0,1.0
28503,The Gruffalo's Child,1493,0,1493,2012.csv,2012,0.0,1.0
28504,The Childhood of Icarus,1493,0,1493,2011.csv,2011,0.0,1.0
28505,Lapland Odyssey 2012 Re-release,1493,0,1493,2012.csv,2012,0.0,1.0
28506,Where Are You Taking Me?,1492,1492,0,2012.csv,2012,1.0,0.0
28507,Las chicas del 3º,1488,0,1488,2014.csv,2014,0.0,1.0
28508,Os Conselhos da Noite,1488,0,1488,2020.csv,2020,0.0,1.0
28509,The Princess Bride 2017 Re-release,1488,0,1488,2017.csv,2017,0.0,1.0
28510,Adrift 2010 Re-release,1487,0,1487,2010.csv,2010,0.0,1.0
28511,Entanglement,1484,0,1484,2015.csv,2015,0.0,1.0
28512,Making Rounds,1484,1484,0,2015.csv,2015,1.0,0.0
28513,Lola... drones,1483,0,1483,2019.csv,2019,0.0,1.0
28514,The Blood Bond,1483,0,1483,2011.csv,2011,0.0,1.0
28515,Old Is Gold,1483,0,1483,2019.csv,2019,0.0,1.0
28516,El Origen de la Tristeza,1481,0,1481,2018.csv,2018,0.0,1.0
28517,Hirschen,1480,0,1480,2014.csv,2014,0.0,1.0
28518,Torso of Stanko Arnold,1479,0,1479,2016.csv,2016,0.0,1.0
28519,Monty and the Street Party,1479,0,1479,2020.csv,2020,0.0,1.0
28520,The Matrix Reloaded 2020 Re-release,1478,0,1478,2020.csv,2020,0.0,1.0
28521,Legado del mar,1474,0,1474,2017.csv,2017,0.0,1.0
28522,Demon Eye,1473,0,1473,2019.csv,2019,0.0,1.0
28523,Shadow Dancer 2015 Re-release,1472,0,1472,2015.csv,2015,0.0,1.0
28524,Setenta y Pico,1470,0,1470,2016.csv,2016,0.0,1.0
28525,Rigor Mortis 2015 Re-release,1470,0,1470,2015.csv,2015,0.0,1.0
28526,Öfkeli çilginlik karamsar çile,1469,0,1469,2011.csv,2011,0.0,1.0
28527,The Package,1469,1469,0,2013.csv,2013,1.0,0.0
28528,Vorrei averti qui,1469,0,1469,2011.csv,2011,0.0,1.0
28529,Soulsmith,1467,0,1467,2017.csv,2017,0.0,1.0
28530,The Lion King 3: Hakuna Matata,1465,0,1465,2010.csv,2010,0.0,1.0
28531,Totally Under Control,1465,0,1465,2020.csv,2020,0.0,1.0
28532,July Rain,1461,0,1461,2016.csv,2016,0.0,1.0
28533,Last Chance Harvey 2012 Re-release,1461,0,1461,2012.csv,2012,0.0,1.0
28534,The Referees,1458,0,1458,2011.csv,2011,0.0,1.0
28535,Children of Paradise,1457,0,1457,2010.csv,2010,0.0,1.0
28536,Parir,1456,0,1456,2017.csv,2017,0.0,1.0
28537,Howl's Moving Castle Studio Ghibli Fest 2020,1454,0,1454,2020.csv,2020,0.0,1.0
28538,Capelito Daddy,1453,0,1453,2011.csv,2011,0.0,1.0
28539,Room Hates,1449,0,1449,2018.csv,2018,0.0,1.0
28540,The Woman,1449,0,1449,2011.csv,2011,0.0,1.0
28541,The World's Fastest Indian 2020 Re-release,1448,0,1448,2020.csv,2020,0.0,1.0
28542,That Way Madness Lies...,1447,1447,0,2018.csv,2018,1.0,0.0
28543,Badlands 2010 Re-release,1447,0,1447,2010.csv,2010,0.0,1.0
28544,The Sky of the Centaur,1446,0,1446,2017.csv,2017,0.0,1.0
28545,The Absent,1443,0,1443,2016.csv,2016,0.0,1.0
28546,A Decent Woman,1441,0,1441,2017.csv,2017,0.0,1.0
28547,Milan Talkies,1437,0,1437,2019.csv,2019,0.0,1.0
28548,Deja la luz prendida,1434,0,1434,2018.csv,2018,0.0,1.0
28549,Colmena,1432,0,1432,2018.csv,2018,0.0,1.0
28550,3-D Sex and Zen: Extreme Ecstasy 2014 Re-release,1431,0,1431,2014.csv,2014,0.0,1.0
28551,Bestiaire,1428,1428,0,2012.csv,2012,1.0,0.0
28552,Blood in the Mobile,1428,0,1428,2011.csv,2011,0.0,1.0
28553,Julia y el zorro,1427,0,1427,2018.csv,2018,0.0,1.0
28554,Habit,1426,0,1426,2018.csv,2018,0.0,1.0
28555,"Zoran, My Nephew the Idiot 2015 Re-release",1426,0,1426,2015.csv,2015,0.0,1.0
28556,Mi Hijo,1425,0,1425,2018.csv,2018,0.0,1.0
28557,The Silence of Mark Rothko,1422,1422,0,2016.csv,2016,1.0,0.0
28558,Ciegos,1416,0,1416,2019.csv,2019,0.0,1.0
28559,Marcelo Yuka no Caminho das Setas (Marcelo Yuka: Follow the Signs),1414,0,1414,2012.csv,2012,0.0,1.0
28560,Balloons,1412,0,1412,2017.csv,2017,0.0,1.0
28561,BÚÉK 2020 Re-release,1410,0,1410,2020.csv,2020,0.0,1.0
28562,The Forest for the Trees,1410,1410,0,2017.csv,2017,1.0,0.0
28563,Alptraum,1408,0,1408,2017.csv,2017,0.0,1.0
28564,The Sentries,1406,0,1406,2018.csv,2018,0.0,1.0
28565,Revolutions,1406,0,1406,2017.csv,2017,0.0,1.0
28566,Zona Zamfirova 2,1404,0,1404,2017.csv,2017,0.0,1.0
28567,Drool,1403,1403,0,2010.csv,2010,1.0,0.0
28568,Maleficent 2020 Re-release,1401,0,1401,2020.csv,2020,0.0,1.0
28569,Short Cut,1399,0,1399,2018.csv,2018,0.0,1.0
28570,To the Hilt,1398,0,1398,2015.csv,2015,0.0,1.0
28571,Heimat is a Space in Time,1398,0,1398,2019.csv,2019,0.0,1.0
28572,Different Mothers,1397,0,1397,2010.csv,2010,0.0,1.0
28573,The Dead Man and Being Happy 2014 Re-release,1397,0,1397,2014.csv,2014,0.0,1.0
28574,I ne bylo luchshe brata,1396,0,1396,2013.csv,2013,0.0,1.0
28575,Madang Amtark 2014 Re-release,1394,0,1394,2014.csv,2014,0.0,1.0
28576,The Alien Girl 2011 Re-release,1392,0,1392,2011.csv,2011,0.0,1.0
28577,Cano,1390,0,1390,2018.csv,2018,0.0,1.0
28578,The Apartment 2020 Re-release,1388,0,1388,2020.csv,2020,0.0,1.0
28579,12 Horas 2 Minutos,1383,0,1383,2012.csv,2012,0.0,1.0
28580,Recollections of the Yellow House,1382,0,1382,2019.csv,2019,0.0,1.0
28581,Un Tal Eduardo,1379,0,1379,2018.csv,2018,0.0,1.0
28582,Chameleon 2011 Re-release,1379,0,1379,2011.csv,2011,0.0,1.0
28583,Attack on Titan Part 2 2018 Re-release,1379,0,1379,2018.csv,2018,0.0,1.0
28584,Birayen bedengiye,1377,0,1377,2018.csv,2018,0.0,1.0
28585,Joyful Reunion,1377,0,1377,2012.csv,2012,0.0,1.0
28586,The Third Man 2020 Re-release,1373,0,1373,2020.csv,2020,0.0,1.0
28587,Finding Vivian Maier 2018 Re-release,1372,0,1372,2018.csv,2018,0.0,1.0
28588,Brief Story from the Green Planet,1368,0,1368,2019.csv,2019,0.0,1.0
28589,Beauty and the Beholder,1368,1368,0,2018.csv,2018,1.0,0.0
28590,My Golden Days 2018 Re-release,1368,0,1368,2018.csv,2018,0.0,1.0
28591,In The Name of Peace: John Hume in America,1366,0,1366,2017.csv,2017,0.0,1.0
28592,Bienaventurados los mansos,1363,0,1363,2017.csv,2017,0.0,1.0
28593,Keepers of the Flame,1363,0,1363,2018.csv,2018,0.0,1.0
28594,Music for Getting Married,1361,0,1361,2018.csv,2018,0.0,1.0
28595,Rodolfo Walsh la Revelacion de lo Escondido,1359,0,1359,2016.csv,2016,0.0,1.0
28596,How To Become Nothing,1358,0,1358,2017.csv,2017,0.0,1.0
28597,Istasyon,1357,0,1357,2020.csv,2020,0.0,1.0
28598,Shan Shan,1357,0,1357,2010.csv,2010,0.0,1.0
28599,Esto no es un golpe,1356,0,1356,2018.csv,2018,0.0,1.0
28600,Moana 2019 Re-release,1356,0,1356,2019.csv,2019,0.0,1.0
28601,Along the Roadside 2015 Re-release,1352,1352,0,2015.csv,2015,1.0,0.0
28602,Access All Areas,1347,0,1347,2017.csv,2017,0.0,1.0
28603,Yalniz Hayaller Kaldi,1346,0,1346,2018.csv,2018,0.0,1.0
28604,Bana Git De,1346,0,1346,2016.csv,2016,0.0,1.0
28605,Görünmeyen,1345,0,1345,2011.csv,2011,0.0,1.0
28606,"BirriLata, una vuelta en tren",1345,0,1345,2016.csv,2016,0.0,1.0
28607,La noche del lobo,1339,0,1339,2016.csv,2016,0.0,1.0
28608,El mago de los vagos,1338,0,1338,2017.csv,2017,0.0,1.0
28609,Mala Vida,1337,0,1337,2018.csv,2018,0.0,1.0
28610,Halef,1335,0,1335,2018.csv,2018,0.0,1.0
28611,"Marieke, Marieke 2012 Re-release",1335,0,1335,2012.csv,2012,0.0,1.0
28612,Sapos y culebras,1334,0,1334,2014.csv,2014,0.0,1.0
28613,Paisaje,1332,0,1332,2018.csv,2018,0.0,1.0
28614,The Adventurers 2019 Re-release,1331,0,1331,2019.csv,2019,0.0,1.0
28615,Quijote,1331,0,1331,2012.csv,2012,0.0,1.0
28616,Kittu Unnadu Jagratha,1330,0,1330,2017.csv,2017,0.0,1.0
28617,Endlich Weltuntergang,1329,0,1329,2012.csv,2012,0.0,1.0
28618,Una historia de Madres,1324,0,1324,2017.csv,2017,0.0,1.0
28619,Yet to Rule,1323,0,1323,2018.csv,2018,0.0,1.0
28620,Seized,1321,0,1321,2020.csv,2020,0.0,1.0
28621,The Chamber,1319,0,1319,2017.csv,2017,0.0,1.0
28622,Shopkins Wild,1317,0,1317,2018.csv,2018,0.0,1.0
28623,690 Vopnafjörður,1314,0,1314,2017.csv,2017,0.0,1.0
28624,Hind Ka Napak Ko Jawab,1314,0,1314,2017.csv,2017,0.0,1.0
28625,Dangar Doctor Jelly,1313,0,1313,2017.csv,2017,0.0,1.0
28626,A Small Act,1311,0,1311,2011.csv,2011,0.0,1.0
28627,Sordo,1310,0,1310,2015.csv,2015,0.0,1.0
28628,Rec 2011 Re-release,1308,0,1308,2011.csv,2011,0.0,1.0
28629,Adi ask,1307,0,1307,2018.csv,2018,0.0,1.0
28630,The Workshop,1306,0,1306,2018.csv,2018,0.0,1.0
28631,Bleach the Movie 2: The Diamond Dust Rebellion 2010 Re-release,1304,0,1304,2010.csv,2010,0.0,1.0
28632,Planeta 5000,1303,0,1303,2020.csv,2020,0.0,1.0
28633,Fuerza Mortal,1302,0,1302,2017.csv,2017,0.0,1.0
28634,Primer Grado en Tres Países,1299,0,1299,2018.csv,2018,0.0,1.0
28635,Bing Luo Sha,1298,0,1298,2013.csv,2013,0.0,1.0
28636,3 Nights in the Desert,1297,1297,0,2015.csv,2015,1.0,0.0
28637,El Mundo De Carolina,1297,0,1297,2016.csv,2016,0.0,1.0
28638,Interlude,1296,0,1296,2017.csv,2017,0.0,1.0
28639,Earth 2019 Re-release,1296,0,1296,2019.csv,2019,0.0,1.0
28640,Impuros,1290,0,1290,2018.csv,2018,0.0,1.0
28641,Kékszakállú,1289,0,1289,2017.csv,2017,0.0,1.0
28642,The World According to Irving,1286,0,1286,2012.csv,2012,0.0,1.0
28643,La Organización Negra (ejercicio documental),1286,0,1286,2016.csv,2016,0.0,1.0
28644,You Disappear,1285,0,1285,2018.csv,2018,0.0,1.0
28645,Söngur Kanemu,1285,0,1285,2018.csv,2018,0.0,1.0
28646,Lakeeran,1284,0,1284,2016.csv,2016,0.0,1.0
28647,Sant Te Sipahi,1284,0,1284,2016.csv,2016,0.0,1.0
28648,I Against I,1280,0,1280,2012.csv,2012,0.0,1.0
28649,Thorn,1279,0,1279,2018.csv,2018,0.0,1.0
28650,More Than Honey 2015 Re-release,1279,0,1279,2015.csv,2015,0.0,1.0
28651,Bellos suicidios,1277,0,1277,2011.csv,2011,0.0,1.0
28652,Lazar,1276,0,1276,2016.csv,2016,0.0,1.0
28653,Sokak Köpekleri Bal ile Betty,1275,0,1275,2016.csv,2016,0.0,1.0
28654,Cinderella 2018 Re-release,1274,0,1274,2018.csv,2018,0.0,1.0
28655,Ya umeyu vyazat,1274,0,1274,2017.csv,2017,0.0,1.0
28656,Our Mothers,1274,0,1274,2020.csv,2020,0.0,1.0
28657,The Hours and Times,1273,1273,0,2019.csv,2019,1.0,0.0
28658,O Interminável,1271,0,1271,2018.csv,2018,0.0,1.0
28659,Corporation,1269,0,1269,2019.csv,2019,0.0,1.0
28660,Rocky IV 2020 Re-release,1269,0,1269,2020.csv,2020,0.0,1.0
28661,El Hijo de Dios,1267,0,1267,2016.csv,2016,0.0,1.0
28662,Reign of the Supermen,1261,0,1261,2019.csv,2019,0.0,1.0
28663,Cassandra's Dream 2010 Re-release,1261,0,1261,2010.csv,2010,0.0,1.0
28664,Altered Perception,1259,1259,0,2018.csv,2018,1.0,0.0
28665,Gardiens de l'ordre 2011 Re-release,1259,0,1259,2011.csv,2011,0.0,1.0
28666,Adam 2018 Re-release,1258,0,1258,2018.csv,2018,0.0,1.0
28667,The Wolf Hour,1255,0,1255,2019.csv,2019,0.0,1.0
28668,The Maltese Falcon 2012 Re-release,1255,0,1255,2012.csv,2012,0.0,1.0
28669,Hotel de la amistad,1255,0,1255,2016.csv,2016,0.0,1.0
28670,The Shepherd,1253,0,1253,2017.csv,2017,0.0,1.0
28671,The Thin Red Line 2020 Re-release,1249,0,1249,2020.csv,2020,0.0,1.0
28672,Estive em Lisboa e Lembrei de Você,1249,0,1249,2016.csv,2016,0.0,1.0
28673,Camino de campaña,1249,0,1249,2016.csv,2016,0.0,1.0
28674,Le Plaisir,1245,0,1245,2018.csv,2018,0.0,1.0
28675,Viviré con tu recuerdo,1244,0,1244,2016.csv,2016,0.0,1.0
28676,Footrot Flats: The Dog's Tale 2020 Re-release,1243,0,1243,2018.csv,2018,0.0,1.0
28677,Intimate Strangers 2011 Re-release,1243,0,1243,2011.csv,2011,0.0,1.0
28678,The Fare,1243,0,1243,2020.csv,2020,0.0,1.0
28679,El Valle Sin Sombras,1242,0,1242,2015.csv,2015,0.0,1.0
28680,Heavenly Nomadic,1240,0,1240,2016.csv,2016,0.0,1.0
28681,A Fish in the Bathtub 2019 re-release,1237,1237,0,2019.csv,2019,1.0,0.0
28682,Dead Horse Nebula,1233,0,1233,2019.csv,2019,0.0,1.0
28683,National Theatre Live: A View from the Bridge 2020 Re-release,1233,0,1233,2020.csv,2020,0.0,1.0
28684,Fando and Lis,1232,0,1232,2020.csv,2020,0.0,1.0
28685,Fuga,1232,0,1232,2019.csv,2019,0.0,1.0
28686,Stela,1229,0,1229,2021.csv,2021,0.0,1.0
28687,Necropolis Symphony,1228,0,1228,2016.csv,2016,0.0,1.0
28688,El navegante solitario,1228,0,1228,2020.csv,2020,0.0,1.0
28689,The Christening 2012 Re-release,1227,0,1227,2012.csv,2012,0.0,1.0
28690,Two Men Went to War 2018 Re-release,1227,1227,0,2018.csv,2018,1.0,0.0
28691,Ochentaisiete,1224,0,1224,2016.csv,2016,0.0,1.0
28692,"Los 120, cafetales de la poesía",1211,0,1211,2018.csv,2018,0.0,1.0
28693,Roh London: La Bayadere,1207,0,1207,2018.csv,2018,0.0,1.0
28694,"Infância, Adolescência, Juventude",1205,0,1205,2019.csv,2019,0.0,1.0
28695,Abandoned 2013 Re-release,1205,0,1205,2013.csv,2013,0.0,1.0
28696,Through the Eyes of the Photographer,1204,0,1204,2015.csv,2015,0.0,1.0
28697,The Bed,1203,0,1203,2018.csv,2018,0.0,1.0
28698,Cure: The Life of Another,1203,0,1203,2015.csv,2015,0.0,1.0
28699,Los Hermanos Karaoke,1201,0,1201,2018.csv,2018,0.0,1.0
28700,Pinprick,1198,0,1198,2013.csv,2013,0.0,1.0
28701,Four,1198,0,1198,2011.csv,2011,0.0,1.0
28702,Eldfim Ást,1197,0,1197,2018.csv,2018,0.0,1.0
28703,A Clockwork Orange 2020 Re-release,1196,0,1196,2020.csv,2020,0.0,1.0
28704,A Small Good Thing,1196,1196,0,2016.csv,2016,1.0,0.0
28705,Samuel in the Clouds,1195,0,1195,2016.csv,2016,0.0,1.0
28706,Snowman's Land,1190,1190,0,2012.csv,2012,1.0,0.0
28707,Under the Turban,1190,1190,0,2018.csv,2018,1.0,0.0
28708,Algo Fayó,1190,0,1190,2017.csv,2017,0.0,1.0
28709,The Magic Mountain,1189,0,1189,2015.csv,2015,0.0,1.0
28710,Above and Below,1189,0,1189,2016.csv,2016,0.0,1.0
28711,Thriller,1188,0,1188,2020.csv,2020,0.0,1.0
28712,Umbral,1188,0,1188,2017.csv,2017,0.0,1.0
28713,Kadavul Irukaan Kumaru,1186,0,1186,2016.csv,2016,0.0,1.0
28714,Born in Syria,1185,0,1185,2017.csv,2017,0.0,1.0
28715,I Love My Mum,1182,0,1182,2019.csv,2019,0.0,1.0
28716,Elim Sende,1181,0,1181,2018.csv,2018,0.0,1.0
28717,The Prophet,1180,0,1180,2012.csv,2012,0.0,1.0
28718,DJ Snake: The Concert in Cinema,1179,0,1179,2020.csv,2020,0.0,1.0
28719,Down para arriba,1179,0,1179,2019.csv,2019,0.0,1.0
28720,Point of Conscience,1179,0,1179,2018.csv,2018,0.0,1.0
28721,Bhangra Paa Le,1177,0,1177,2020.csv,2020,0.0,1.0
28722,XConfessions,1175,0,1175,2016.csv,2016,0.0,1.0
28723,Big Boys Gone Bananas!*,1175,0,1175,2012.csv,2012,0.0,1.0
28724,The Monsters' Dinner,1174,0,1174,2012.csv,2012,0.0,1.0
28725,A Different American Dream,1172,1172,0,2017.csv,2017,1.0,0.0
28726,Cruzeiro Seixas - As Cartas do Rei Artur,1171,0,1171,2017.csv,2017,0.0,1.0
28727,A Zombie Invasion,1170,1170,0,2013.csv,2013,1.0,0.0
28728,Red Like the Sky 2011 Re-release,1170,0,1170,2011.csv,2011,0.0,1.0
28729,Seniors,1168,0,1168,2011.csv,2011,0.0,1.0
28730,Miss Violence 2016 Re-release,1165,0,1165,2016.csv,2016,0.0,1.0
28731,Letters to Paul Morrissey,1164,0,1164,2019.csv,2019,0.0,1.0
28732,Love Songs 2010 Re-release,1163,0,1163,2010.csv,2010,0.0,1.0
28733,Rock'n'Roll,1161,0,1161,2020.csv,2020,0.0,1.0
28734,Les enfants d'Isadora,1160,0,1160,2020.csv,2020,0.0,1.0
28735,Brothers 2016 Re-release,1160,0,1160,2016.csv,2016,0.0,1.0
28736,Reel Rock 14,1157,0,1157,2019.csv,2019,0.0,1.0
28737,Fear Pharm,1157,1157,0,2020.csv,2020,1.0,0.0
28738,Los relocalizados,1155,0,1155,2017.csv,2017,0.0,1.0
28739,Rann,1146,0,1146,2010.csv,2010,0.0,1.0
28740,Patrulla 111,1145,0,1145,2020.csv,2020,0.0,1.0
28741,Coming Home,1145,0,1145,2019.csv,2019,0.0,1.0
28742,Strangled 2017 Re-release,1143,0,1143,2017.csv,2017,0.0,1.0
28743,Hombres de piel dura,1143,0,1143,2019.csv,2019,0.0,1.0
28744,Comes a Bright Day,1142,0,1142,2012.csv,2012,0.0,1.0
28745,Jack & Diane,1142,1142,0,2012.csv,2012,1.0,0.0
28746,La Playa D.C.,1138,0,1138,2014.csv,2014,0.0,1.0
28747,Cassandra,1137,0,1137,2013.csv,2013,0.0,1.0
28748,Seconds Apart,1137,0,1137,2011.csv,2011,0.0,1.0
28749,Sickfuckpeople,1136,0,1136,2013.csv,2013,0.0,1.0
28750,Half Ticket,1135,0,1135,2016.csv,2016,0.0,1.0
28751,Oroslan,1134,0,1134,2019.csv,2019,0.0,1.0
28752,Veer!,1132,1132,0,2013.csv,2013,1.0,0.0
28753,Babu Bangaram,1132,0,1132,2016.csv,2016,0.0,1.0
28754,Tu Mera Ki Lagda,1129,0,1129,2019.csv,2019,0.0,1.0
28755,One Shot,1127,0,1127,2018.csv,2018,0.0,1.0
28756,London Town,1126,0,1126,2017.csv,2017,0.0,1.0
28757,Jatra,1126,0,1126,2017.csv,2017,0.0,1.0
28758,Dom,1126,0,1126,2019.csv,2019,0.0,1.0
28759,Hasbihal,1125,0,1125,2019.csv,2019,0.0,1.0
28760,Aerials,1124,0,1124,2016.csv,2016,0.0,1.0
28761,Premi,1124,0,1124,2017.csv,2017,0.0,1.0
28762,Eternal Amazon,1123,0,1123,2014.csv,2014,0.0,1.0
28763,BABA 'Bu Alem Bi Alem',1121,0,1121,2019.csv,2019,0.0,1.0
28764,Yarinin Adi Baska,1120,0,1120,2017.csv,2017,0.0,1.0
28765,"Pedra, Peixe, Rio (Itamatatiua)",1120,0,1120,2010.csv,2010,0.0,1.0
28766,Cuarenta balas: El caso Fischer-Bufano,1119,0,1119,2015.csv,2015,0.0,1.0
28767,Fast & Furious 6 2020 Re-release,1118,0,1118,2020.csv,2020,0.0,1.0
28768,Urban Hymn,1115,0,1115,2016.csv,2016,0.0,1.0
28769,Patthelyzet,1114,0,1114,2020.csv,2020,0.0,1.0
28770,"Khrustalyov, My Car!",1113,0,1113,2018.csv,2018,0.0,1.0
28771,Zena,1112,0,1112,2019.csv,2019,0.0,1.0
28772,Just Sex and Nothing Else,1112,0,1112,2011.csv,2011,0.0,1.0
28773,Nena,1112,0,1112,2016.csv,2016,0.0,1.0
28774,Predator 2020 Re-release,1110,0,1110,2020.csv,2020,0.0,1.0
28775,Roads,1108,0,1108,2019.csv,2019,0.0,1.0
28776,Hai Tang Hong,1107,1107,0,2020.csv,2020,1.0,0.0
28777,A Caribbean Dream,1106,0,1106,2017.csv,2017,0.0,1.0
28778,Half Brothers,1100,1100,0,2018.csv,2018,1.0,0.0
28779,Como el cielo después de llover,1098,0,1098,2020.csv,2020,0.0,1.0
28780,The Wages of Fear 2010 Re-release,1098,0,1098,2010.csv,2010,0.0,1.0
28781,Keep Me Company,1097,0,1097,2020.csv,2020,0.0,1.0
28782,Amor Urgente,1090,0,1090,2018.csv,2018,0.0,1.0
28783,Yvonne,1088,0,1088,2019.csv,2019,0.0,1.0
28784,We Are the Giant,1088,1088,0,2014.csv,2014,1.0,0.0
28785,Soundgarden: Live from the Artists Den - The IMAX Experience,1087,0,1087,2019.csv,2019,0.0,1.0
28786,"Pendeja, payasa y gorda",1084,0,1084,2017.csv,2017,0.0,1.0
28787,Swing Vote 2010 Re-release,1084,0,1084,2010.csv,2010,0.0,1.0
28788,Around China with a Movie Camera,1084,0,1084,2016.csv,2016,0.0,1.0
28789,Keeper 2017 Re-release,1083,0,1083,2017.csv,2017,0.0,1.0
28790,Fah gam tor,1083,0,1083,2014.csv,2014,0.0,1.0
28791,Punto ciego,1081,0,1081,2016.csv,2016,0.0,1.0
28792,The Missing Picture 2015 Re-release,1081,0,1081,2015.csv,2015,0.0,1.0
28793,The Butterfly Room,1081,1081,0,2014.csv,2014,1.0,0.0
28794,Huracán,1080,0,1080,2020.csv,2020,0.0,1.0
28795,Oldboy,1080,0,1080,2020.csv,2020,0.0,1.0
28796,Muscle,1078,0,1078,2020.csv,2020,0.0,1.0
28797,The Gay Divorcee 2019 Re-release,1077,0,1077,2019.csv,2019,0.0,1.0
28798,Banat: The Journey,1074,0,1074,2016.csv,2016,0.0,1.0
28799,Little Glory,1073,0,1073,2012.csv,2012,0.0,1.0
28800,Ninja Scroll,1073,0,1073,2012.csv,2012,0.0,1.0
28801,Boat Rower Girl,1070,0,1070,2019.csv,2019,0.0,1.0
28802,Parallel Policy,1070,1070,0,2020.csv,2020,1.0,0.0
28803,The Death of Superman,1069,0,1069,2019.csv,2019,0.0,1.0
28804,La Luna En Ti,1069,0,1069,2010.csv,2010,0.0,1.0
28805,Lo que sé de Lola 2010 Re-release,1068,0,1068,2010.csv,2010,0.0,1.0
28806,König des Comics,1068,0,1068,2012.csv,2012,0.0,1.0
28807,Black Angel 2016 Re-release,1067,0,1067,2016.csv,2016,0.0,1.0
28808,Daguerreotype,1066,0,1066,2018.csv,2018,0.0,1.0
28809,Ana Barin Halak,1065,0,1065,2019.csv,2019,0.0,1.0
28810,People of Allah,1063,0,1063,2010.csv,2010,0.0,1.0
28811,Svyaz vremyon,1060,0,1060,2010.csv,2010,0.0,1.0
28812,Nowhere,1059,0,1059,2020.csv,2020,0.0,1.0
28813,Galapagos 2013 Re-release,1056,0,1056,2013.csv,2013,0.0,1.0
28814,Prikosnovenie vetra,1055,0,1055,2016.csv,2016,0.0,1.0
28815,The Exercise of Chaos,1054,0,1054,2013.csv,2013,0.0,1.0
28816,Cowards 2010 Re-release,1049,0,1049,2010.csv,2010,0.0,1.0
28817,El Hombre,1047,0,1047,2018.csv,2018,0.0,1.0
28818,Le Tigre Et Les Animaux De La Foret,1046,0,1046,2011.csv,2011,0.0,1.0
28819,The Football Boys,1041,0,1041,2016.csv,2016,0.0,1.0
28820,Withnail & I 2020 Re-release,1041,0,1041,2014.csv,2014,0.0,1.0
28821,Almost Ghosts,1038,0,1038,2019.csv,2019,0.0,1.0
28822,Le Cercle Rouge 2010 Re-release,1038,0,1038,2010.csv,2010,0.0,1.0
28823,Eternity,1036,0,1036,2019.csv,2019,0.0,1.0
28824,Childless,1036,1036,0,2015.csv,2015,1.0,0.0
28825,Nashla kosa na kamen,1035,0,1035,2017.csv,2017,0.0,1.0
28826,Tramontane,1035,0,1035,2017.csv,2017,0.0,1.0
28827,Kosmos 2012 Re-release,1034,0,1034,2012.csv,2012,0.0,1.0
28828,Diablo,1034,0,1034,2013.csv,2013,0.0,1.0
28829,Invisible Hands,1034,1034,0,2018.csv,2018,1.0,0.0
28830,We Are Thr3e,1033,0,1033,2018.csv,2018,0.0,1.0
28831,Het leven volgens Nino,1033,0,1033,2014.csv,2014,0.0,1.0
28832,Beyond the River 2019 Re-release,1032,0,1032,2019.csv,2019,0.0,1.0
28833,"Tahrir 2011: The Good, the Bad, and the Politician",1032,0,1032,2012.csv,2012,0.0,1.0
28834,Arribeños Street,1031,0,1031,2016.csv,2016,0.0,1.0
28835,Absence,1031,1031,0,2013.csv,2013,1.0,0.0
28836,"Yes, Chef!",1030,0,1030,2017.csv,2017,0.0,1.0
28837,Wonders in the Suburbs,1029,0,1029,2020.csv,2020,0.0,1.0
28838,Vanishing Point,1028,0,1028,2015.csv,2015,0.0,1.0
28839,Harvest,1027,0,1027,2012.csv,2012,0.0,1.0
28840,The Prodigies 2013 Re-release,1026,0,1026,2013.csv,2013,0.0,1.0
28841,"Malambo, the Good Man",1024,0,1024,2018.csv,2018,0.0,1.0
28842,"My Name is Batlir, not Butler",1023,0,1023,2018.csv,2018,0.0,1.0
28843,Remnants,1022,1022,0,2013.csv,2013,1.0,0.0
28844,Sunny et l'éléphant 2010 Re-release,1020,0,1020,2010.csv,2010,0.0,1.0
28845,bestefreunde,1020,0,1020,2016.csv,2016,0.0,1.0
28846,El almanaque 2014 Re-release,1019,0,1019,2014.csv,2014,0.0,1.0
28847,Peter Peryer: The Art of Seeing,1019,0,1019,2019.csv,2019,0.0,1.0
28848,Porfirio,1018,0,1018,2011.csv,2011,0.0,1.0
28849,Molly Moon and the Incredible Book of Hypnotism 2016 Re-release,1018,0,1018,2016.csv,2016,0.0,1.0
28850,Winterland,1017,0,1017,2019.csv,2019,0.0,1.0
28851,Moacir III,1016,0,1016,2017.csv,2017,0.0,1.0
28852,Vettah,1012,0,1012,2016.csv,2016,0.0,1.0
28853,Dive,1012,0,1012,2018.csv,2018,0.0,1.0
28854,Isi Life Mein...!,1010,0,1010,2011.csv,2011,0.0,1.0
28855,Bento Harassment,1009,0,1009,2020.csv,2020,0.0,1.0
28856,A Horrible Woman,1008,0,1008,2018.csv,2018,0.0,1.0
28857,Palestinos Go Home,1006,0,1006,2016.csv,2016,0.0,1.0
28858,Madam Satan,1005,0,1005,2013.csv,2013,0.0,1.0
28859,El cielo en tu mirada 2014 Re-release,1004,0,1004,2014.csv,2014,0.0,1.0
28860,Rigoletto On The Lake,1004,0,1004,2020.csv,2020,0.0,1.0
28861,Nannaku Prematho,1003,0,1003,2016.csv,2016,0.0,1.0
28862,Kokowääh 2013 Re-release,1000,0,1000,2013.csv,2013,0.0,1.0
28863,Attack on Titan: Crimson Bow and Arrow 2018 Re-release,999,0,999,2018.csv,2018,0.0,1.0
28864,London Di Heer,997,0,997,2016.csv,2016,0.0,1.0
28865,Alien Encounters in America: UFOs and Extraterrestrial Visitations,997,0,997,2016.csv,2016,0.0,1.0
28866,Altman,996,0,996,2015.csv,2015,0.0,1.0
28867,The Metropolitan Opera HD Live: Donizetti: Lucia di Lammermoor,995,0,995,2011.csv,2011,0.0,1.0
28868,Veorabrigoi,993,0,993,2015.csv,2015,0.0,1.0
28869,Interview 2011 Re-release,993,0,993,2011.csv,2011,0.0,1.0
28870,Eat Your Bones,992,0,992,2015.csv,2015,0.0,1.0
28871,Paulo Coelho's Best Story 2016 Re-release,992,0,992,2016.csv,2016,0.0,1.0
28872,The First Miss,992,0,992,2014.csv,2014,0.0,1.0
28873,The Frog,991,0,991,2018.csv,2018,0.0,1.0
28874,Jerichow 2012 Re-release,990,0,990,2012.csv,2012,0.0,1.0
28875,Before the Flood,988,0,988,2016.csv,2016,0.0,1.0
28876,Los Feliz,988,0,988,2016.csv,2016,0.0,1.0
28877,Imagens Proibidas,986,0,986,2019.csv,2019,0.0,1.0
28878,Cactus Flower,982,0,982,2018.csv,2018,0.0,1.0
28879,Dodes'ka-den,981,0,981,2020.csv,2020,0.0,1.0
28880,L'histoire du petit Paolo,981,0,981,2013.csv,2013,0.0,1.0
28881,Mocha,976,0,976,2019.csv,2019,0.0,1.0
28882,Paper Souls,976,0,976,2014.csv,2014,0.0,1.0
28883,The Penguin Counters,976,976,0,2017.csv,2017,1.0,0.0
28884,Colores de Pasión,975,0,975,2018.csv,2018,0.0,1.0
28885,Midnight Son,973,0,973,2013.csv,2013,0.0,1.0
28886,Dhol Ratti,971,0,971,2018.csv,2018,0.0,1.0
28887,Bir Yalnizlik Sarkisi,970,0,970,2020.csv,2020,0.0,1.0
28888,Strangers Online,968,968,0,2011.csv,2011,1.0,0.0
28889,Memory Exercises,966,0,966,2017.csv,2017,0.0,1.0
28890,Histórias de Alice,965,0,965,2016.csv,2016,0.0,1.0
28891,Kiruna - A Brand New World,962,0,962,2020.csv,2020,0.0,1.0
28892,Planet Terror 2011 Re-release,962,0,962,2011.csv,2011,0.0,1.0
28893,Hayalimdeki Köy,960,0,960,2019.csv,2019,0.0,1.0
28894,Pranchiyettan and the Saint,957,0,957,2011.csv,2011,0.0,1.0
28895,El Corte,956,0,956,2018.csv,2018,0.0,1.0
28896,Knock Out,953,0,953,2010.csv,2010,0.0,1.0
28897,Sinbad 2011 Re-release,952,0,952,2011.csv,2011,0.0,1.0
28898,Raja Abroadiya,951,0,951,2018.csv,2018,0.0,1.0
28899,El almanaque,950,0,950,2012.csv,2012,0.0,1.0
28900,Crimen de Las Salinas,950,0,950,2017.csv,2017,0.0,1.0
28901,Human Nature,949,0,949,2012.csv,2012,0.0,1.0
28902,The Blue Tiger 2014 Re-release,949,0,949,2014.csv,2014,0.0,1.0
28903,The Guv'nor,948,0,948,2016.csv,2016,0.0,1.0
28904,Bizum usaklar,948,0,948,2018.csv,2018,0.0,1.0
28905,Szkola uwodzenia Czeslawa M.,948,0,948,2016.csv,2016,0.0,1.0
28906,Solar,948,0,948,2017.csv,2017,0.0,1.0
28907,La Balade De Babouchka,945,0,945,2014.csv,2014,0.0,1.0
28908,The Closed Circuit 2015 Re-release,942,0,942,2015.csv,2015,0.0,1.0
28909,Takeover,940,0,940,2020.csv,2020,0.0,1.0
28910,Impunity,938,0,938,2015.csv,2015,0.0,1.0
28911,Violette 2016 Re-release,938,0,938,2016.csv,2016,0.0,1.0
28912,Campo,938,0,938,2019.csv,2019,0.0,1.0
28913,Bridges of Time,935,0,935,2019.csv,2019,0.0,1.0
28914,Qu'ils reposent en révolte (Des figures de guerre),934,0,934,2012.csv,2012,0.0,1.0
28915,Donzela Guerreira,934,0,934,2020.csv,2020,0.0,1.0
28916,Until the End of the Death,932,0,932,2019.csv,2019,0.0,1.0
28917,A People Uncounted,930,930,0,2014.csv,2014,1.0,0.0
28918,Manor House,927,0,927,2020.csv,2020,0.0,1.0
28919,América 2013 Re-release,926,0,926,2013.csv,2013,0.0,1.0
28920,Across the Waters,926,0,926,2017.csv,2017,0.0,1.0
28921,Marcel Proust's Time Regained 2019 Re-release,925,0,925,2019.csv,2019,0.0,1.0
28922,Sinatra Being Frank,925,0,925,2015.csv,2015,0.0,1.0
28923,Okhwan's Mission Impossible,924,0,924,2016.csv,2016,0.0,1.0
28924,"How Are You Doing, Rudolf Ming?",919,0,919,2010.csv,2010,0.0,1.0
28925,Cada 30 Horas,919,0,919,2016.csv,2016,0.0,1.0
28926,Quebradeiras,918,0,918,2011.csv,2011,0.0,1.0
28927,The Early Years: Erik Nietzsche Part 1 2010 Re-release,918,0,918,2010.csv,2010,0.0,1.0
28928,Elbow Grease,917,917,0,2021.csv,2021,1.0,0.0
28929,Carne propia,917,0,917,2017.csv,2017,0.0,1.0
28930,Alone with Her 2010 Re-release,913,0,913,2010.csv,2010,0.0,1.0
28931,Casa Coraggio,911,0,911,2017.csv,2017,0.0,1.0
28932,Safari 2017 Re-release,904,0,904,2017.csv,2017,0.0,1.0
28933,I Steal You From The Whole World,903,0,903,2020.csv,2020,0.0,1.0
28934,They Are We,900,900,0,2015.csv,2015,1.0,0.0
28935,Sign 'o' the Times 2017 Re-release,900,0,900,2017.csv,2017,0.0,1.0
28936,Ordinary Time,898,0,898,2019.csv,2019,0.0,1.0
28937,Blue Moon,896,0,896,2019.csv,2019,0.0,1.0
28938,"Tupac Amaru, algo está cambiando: something is changing",896,0,896,2012.csv,2012,0.0,1.0
28939,Sahis 46,896,0,896,2019.csv,2019,0.0,1.0
28940,SKL - Sport tisocerih obrazov,894,0,894,2019.csv,2019,0.0,1.0
28941,Guru Da Banda,893,0,893,2018.csv,2018,0.0,1.0
28942,Olvidalos y volverán por más,890,0,890,2016.csv,2016,0.0,1.0
28943,Otra madre,890,0,890,2017.csv,2017,0.0,1.0
28944,The Rape of Recy Taylor 2019 Re-release,890,0,890,2019.csv,2019,0.0,1.0
28945,The Dread,889,0,889,2018.csv,2018,0.0,1.0
28946,La Intimidad,889,0,889,2018.csv,2018,0.0,1.0
28947,Oya Hoye Pyar Ho Gaya,888,0,888,2013.csv,2013,0.0,1.0
28948,Out of the Furnace 2017 Re-release,886,0,886,2017.csv,2017,0.0,1.0
28949,Krov,886,0,886,2019.csv,2019,0.0,1.0
28950,Todo por el ascenso,881,0,881,2019.csv,2019,0.0,1.0
28951,Big Muddy,881,881,0,2015.csv,2015,1.0,0.0
28952,The Tapes,880,0,880,2011.csv,2011,0.0,1.0
28953,Network 2020 Re-release,880,0,880,2020.csv,2020,0.0,1.0
28954,Extraordinary Ordinary People,880,880,0,2017.csv,2017,1.0,0.0
28955,Luxor,879,0,879,2020.csv,2020,0.0,1.0
28956,Armed Response,879,0,879,2014.csv,2014,0.0,1.0
28957,The Sex of the Mothers 2014 Re-release,877,0,877,2014.csv,2014,0.0,1.0
28958,Cartoonists: Footsoldiers of Democracy?,876,0,876,2014.csv,2014,0.0,1.0
28959,Lady Bird 2020 Re-release,875,0,875,2020.csv,2020,0.0,1.0
28960,Singin' in the Rain 2020 Re-release,874,0,874,2017.csv,2017,0.0,1.0
28961,Amigo Lindo del Alma,874,0,874,2019.csv,2019,0.0,1.0
28962,Arrieros,872,0,872,2012.csv,2012,0.0,1.0
28963,Purgatorio,872,0,872,2014.csv,2014,0.0,1.0
28964,Pero Lovsin - Ti lahko,871,0,871,2018.csv,2018,0.0,1.0
28965,Los territorios,869,0,869,2018.csv,2018,0.0,1.0
28966,Three Seconds 2020 Re-release,868,0,868,2020.csv,2020,0.0,1.0
28967,El cruce de la pampa,867,0,867,2016.csv,2016,0.0,1.0
28968,Svetozár Stracina,866,0,866,2019.csv,2019,0.0,1.0
28969,Into_nation of Big Odessa,866,0,866,2019.csv,2019,0.0,1.0
28970,Die Frau meiner Träume,864,0,864,2016.csv,2016,0.0,1.0
28971,"Electric Boogaloo: The Wild, Untold Story of Cannon Films",864,0,864,2015.csv,2015,0.0,1.0
28972,Trick or Treat,859,0,859,2019.csv,2019,0.0,1.0
28973,Pax Americana and the Weaponization of Space,857,0,857,2010.csv,2010,0.0,1.0
28974,"Kleitas, mates un meitas",857,0,857,2010.csv,2010,0.0,1.0
28975,Regreso a Coronel Vallejos: La traición de Manuel Puig,857,0,857,2018.csv,2018,0.0,1.0
28976,Pandas: The Journey Home,856,0,856,2015.csv,2015,0.0,1.0
28977,Shineless,855,0,855,2018.csv,2018,0.0,1.0
28978,Actriz,854,0,854,2017.csv,2017,0.0,1.0
28979,Socrates,853,0,853,2020.csv,2020,0.0,1.0
28980,45365,853,853,0,2010.csv,2010,1.0,0.0
28981,The Last Day,853,0,853,2017.csv,2017,0.0,1.0
28982,Kader Postasi,851,0,851,2019.csv,2019,0.0,1.0
28983,Sam Klemke's Time Machine,851,0,851,2016.csv,2016,0.0,1.0
28984,Officer Downe,850,850,0,2016.csv,2016,1.0,0.0
28985,Martinez de Hoz,849,0,849,2017.csv,2017,0.0,1.0
28986,"Ensemble, nous allons vivre une très, très grande histoire d'amour...",848,0,848,2010.csv,2010,0.0,1.0
28987,Holy Beasts,847,0,847,2019.csv,2019,0.0,1.0
28988,Unthinkable 2012 Re-release,847,0,847,2012.csv,2012,0.0,1.0
28989,Stealing Chaplin,845,0,845,2020.csv,2020,0.0,1.0
28990,Uno Más,845,0,845,2020.csv,2020,0.0,1.0
28991,"Jia Zhangke, A Guy from Fenyang",842,0,842,2017.csv,2017,0.0,1.0
28992,Tango Suomi,838,0,838,2017.csv,2017,0.0,1.0
28993,Catch and Release 2016 Re-release,838,0,838,2016.csv,2016,0.0,1.0
28994,Taking Stock,837,0,837,2016.csv,2016,0.0,1.0
28995,Attack on Titan: The Wings of Freedom 2018 Re-release,837,0,837,2018.csv,2018,0.0,1.0
28996,A Wolf at the Door 2015 Re-release,836,0,836,2015.csv,2015,0.0,1.0
28997,Newen,834,0,834,2016.csv,2016,0.0,1.0
28998,Hálito Azul,832,0,832,2019.csv,2019,0.0,1.0
28999,Abandoned,832,832,0,2011.csv,2011,1.0,0.0
29000,Onyx,831,0,831,2016.csv,2016,0.0,1.0
29001,New York Shadows,828,0,828,2013.csv,2013,0.0,1.0
29002,Hiroku: Defenders of Gaia,824,0,824,2014.csv,2014,0.0,1.0
29003,Puppylove,824,0,824,2014.csv,2014,0.0,1.0
29004,Automation,824,0,824,2021.csv,2021,0.0,1.0
29005,Live Wire 2010 Re-release,823,0,823,2010.csv,2010,0.0,1.0
29006,Fausto También,823,0,823,2016.csv,2016,0.0,1.0
29007,My Friend Fela,822,0,822,2020.csv,2020,0.0,1.0
29008,Invasion 2015 Re-release,821,0,821,2015.csv,2015,0.0,1.0
29009,R U There,821,0,821,2010.csv,2010,0.0,1.0
29010,"I, Olga Hepnarova 2019 Re-release",821,0,821,2019.csv,2019,0.0,1.0
29011,El sable,820,0,820,2016.csv,2016,0.0,1.0
29012,Vermelho Russo,817,0,817,2018.csv,2018,0.0,1.0
29013,Shikkari Shambhu,816,0,816,2018.csv,2018,0.0,1.0
29014,Deva,815,0,815,2019.csv,2019,0.0,1.0
29015,Nana 2016 Re-release,814,0,814,2016.csv,2016,0.0,1.0
29016,TVTV: Video Revolutionaries,812,812,0,2018.csv,2018,1.0,0.0
29017,Wild Session,810,0,810,2019.csv,2019,0.0,1.0
29018,Before the Devil Knows You're Dead 2012 Re-release,809,0,809,2012.csv,2012,0.0,1.0
29019,María y los niños pobres,807,0,807,2010.csv,2010,0.0,1.0
29020,Jurassic World 2020 Re-release,807,0,807,2020.csv,2020,0.0,1.0
29021,Jackpot 2014 Re-release,806,806,0,2014.csv,2014,1.0,0.0
29022,"I, Don Giovanni 2012 Re-release",805,0,805,2012.csv,2012,0.0,1.0
29023,Presagio,804,0,804,2018.csv,2018,0.0,1.0
29024,"Amazonas, el camino de la cocaína",803,0,803,2015.csv,2015,0.0,1.0
29025,Spring Interlude,803,0,803,2019.csv,2019,0.0,1.0
29026,#Starvecrow,795,0,795,2017.csv,2017,0.0,1.0
29027,Orquesta El Tambo. La música en buenas manos,795,0,795,2016.csv,2016,0.0,1.0
29028,Nosilatiaj. La Belleza,793,0,793,2012.csv,2012,0.0,1.0
29029,K-Shop,793,0,793,2016.csv,2016,0.0,1.0
29030,Passenger from San Francisco,793,0,793,2019.csv,2019,0.0,1.0
29031,Breathless 2018 Re-release,792,0,792,2018.csv,2018,0.0,1.0
29032,The Untold Story,790,790,0,2019.csv,2019,1.0,0.0
29033,Os Dois Irmãos,788,0,788,2019.csv,2019,0.0,1.0
29034,Central to the Soul,787,0,787,2019.csv,2019,0.0,1.0
29035,Coração Negro,786,0,786,2019.csv,2019,0.0,1.0
29036,Fucilateli - Commissione d'Inchiesta su Caporetto 1918 - 19,786,0,786,2019.csv,2019,0.0,1.0
29037,Blind Alley,786,0,786,2013.csv,2013,0.0,1.0
29038,Argentina Animada,784,0,784,2018.csv,2018,0.0,1.0
29039,Immigrants (L.A. Dolce Vita) 2011 Re-release,783,0,783,2011.csv,2011,0.0,1.0
29040,Gerhard Richter Painting 2016 Re-release,781,0,781,2016.csv,2016,0.0,1.0
29041,Libertad es una palabra grande,779,0,779,2019.csv,2019,0.0,1.0
29042,Vsetko co mam rad,779,0,779,2016.csv,2016,0.0,1.0
29043,Happy Feet Two 2020 Re-release,779,0,779,2020.csv,2020,0.0,1.0
29044,Atrevidas,775,0,775,2018.csv,2018,0.0,1.0
29045,Alif,775,0,775,2017.csv,2017,0.0,1.0
29046,La Laguna,774,0,774,2015.csv,2015,0.0,1.0
29047,Ferhat ile Sirin,772,0,772,2019.csv,2019,0.0,1.0
29048,Microphone,772,0,772,2011.csv,2011,0.0,1.0
29049,Hombres Solos,770,0,770,2016.csv,2016,0.0,1.0
29050,Golmaal Again 2020 Re-release,769,0,769,2020.csv,2020,0.0,1.0
29051,Human Surge,758,0,758,2017.csv,2017,0.0,1.0
29052,Rasikkum Seemane,758,0,758,2010.csv,2010,0.0,1.0
29053,The Shepherd,754,0,754,2020.csv,2020,0.0,1.0
29054,Big Fat Gypsy Gangster,753,0,753,2011.csv,2011,0.0,1.0
29055,Ellos te eligen,751,0,751,2015.csv,2015,0.0,1.0
29056,Majokko shimai no Yoyo to Nene,751,0,751,2014.csv,2014,0.0,1.0
29057,M&M: The Mall The Merrier,750,0,750,2020.csv,2020,0.0,1.0
29058,Quatro,750,0,750,2016.csv,2016,0.0,1.0
29059,The River,748,0,748,2019.csv,2019,0.0,1.0
29060,Wings,746,0,746,2016.csv,2016,0.0,1.0
29061,Tad: The Lost Explorer 2017 Re-release,746,0,746,2017.csv,2017,0.0,1.0
29062,A Seat at the Table,745,0,745,2020.csv,2020,0.0,1.0
29063,Motley's Law,739,0,739,2016.csv,2016,0.0,1.0
29064,Neseika,738,0,738,2020.csv,2020,0.0,1.0
29065,Abrakadabra,737,0,737,2019.csv,2019,0.0,1.0
29066,The Matrix Revolutions 2019 Re-release,733,0,733,2019.csv,2019,0.0,1.0
29067,No Viajaré Escondida,733,0,733,2018.csv,2018,0.0,1.0
29068,Mujer medicina,732,0,732,2019.csv,2019,0.0,1.0
29069,Astrogauchos,730,0,730,2019.csv,2019,0.0,1.0
29070,Tales from Kars,730,0,730,2011.csv,2011,0.0,1.0
29071,Lantéc Chaná,729,0,729,2017.csv,2017,0.0,1.0
29072,Alunizar,729,0,729,2015.csv,2015,0.0,1.0
29073,Parcours d'amour,727,0,727,2015.csv,2015,0.0,1.0
29074,Dwae-ji-ui wang 2013 Re-release,727,0,727,2013.csv,2013,0.0,1.0
29075,Pelle Politibil går i vannet 2011 Re-release,726,0,726,2011.csv,2011,0.0,1.0
29076,Aux,725,0,725,2017.csv,2017,0.0,1.0
29077,It's All So Quiet 2015 Re-release,724,724,0,2015.csv,2015,1.0,0.0
29078,Daybreakers 2011 Re-release,724,0,724,2011.csv,2011,0.0,1.0
29079,Despicable Me 3 2020 Re-release,722,0,722,2020.csv,2020,0.0,1.0
29080,Rubb Rakha,722,0,722,2018.csv,2018,0.0,1.0
29081,Alegrías de Cádiz,720,0,720,2014.csv,2014,0.0,1.0
29082,Konstruktion Argentina,718,0,718,2018.csv,2018,0.0,1.0
29083,Vadio - I Am Not a Poet,718,0,718,2019.csv,2019,0.0,1.0
29084,Jubilee 2018 Re-release,718,0,718,2018.csv,2018,0.0,1.0
29085,Breakdown,713,0,713,2016.csv,2016,0.0,1.0
29086,Home for the Weekend 2016 Re-release,713,0,713,2016.csv,2016,0.0,1.0
29087,A Girl Like Grace,713,713,0,2016.csv,2016,1.0,0.0
29088,Viaje,712,0,712,2016.csv,2016,0.0,1.0
29089,Anatolian Trip,711,0,711,2019.csv,2019,0.0,1.0
29090,La construcción del enemigo,710,0,710,2016.csv,2016,0.0,1.0
29091,Dream Big: Engineering Our World,708,0,708,2017.csv,2017,0.0,1.0
29092,"Putos peronistas, cumbia del sentimiento",707,0,707,2012.csv,2012,0.0,1.0
29093,Redneck Carnage,706,706,0,2011.csv,2011,1.0,0.0
29094,Aatishbaazi Ishq,705,0,705,2016.csv,2016,0.0,1.0
29095,Eastern Promises 2010 Re-release,705,0,705,2010.csv,2010,0.0,1.0
29096,"Cinema, mon amour",704,0,704,2016.csv,2016,0.0,1.0
29097,Recetas para microondas,702,0,702,2018.csv,2018,0.0,1.0
29098,Today Match at 3,702,0,702,2017.csv,2017,0.0,1.0
29099,Las catedrales del vino,701,0,701,2011.csv,2011,0.0,1.0
29100,Until You Untie Me,701,0,701,2018.csv,2018,0.0,1.0
29101,The Loving Story,700,700,0,2012.csv,2012,1.0,0.0
29102,Rodencia y el Diente de la Princesa 2017 Re-release,700,0,700,2017.csv,2017,0.0,1.0
29103,Mi último fracaso,700,0,700,2017.csv,2017,0.0,1.0
29104,Lady Karuizawa,699,0,699,2020.csv,2020,0.0,1.0
29105,It's Hard Being Loved by Jerks 2015 Re-release,697,697,0,2015.csv,2015,1.0,0.0
29106,"I'm the Same, I'm an Other",697,0,697,2013.csv,2013,0.0,1.0
29107,Back Held Hands,696,0,696,2019.csv,2019,0.0,1.0
29108,Lucy en el infierno,694,0,694,2018.csv,2018,0.0,1.0
29109,The Secret Life of Pets 2020 Re-release,694,0,694,2020.csv,2020,0.0,1.0
29110,Sator,693,0,693,2020.csv,2020,0.0,1.0
29111,The Dig,693,0,693,2021.csv,2021,0.0,1.0
29112,"Mothers, daughters & other issues",689,0,689,2018.csv,2018,0.0,1.0
29113,Bitch,688,0,688,2017.csv,2017,0.0,1.0
29114,The Death of J.P. Cuenca,687,0,687,2016.csv,2016,0.0,1.0
29115,Sugartown - for a fistful of votes,687,0,687,2019.csv,2019,0.0,1.0
29116,The Portal,685,0,685,2019.csv,2019,0.0,1.0
29117,Fidelity 2016 Re-release,685,0,685,2016.csv,2016,0.0,1.0
29118,Run with the Hunted,682,0,682,2021.csv,2021,0.0,1.0
29119,If the Seed Doesn't Die,681,0,681,2011.csv,2011,0.0,1.0
29120,Upa! 2,681,0,681,2017.csv,2017,0.0,1.0
29121,Lupo,679,0,679,2019.csv,2019,0.0,1.0
29122,El Peor Hombre del Mundo,677,0,677,2017.csv,2017,0.0,1.0
29123,Scream of the Banshee,677,0,677,2011.csv,2011,0.0,1.0
29124,Extramuros,674,0,674,2017.csv,2017,0.0,1.0
29125,Fragmentos rebelados,674,0,674,2018.csv,2018,0.0,1.0
29126,The Long Excuse 2018 Re-release,672,0,672,2018.csv,2018,0.0,1.0
29127,Eden Lake 2011 Re-release,672,0,672,2011.csv,2011,0.0,1.0
29128,Noma,671,0,671,2016.csv,2016,0.0,1.0
29129,Family Games,671,0,671,2018.csv,2018,0.0,1.0
29130,Evil Under the Sun 2018 Re-release,670,0,670,2018.csv,2018,0.0,1.0
29131,Hot Hot Hot,669,0,669,2011.csv,2011,0.0,1.0
29132,Four Lions 2013 Re-release,669,0,669,2013.csv,2013,0.0,1.0
29133,Keep Frozen,668,0,668,2016.csv,2016,0.0,1.0
29134,One Tree Three Lives,668,0,668,2012.csv,2012,0.0,1.0
29135,Agárrese como pueda,666,0,666,2016.csv,2016,0.0,1.0
29136,Fellini Satyricon 2020 Re-release,666,0,666,2020.csv,2020,0.0,1.0
29137,Postman,666,0,666,2019.csv,2019,0.0,1.0
29138,Syrup,663,663,0,2013.csv,2013,1.0,0.0
29139,The Prince,663,0,663,2020.csv,2020,0.0,1.0
29140,Não Consegues Criar O Mundo Duas Vezes,661,0,661,2018.csv,2018,0.0,1.0
29141,The Children of Huang Shi 2012 Re-release,658,0,658,2012.csv,2012,0.0,1.0
29142,Here in Lisbon,658,0,658,2016.csv,2016,0.0,1.0
29143,My Life as a Zucchini 2018 Re-release,658,0,658,2018.csv,2018,0.0,1.0
29144,Up Up & Up,658,0,658,2020.csv,2020,0.0,1.0
29145,Balls of Fury 2011 Re-release,655,0,655,2011.csv,2011,0.0,1.0
29146,Peppa Pig: Festival of Fun,654,0,654,2020.csv,2020,0.0,1.0
29147,Tarla,654,0,654,2017.csv,2017,0.0,1.0
29148,Kiki's Delivery Service Studio Ghibli Fest 2020,654,0,654,2020.csv,2020,0.0,1.0
29149,Borderland 2011 Re-release,651,0,651,2011.csv,2011,0.0,1.0
29150,King Kong 2016 Re-release,651,0,651,2016.csv,2016,0.0,1.0
29151,Slide,648,0,648,2015.csv,2015,0.0,1.0
29152,Saru Lock the Movie 2011 Re-release,647,0,647,2011.csv,2011,0.0,1.0
29153,Nature Calls,646,646,0,2012.csv,2012,1.0,0.0
29154,Kavi Uddheshichathu..?,646,0,646,2016.csv,2016,0.0,1.0
29155,The Box 2011 Re-release,645,0,645,2011.csv,2011,0.0,1.0
29156,Un pueblo hecho canción,645,0,645,2017.csv,2017,0.0,1.0
29157,Pescadores 2017 Re-release,645,0,645,2017.csv,2017,0.0,1.0
29158,Bondoc,642,0,642,2016.csv,2016,0.0,1.0
29159,Para Além da Memória,641,0,641,2020.csv,2020,0.0,1.0
29160,Seaburners,640,0,640,2014.csv,2014,0.0,1.0
29161,My Own Love Song 2012 Re-release,639,0,639,2012.csv,2012,0.0,1.0
29162,OdysSea,638,0,638,2013.csv,2013,0.0,1.0
29163,El gran circo pobre de Timoteo,637,0,637,2017.csv,2017,0.0,1.0
29164,I Come with the Rain 2013 Re-release,637,0,637,2013.csv,2013,0.0,1.0
29165,Un hombre que no supo adónde ir,637,0,637,2016.csv,2016,0.0,1.0
29166,Scent of My Daughter,635,0,635,2020.csv,2020,0.0,1.0
29167,The Prosecutor the Defender the Father and His Son,635,0,635,2016.csv,2016,0.0,1.0
29168,Alan Hinkes: The First Briton To Climb The World's Highest Mountains,635,0,635,2018.csv,2018,0.0,1.0
29169,Natsamrat,633,0,633,2018.csv,2018,0.0,1.0
29170,White White World,633,0,633,2011.csv,2011,0.0,1.0
29171,Requiem Pour Une Tueuse - Requiem for A Killer 2012 Re-release,632,0,632,2012.csv,2012,0.0,1.0
29172,Nine Days of One Year,630,0,630,2016.csv,2016,0.0,1.0
29173,"Chubut, libertad y tierra",628,0,628,2019.csv,2019,0.0,1.0
29174,Chasing Trane: The John Coltrane Documentary 2019 Re-release,626,0,626,2019.csv,2019,0.0,1.0
29175,Citizen Gangster,625,625,0,2012.csv,2012,1.0,0.0
29176,Un Gauchito Gil,625,0,625,2019.csv,2019,0.0,1.0
29177,Oozham,624,0,624,2016.csv,2016,0.0,1.0
29178,Geçmis,623,0,623,2017.csv,2017,0.0,1.0
29179,Guilty Men,622,0,622,2016.csv,2016,0.0,1.0
29180,Enakkul Oruvan,621,0,621,2015.csv,2015,0.0,1.0
29181,Kalpten Gerdanlik,621,0,621,2019.csv,2019,0.0,1.0
29182,Money Plane,618,0,618,2021.csv,2021,0.0,1.0
29183,Una canción,616,0,616,2012.csv,2012,0.0,1.0
29184,Jet Trash,616,0,616,2016.csv,2016,0.0,1.0
29185,My Way or the Highway,615,0,615,2018.csv,2018,0.0,1.0
29186,La Vieja,613,0,613,2016.csv,2016,0.0,1.0
29187,Scruff: El Sueno De Una Noche De Verano,612,0,612,2011.csv,2011,0.0,1.0
29188,The Athlete,611,0,611,2012.csv,2012,0.0,1.0
29189,Don't Look Back 2012 Re-release,610,0,610,2012.csv,2012,0.0,1.0
29190,The Land of the Enlightened,609,0,609,2016.csv,2016,0.0,1.0
29191,Última carta desde la revolución,606,0,606,2016.csv,2016,0.0,1.0
29192,The Big Red One 2010 Re-release,603,0,603,2010.csv,2010,0.0,1.0
29193,El hombre nuevo,602,0,602,2015.csv,2015,0.0,1.0
29194,That Click,602,0,602,2020.csv,2020,0.0,1.0
29195,Gottfried Helnwein and the Dreaming Child,601,601,0,2012.csv,2012,1.0,0.0
29196,Eva,601,0,601,2010.csv,2010,0.0,1.0
29197,"Comediants, amb el sol a la maleta",600,0,600,2013.csv,2013,0.0,1.0
29198,On Football,600,0,600,2016.csv,2016,0.0,1.0
29199,Hellboy 2020 Re-release,599,0,599,2020.csv,2020,0.0,1.0
29200,The Myth of the American Sleepover 2012 Re-release,597,0,597,2012.csv,2012,0.0,1.0
29201,Los ganadores,594,0,594,2017.csv,2017,0.0,1.0
29202,Damascena,594,0,594,2020.csv,2020,0.0,1.0
29203,Shake Hands with the Devil,594,594,0,2010.csv,2010,1.0,0.0
29204,Mayurakshi,590,0,590,2018.csv,2018,0.0,1.0
29205,Leave It on the Floor,590,0,590,2012.csv,2012,0.0,1.0
29206,Theatre of War,586,0,586,2018.csv,2018,0.0,1.0
29207,Lay the Favorite 2015 Re-release,585,0,585,2015.csv,2015,0.0,1.0
29208,Motherhood 2011 Re-release,582,0,582,2011.csv,2011,0.0,1.0
29209,Louyre: This Our Still Life,582,0,582,2011.csv,2011,0.0,1.0
29210,The Whisper of the Jaguar,582,0,582,2019.csv,2019,0.0,1.0
29211,First Signal,580,580,0,2021.csv,2021,1.0,0.0
29212,Big Trouble in Little China 2020 Re-release,577,0,577,2020.csv,2020,0.0,1.0
29213,The Phantom of Liberty 2020 Re-release,577,0,577,2020.csv,2020,0.0,1.0
29214,Anagramas,577,0,577,2017.csv,2017,0.0,1.0
29215,Diez menos,574,0,574,2018.csv,2018,0.0,1.0
29216,Pierrot le Fou 2018 Re-release,573,0,573,2018.csv,2018,0.0,1.0
29217,A Good Day to Die,573,573,0,2011.csv,2011,1.0,0.0
29218,Best Laid Plans,573,0,573,2012.csv,2012,0.0,1.0
29219,Memorias De Un Conspirador,573,0,573,2013.csv,2013,0.0,1.0
29220,Ditches,570,0,570,2017.csv,2017,0.0,1.0
29221,Kern,569,0,569,2013.csv,2013,0.0,1.0
29222,Medziu paslaptis,568,0,568,2015.csv,2015,0.0,1.0
29223,13th,566,0,566,2016.csv,2016,0.0,1.0
29224,La protagonista,560,0,560,2020.csv,2020,0.0,1.0
29225,The Pit,560,560,0,2016.csv,2016,1.0,0.0
29226,La jungla interior,559,0,559,2014.csv,2014,0.0,1.0
29227,At the Wrong Place,559,0,559,2013.csv,2013,0.0,1.0
29228,What's Going On?,558,0,558,2010.csv,2010,0.0,1.0
29229,Episode 3: 'Enjoy Poverty' 2010 Re-release,557,0,557,2010.csv,2010,0.0,1.0
29230,"Wednesday, May 9",557,0,557,2016.csv,2016,0.0,1.0
29231,The NeverEnding Story 2020 Re-release,554,0,554,2020.csv,2020,0.0,1.0
29232,Los hipócritas,552,0,552,2019.csv,2019,0.0,1.0
29233,Street Leagues,552,0,552,2020.csv,2020,0.0,1.0
29234,Antonio One Two Three,552,0,552,2019.csv,2019,0.0,1.0
29235,Clementina,552,0,552,2019.csv,2019,0.0,1.0
29236,Beginner,551,0,551,2017.csv,2017,0.0,1.0
29237,Traitor 2011 Re-release,550,0,550,2011.csv,2011,0.0,1.0
29238,Saving Dreams,547,0,547,2017.csv,2017,0.0,1.0
29239,Palace for the People,545,0,545,2019.csv,2019,0.0,1.0
29240,Ne var?,544,0,544,2018.csv,2018,0.0,1.0
29241,Parade,543,0,543,2020.csv,2020,0.0,1.0
29242,Brahmotsavam,541,0,541,2016.csv,2016,0.0,1.0
29243,Open Wound,539,0,539,2017.csv,2017,0.0,1.0
29244,Kosice hidroespacial,536,0,536,2018.csv,2018,0.0,1.0
29245,Food on the Go (E il cibo va),536,0,536,2018.csv,2018,0.0,1.0
29246,Salero,534,0,534,2017.csv,2017,0.0,1.0
29247,Murtaza,532,0,532,2018.csv,2018,0.0,1.0
29248,Finding Gaston 2015 Re-release,532,0,532,2015.csv,2015,0.0,1.0
29249,Foam at the Mouth,532,0,532,2019.csv,2019,0.0,1.0
29250,Melle,529,0,529,2017.csv,2017,0.0,1.0
29251,Rafiki 2010 Re-release,528,0,528,2010.csv,2010,0.0,1.0
29252,Higher Power,528,528,0,2018.csv,2018,1.0,0.0
29253,Greater 2020 Re-release,527,527,0,2020.csv,2020,1.0,0.0
29254,Meeting Evil,525,525,0,2012.csv,2012,1.0,0.0
29255,Murales. El principio de las cosas,524,0,524,2016.csv,2016,0.0,1.0
29256,Cartas a María,523,0,523,2015.csv,2015,0.0,1.0
29257,Aloys,523,0,523,2016.csv,2016,0.0,1.0
29258,Invasion,522,0,522,2013.csv,2013,0.0,1.0
29259,68 Kill,522,0,522,2019.csv,2019,0.0,1.0
29260,Inner Ghosts,522,0,522,2020.csv,2020,0.0,1.0
29261,Diallelos,519,0,519,2017.csv,2017,0.0,1.0
29262,Argus Montenegro & A Instabilidade Do Tempo Forte,516,0,516,2012.csv,2012,0.0,1.0
29263,Jess & James,514,0,514,2017.csv,2017,0.0,1.0
29264,Bir Sey Degilim,513,0,513,2016.csv,2016,0.0,1.0
29265,Callcenter,513,0,513,2019.csv,2019,0.0,1.0
29266,Iruttu Araiyil Murattu Kuthu,512,0,512,2018.csv,2018,0.0,1.0
29267,Hand Gestures,512,0,512,2016.csv,2016,0.0,1.0
29268,At Any Price 2016 Re-release,510,0,510,2016.csv,2016,0.0,1.0
29269,The 11th Hour,510,0,510,2015.csv,2015,0.0,1.0
29270,Life On Deniston Plateau,509,0,509,2021.csv,2021,0.0,1.0
29271,Aappan Pher Milange,509,0,509,2012.csv,2012,0.0,1.0
29272,Devi(L),508,0,508,2016.csv,2016,0.0,1.0
29273,Eastern Drift,504,0,504,2011.csv,2011,0.0,1.0
29274,In Your Name,504,0,504,2010.csv,2010,0.0,1.0
29275,Scream 2 2020 Re-release,503,0,503,2020.csv,2020,0.0,1.0
29276,Las facultades,502,0,502,2019.csv,2019,0.0,1.0
29277,Hasret Bitti,501,0,501,2016.csv,2016,0.0,1.0
29278,Caviar,501,0,501,2020.csv,2020,0.0,1.0
29279,Happy Feet 2020 Re-release,500,0,500,2020.csv,2020,0.0,1.0
29280,Pushpaka Vimana,499,0,499,2017.csv,2017,0.0,1.0
29281,"7, 8, 9, Boniface",499,0,499,2012.csv,2012,0.0,1.0
29282,Princesita,499,0,499,2018.csv,2018,0.0,1.0
29283,"Bien de Familia, una película musical",497,0,497,2016.csv,2016,0.0,1.0
29284,La casa en la playa,496,0,496,2019.csv,2019,0.0,1.0
29285,We Are Poets,493,0,493,2012.csv,2012,0.0,1.0
29286,Beyond The Visible - Hilma af Klint,493,0,493,2020.csv,2020,0.0,1.0
29287,En peligro,493,0,493,2018.csv,2018,0.0,1.0
29288,Dear Enemy,491,0,491,2012.csv,2012,0.0,1.0
29289,Chloe & Theo,490,0,490,2016.csv,2016,0.0,1.0
29290,Chaco,489,0,489,2018.csv,2018,0.0,1.0
29291,What I Love the Most,488,0,488,2011.csv,2011,0.0,1.0
29292,Make Your Life a Masterpiece in Progress,487,0,487,2014.csv,2014,0.0,1.0
29293,Biagio,485,0,485,2016.csv,2016,0.0,1.0
29294,Calabria,485,0,485,2017.csv,2017,0.0,1.0
29295,Magie der Moore,485,0,485,2015.csv,2015,0.0,1.0
29296,Alva,483,0,483,2020.csv,2020,0.0,1.0
29297,Robert Doisneau: Through the Lens,482,0,482,2018.csv,2018,0.0,1.0
29298,The Carer 2018 Re-release,481,0,481,2018.csv,2018,0.0,1.0
29299,Great Kills Road,481,0,481,2010.csv,2010,0.0,1.0
29300,Rasgar o Passado,480,0,480,2016.csv,2016,0.0,1.0
29301,"La Feliz, continuidades de la violencia",480,0,480,2019.csv,2019,0.0,1.0
29302,Antonio Gil,479,0,479,2019.csv,2019,0.0,1.0
29303,La mirada del colibrí,477,0,477,2016.csv,2016,0.0,1.0
29304,Tótem 2014 Re-release,477,0,477,2014.csv,2014,0.0,1.0
29305,Cinema Paradiso 2012 Re-release,476,0,476,2012.csv,2012,0.0,1.0
29306,Triumph of the Wall,476,476,0,2013.csv,2013,1.0,0.0
29307,The Man Who Fell to Earth 2020 Re-release,474,0,474,2020.csv,2020,0.0,1.0
29308,The Exorcist 2020 Re-release,473,0,473,2020.csv,2020,0.0,1.0
29309,Steel Mask Versus Blue Abyss,472,0,472,2017.csv,2017,0.0,1.0
29310,Zurich 2015 Re-release,471,0,471,2015.csv,2015,0.0,1.0
29311,The Fireflies Are Gone 2020 Re-release,468,0,468,2020.csv,2020,0.0,1.0
29312,The Pretty Ones,468,0,468,2017.csv,2017,0.0,1.0
29313,Piggy,467,0,467,2012.csv,2012,0.0,1.0
29314,Anguish,467,0,467,2016.csv,2016,0.0,1.0
29315,Angelo,464,0,464,2019.csv,2019,0.0,1.0
29316,The Kamagasaki Cauldron War,463,0,463,2019.csv,2019,0.0,1.0
29317,Return to Ithaca 2017 Re-release,463,0,463,2017.csv,2017,0.0,1.0
29318,Sdayotsya dom so vsemi neudobstvami,462,0,462,2016.csv,2016,0.0,1.0
29319,Gesto,462,0,462,2016.csv,2016,0.0,1.0
29320,Unbroken,461,0,461,2020.csv,2020,0.0,1.0
29321,Legko li by molodym?,460,0,460,2011.csv,2011,0.0,1.0
29322,The Takatsu River,458,0,458,2020.csv,2020,0.0,1.0
29323,The Gleaners & I 2018 Re-release,458,0,458,2018.csv,2018,0.0,1.0
29324,Bayrak 1,457,0,457,2019.csv,2019,0.0,1.0
29325,How to Make a Dead Man Float,456,0,456,2018.csv,2018,0.0,1.0
29326,Crowhurst,455,0,455,2018.csv,2018,0.0,1.0
29327,Ne Pozabi,455,0,455,2015.csv,2015,0.0,1.0
29328,Green is Gold,455,455,0,2016.csv,2016,1.0,0.0
29329,Río Mekong,453,0,453,2018.csv,2018,0.0,1.0
29330,The Big Sleep 2012 Re-release,451,0,451,2012.csv,2012,0.0,1.0
29331,The Judgment 2016 Re-release,448,0,448,2016.csv,2016,0.0,1.0
29332,Mean Girls 2020 Re-release,448,0,448,2020.csv,2020,0.0,1.0
29333,Rogue One: A Star Wars Story 2020 Re-release,447,0,447,2020.csv,2020,0.0,1.0
29334,Simmba 2020 Re-release,447,0,447,2020.csv,2020,0.0,1.0
29335,Dracula 2020 Re-release,446,0,446,2020.csv,2020,0.0,1.0
29336,Alias Yineth,446,0,446,2018.csv,2018,0.0,1.0
29337,Song for a Raggy Boy 2010 Re-release,445,0,445,2010.csv,2010,0.0,1.0
29338,Békeidö,445,0,445,2021.csv,2021,0.0,1.0
29339,Pili,441,0,441,2018.csv,2018,0.0,1.0
29340,Swans,441,0,441,2012.csv,2012,0.0,1.0
29341,Juego de espías (Canfranc-Zaragoza-San Sebastián),441,0,441,2013.csv,2013,0.0,1.0
29342,Roads in February,435,0,435,2019.csv,2019,0.0,1.0
29343,My Name Is Lenny,435,0,435,2017.csv,2017,0.0,1.0
29344,Dark Sea,435,0,435,2014.csv,2014,0.0,1.0
29345,The Heritage of Love,434,0,434,2016.csv,2016,0.0,1.0
29346,Mariphasa,434,0,434,2018.csv,2018,0.0,1.0
29347,Eden Is West 2012 Re-release,433,0,433,2012.csv,2012,0.0,1.0
29348,The Voice Makes a Miracle,432,0,432,2012.csv,2012,0.0,1.0
29349,Daybreak,432,0,432,2018.csv,2018,0.0,1.0
29350,"Kollontai, apuntes de resistencia",431,0,431,2019.csv,2019,0.0,1.0
29351,Crackerjack 2020 Re-release,431,0,431,2020.csv,2020,0.0,1.0
29352,Injured Partridge,428,0,428,2019.csv,2019,0.0,1.0
29353,Mudmen,427,0,427,2017.csv,2017,0.0,1.0
29354,Trash 2011 Re-release,426,0,426,2011.csv,2011,0.0,1.0
29355,Exilio de Malvinas,426,0,426,2016.csv,2016,0.0,1.0
29356,Studniówk@,425,0,425,2018.csv,2018,0.0,1.0
29357,The Last Wave 2020 Re-release,425,0,425,2020.csv,2020,0.0,1.0
29358,Justine,425,0,425,2017.csv,2017,0.0,1.0
29359,Bronces en Isla Verde,424,0,424,2016.csv,2016,0.0,1.0
29360,Sin Dejar Rastro,424,0,424,2017.csv,2017,0.0,1.0
29361,Het Verloren Vriendje En Andere Verhaaltjes,423,0,423,2013.csv,2013,0.0,1.0
29362,Amanecer en mi tierra,420,0,420,2019.csv,2019,0.0,1.0
29363,The Wolf Man 2020 Re-release,420,0,420,2020.csv,2020,0.0,1.0
29364,El retorno de Don Luis,419,0,419,2016.csv,2016,0.0,1.0
29365,Asmodexia,418,0,418,2014.csv,2014,0.0,1.0
29366,Nublu,418,0,418,2017.csv,2017,0.0,1.0
29367,Reina de Corazones,417,0,417,2018.csv,2018,0.0,1.0
29368,Kerosin,417,0,417,2020.csv,2020,0.0,1.0
29369,The Lover's Guide,416,0,416,2011.csv,2011,0.0,1.0
29370,A Place in Time,414,0,414,2019.csv,2019,0.0,1.0
29371,"Idomeneo, re di Creta: Wolfgang Amadeus Mozart 2017 Re-release",413,0,413,2017.csv,2017,0.0,1.0
29372,The Summer of Sangaile 2017 Re-release,413,0,413,2017.csv,2017,0.0,1.0
29373,10 Things I Hate About You 2020 Re-release,413,0,413,2020.csv,2020,0.0,1.0
29374,Domingo,411,0,411,2020.csv,2020,0.0,1.0
29375,One More Year,410,0,410,2019.csv,2019,0.0,1.0
29376,A Film Unfinished 2011 Re-release,410,0,410,2011.csv,2011,0.0,1.0
29377,Don't Blink 2018 Re-release,407,0,407,2018.csv,2018,0.0,1.0
29378,Angel Guts: Red Porno,407,0,407,2020.csv,2020,0.0,1.0
29379,Indignados,406,0,406,2013.csv,2013,0.0,1.0
29380,Hôtel des Amériques,406,0,406,2020.csv,2020,0.0,1.0
29381,The Magician 2010 Re-release,406,406,0,2010.csv,2010,1.0,0.0
29382,The Valley of Tears,404,0,404,2013.csv,2013,0.0,1.0
29383,Ahí viene,403,0,403,2018.csv,2018,0.0,1.0
29384,Facing the Wind,403,0,403,2018.csv,2018,0.0,1.0
29385,The House of Wannsee Street,403,0,403,2019.csv,2019,0.0,1.0
29386,San Antonio 2012 Re-release,402,0,402,2012.csv,2012,0.0,1.0
29387,Skinless,400,400,0,2014.csv,2014,1.0,0.0
29388,Tuftland,399,0,399,2018.csv,2018,0.0,1.0
29389,Cinemanovels,398,398,0,2014.csv,2014,1.0,0.0
29390,Chitty Chitty Bang Bang 2020 Re-release,398,0,398,2020.csv,2020,0.0,1.0
29391,"¿Dónde estás, Negro?",397,0,397,2016.csv,2016,0.0,1.0
29392,Amanda Knox,397,0,397,2016.csv,2016,0.0,1.0
29393,El fumigador,394,0,394,2017.csv,2017,0.0,1.0
29394,Viking Siege,393,0,393,2019.csv,2019,0.0,1.0
29395,Heroes for a Semester,393,0,393,2014.csv,2014,0.0,1.0
29396,Ella(s),391,0,391,2010.csv,2010,0.0,1.0
29397,Kirpaan: The Sword of Honour,390,0,390,2014.csv,2014,0.0,1.0
29398,Hora Día Mes,389,0,389,2019.csv,2019,0.0,1.0
29399,Grandes esperanças,387,0,387,2016.csv,2016,0.0,1.0
29400,Bakon Yanayi,386,0,386,2019.csv,2019,0.0,1.0
29401,Monumento,383,0,383,2016.csv,2016,0.0,1.0
29402,Myliu kulka tavo sirdyje,380,0,380,2011.csv,2011,0.0,1.0
29403,Antboy 2016 Re-release,378,0,378,2016.csv,2016,0.0,1.0
29404,Booster,376,0,376,2014.csv,2014,0.0,1.0
29405,School of Rock 2020 Re-release,376,0,376,2020.csv,2020,0.0,1.0
29406,You Only Live Twice 2020 Re-release,375,0,375,2020.csv,2020,0.0,1.0
29407,Gethu,373,0,373,2016.csv,2016,0.0,1.0
29408,The Grandfather 2020 Re-release,370,0,370,2020.csv,2020,0.0,1.0
29409,Time Sweep,369,0,369,2016.csv,2016,0.0,1.0
29410,The Shoelace,368,0,368,2019.csv,2019,0.0,1.0
29411,The Reverend,366,0,366,2012.csv,2012,0.0,1.0
29412,Valami Amerika 2 2011 Re-release,365,0,365,2011.csv,2011,0.0,1.0
29413,Crol,364,0,364,2017.csv,2017,0.0,1.0
29414,Ati y Mindiwa,364,0,364,2016.csv,2016,0.0,1.0
29415,Nueva Mente,363,0,363,2019.csv,2019,0.0,1.0
29416,Dark Night,363,0,363,2017.csv,2017,0.0,1.0
29417,"Monumento, la humanidad detrás del concreto",362,0,362,2016.csv,2016,0.0,1.0
29418,Spaceship Earth,362,0,362,2020.csv,2020,0.0,1.0
29419,Amanecidos,362,0,362,2012.csv,2012,0.0,1.0
29420,The 50 Year Argument,361,0,361,2017.csv,2017,0.0,1.0
29421,Oleg and Strange Arts,361,0,361,2017.csv,2017,0.0,1.0
29422,Travellers,360,0,360,2011.csv,2011,0.0,1.0
29423,Blanco o Negro,360,0,360,2019.csv,2019,0.0,1.0
29424,Fool Moon,357,0,357,2017.csv,2017,0.0,1.0
29425,Voto Que El Alma Pronuncia,357,0,357,2012.csv,2012,0.0,1.0
29426,A Night in the Woods,357,0,357,2012.csv,2012,0.0,1.0
29427,Joenjoy,356,0,356,2010.csv,2010,0.0,1.0
29428,A Deal Is a Deal 2012 Re-release,356,0,356,2012.csv,2012,0.0,1.0
29429,Nezih Bir Film,356,0,356,2018.csv,2018,0.0,1.0
29430,Jeon Woochi 2012 Re-release,355,0,355,2012.csv,2012,0.0,1.0
29431,Booked Out,353,0,353,2012.csv,2012,0.0,1.0
29432,Fulboy,353,0,353,2016.csv,2016,0.0,1.0
29433,The Woman Who Brushed Off Her Tears,349,0,349,2012.csv,2012,0.0,1.0
29434,Andre Rieu's 2020 Maastricht Concert: Happy Together,348,0,348,2020.csv,2020,0.0,1.0
29435,Marubhoomiyile Aana,348,0,348,2016.csv,2016,0.0,1.0
29436,The Martian 2020 Re-release,345,0,345,2015.csv,2015,0.0,1.0
29437,Plastic Planet 2012 Re-release,345,0,345,2012.csv,2012,0.0,1.0
29438,Seven Days Sunday 2011 Re-release,341,0,341,2011.csv,2011,0.0,1.0
29439,Unresolved Sexual Tension 2014 Re-release,341,0,341,2014.csv,2014,0.0,1.0
29440,Wendy and Lucy 2010 Re-release,340,0,340,2010.csv,2010,0.0,1.0
29441,A Matter of Courage,340,0,340,2016.csv,2016,0.0,1.0
29442,El efecto K. El montador de Stalin,340,0,340,2013.csv,2013,0.0,1.0
29443,Upa! An Argentinian Movie 2017 Re-release,339,0,339,2017.csv,2017,0.0,1.0
29444,"Ride, Rise, Roar",338,0,338,2011.csv,2011,0.0,1.0
29445,Headwinds 2014 Re-release,338,0,338,2014.csv,2014,0.0,1.0
29446,Corridor,337,0,337,2011.csv,2011,0.0,1.0
29447,Amy 2020 Re-release,337,0,337,2020.csv,2020,0.0,1.0
29448,Oxigeno Para Vivir,335,0,335,2011.csv,2011,0.0,1.0
29449,Die Krone von Arkus,335,0,335,2016.csv,2016,0.0,1.0
29450,Turnout,333,0,333,2011.csv,2011,0.0,1.0
29451,As Horas Vulgares,333,0,333,2013.csv,2013,0.0,1.0
29452,La luz con el tiempo dentro,330,0,330,2015.csv,2015,0.0,1.0
29453,Calabria 2018 Re-release,329,0,329,2018.csv,2018,0.0,1.0
29454,The Elevator 2013 Re-release,328,0,328,2013.csv,2013,0.0,1.0
29455,"Huemul, la sombra de una especie",328,0,328,2016.csv,2016,0.0,1.0
29456,El cuarto reino. El reino de los plásticos,327,0,327,2019.csv,2019,0.0,1.0
29457,La huella del doctor Ernesto Guevara,327,0,327,2015.csv,2015,0.0,1.0
29458,The Dreamed Ones,327,0,327,2016.csv,2016,0.0,1.0
29459,Unfit: The Psychology of Donald Trump,327,0,327,2020.csv,2020,0.0,1.0
29460,Padres de la plaza: 10 recorridos posibles,325,0,325,2010.csv,2010,0.0,1.0
29461,Singin' in the Rain 2011 Re-release,323,0,323,2011.csv,2011,0.0,1.0
29462,White Lily,319,0,319,2020.csv,2020,0.0,1.0
29463,Crawlspace,318,0,318,2012.csv,2012,0.0,1.0
29464,Birakin çocuk oynasin,318,0,318,2018.csv,2018,0.0,1.0
29465,La piel marcada,318,0,318,2016.csv,2016,0.0,1.0
29466,Bringing Up Baby 2011 Re-release,317,0,317,2011.csv,2011,0.0,1.0
29467,Creature Designers - The Frankenstein Complex,314,0,314,2016.csv,2016,0.0,1.0
29468,Dance of the Penguins,313,0,313,2020.csv,2020,0.0,1.0
29469,Orione,312,0,312,2018.csv,2018,0.0,1.0
29470,Little Mountain Boy 2017 Re-release,311,0,311,2017.csv,2017,0.0,1.0
29471,El teorema de Santiago,310,0,310,2017.csv,2017,0.0,1.0
29472,Breaking Through 2018 Re-release,310,0,310,2018.csv,2018,0.0,1.0
29473,Raging Bull 2020 Re-release,310,0,310,2020.csv,2020,0.0,1.0
29474,100 Streets,309,0,309,2016.csv,2016,0.0,1.0
29475,Nouvelles Aventures De Capelito,306,0,306,2013.csv,2013,0.0,1.0
29476,"Yes, God, Yes",305,0,305,2020.csv,2020,0.0,1.0
29477,Four Days Inside Guantanamo,305,0,305,2011.csv,2011,0.0,1.0
29478,"Familia Cantora, Los Pacheco",305,0,305,2016.csv,2016,0.0,1.0
29479,L'expérience Blocher,303,0,303,2014.csv,2014,0.0,1.0
29480,Dia de Preto,303,0,303,2012.csv,2012,0.0,1.0
29481,Madeleine,301,0,301,2017.csv,2017,0.0,1.0
29482,Esa película que llevo conmigo,299,0,299,2019.csv,2019,0.0,1.0
29483,Sonhámos Um País,297,0,297,2020.csv,2020,0.0,1.0
29484,De Despojos y Costillas,297,0,297,2018.csv,2018,0.0,1.0
29485,LA 92,297,0,297,2017.csv,2017,0.0,1.0
29486,Blood Car,297,0,297,2012.csv,2012,0.0,1.0
29487,Freakens,296,0,296,2020.csv,2020,0.0,1.0
29488,Antiporno,294,0,294,2017.csv,2017,0.0,1.0
29489,The Matrix Revolutions 2020 Re-release,294,0,294,2020.csv,2020,0.0,1.0
29490,One-way to Moscow,294,0,294,2020.csv,2020,0.0,1.0
29491,Billy and the Kids,293,0,293,2019.csv,2019,0.0,1.0
29492,"Yenú Kade, cristiano bueno",292,0,292,2015.csv,2015,0.0,1.0
29493,Instrucciones para la poligamia,292,0,292,2019.csv,2019,0.0,1.0
29494,Vedigundu Pasangge,291,0,291,2018.csv,2018,0.0,1.0
29495,Tempo of a Restless Soul,290,0,290,2010.csv,2010,0.0,1.0
29496,Anna Karenina 2018 Re-release,288,0,288,2018.csv,2018,0.0,1.0
29497,Ming of Harlem: Twenty One Storeys in the Air,287,0,287,2016.csv,2016,0.0,1.0
29498,Universo Pinzás,286,0,286,2019.csv,2019,0.0,1.0
29499,Bengali Beauty,284,0,284,2018.csv,2018,0.0,1.0
29500,Quizás hoy,282,0,282,2017.csv,2017,0.0,1.0
29501,Rekka,282,0,282,2016.csv,2016,0.0,1.0
29502,Psikhi,281,0,281,2016.csv,2016,0.0,1.0
29503,Give Up Tomorrow,280,0,280,2012.csv,2012,0.0,1.0
29504,Clandestine Soul,280,0,280,2019.csv,2019,0.0,1.0
29505,This Is Sanlitun,279,0,279,2013.csv,2013,0.0,1.0
29506,El otro verano,277,0,277,2018.csv,2018,0.0,1.0
29507,Anadolu masallari,277,0,277,2017.csv,2017,0.0,1.0
29508,The Hexecutioners,276,0,276,2016.csv,2016,0.0,1.0
29509,Creature from the Black Lagoon 2020 Re-release,275,0,275,2020.csv,2020,0.0,1.0
29510,Ciudad en rojo,273,0,273,2011.csv,2011,0.0,1.0
29511,The Disappearing Illusionist,273,0,273,2015.csv,2015,0.0,1.0
29512,Ánima,272,0,272,2012.csv,2012,0.0,1.0
29513,A Blast,270,0,270,2016.csv,2016,0.0,1.0
29514,Wet Woman in the Wind,268,0,268,2017.csv,2017,0.0,1.0
29515,"Andrés Carrasco, Ciencia disruptiva",264,0,264,2020.csv,2020,0.0,1.0
29516,The Barefoot Emperor,263,0,263,2020.csv,2020,0.0,1.0
29517,Aumingja Ísland,260,0,260,2016.csv,2016,0.0,1.0
29518,Aaha Kalyanam,260,0,260,2014.csv,2014,0.0,1.0
29519,Tantie,260,0,260,2011.csv,2011,0.0,1.0
29520,The Fire 2016 Re-release,259,0,259,2016.csv,2016,0.0,1.0
29521,Lovers Are Wet,259,0,259,2020.csv,2020,0.0,1.0
29522,Mamy 3,258,0,258,2015.csv,2015,0.0,1.0
29523,Marihuana Sin Chivos,258,0,258,2012.csv,2012,0.0,1.0
29524,El espacio entre los dos,257,0,257,2012.csv,2012,0.0,1.0
29525,Guerrero de Norte y Sur,256,0,256,2019.csv,2019,0.0,1.0
29526,Scarface 2020 Re-release,256,0,256,2020.csv,2020,0.0,1.0
29527,Orhan Pamuk'a söylemeyin Kars'ta çektigim filmde Kar romani da var,256,0,256,2017.csv,2017,0.0,1.0
29528,Arada,254,0,254,2018.csv,2018,0.0,1.0
29529,Existir sin vos. Una noche con Charly García,253,0,253,2016.csv,2016,0.0,1.0
29530,Lappan Chhappan,252,0,252,2017.csv,2017,0.0,1.0
29531,Om Shanti Om 2020 Re-release,249,0,249,2020.csv,2020,0.0,1.0
29532,The Dinosaur Project 2015 Re-release,249,0,249,2015.csv,2015,0.0,1.0
29533,"Mirala, que linda viene...",247,0,247,2018.csv,2018,0.0,1.0
29534,Neds 2012 Re-release,246,0,246,2012.csv,2012,0.0,1.0
29535,Una de nosotras,245,0,245,2019.csv,2019,0.0,1.0
29536,American Desert,244,0,244,2021.csv,2021,0.0,1.0
29537,Native,243,0,243,2018.csv,2018,0.0,1.0
29538,Irina Palm 2010 Re-release,241,0,241,2010.csv,2010,0.0,1.0
29539,Sarrainodu,239,0,239,2016.csv,2016,0.0,1.0
29540,Verge,236,0,236,2017.csv,2017,0.0,1.0
29541,"Les aventures de Philibert, capitaine puceau 2012 Re-release",235,0,235,2012.csv,2012,0.0,1.0
29542,El ruido son la casas,235,0,235,2019.csv,2019,0.0,1.0
29543,Vivir para contarlo,235,0,235,2016.csv,2016,0.0,1.0
29544,¡Viva el palíndromo!,234,0,234,2018.csv,2018,0.0,1.0
29545,Una ciudad de provincia,232,0,232,2018.csv,2018,0.0,1.0
29546,Thinking of Him,232,0,232,2017.csv,2017,0.0,1.0
29547,The Black Power Mixtape 1967-1975 2013 Re-release,231,0,231,2013.csv,2013,0.0,1.0
29548,Future Shock! The Story of 2000AD,231,0,231,2015.csv,2015,0.0,1.0
29549,Eso que llaman amor,231,0,231,2015.csv,2015,0.0,1.0
29550,My Fair Gentleman,230,0,230,2010.csv,2010,0.0,1.0
29551,Pandorica,228,0,228,2016.csv,2016,0.0,1.0
29552,Digo la cordillera. Cuadernos de viaje,227,0,227,2019.csv,2019,0.0,1.0
29553,The Deminer,225,0,225,2018.csv,2018,0.0,1.0
29554,Armed Hands 2013 Re-release,225,0,225,2013.csv,2013,0.0,1.0
29555,Nacido para morir,222,0,222,2016.csv,2016,0.0,1.0
29556,Feeling Lucky,220,0,220,2016.csv,2016,0.0,1.0
29557,King of Crime,220,0,220,2018.csv,2018,0.0,1.0
29558,"Rock, Paper and Scissors",217,0,217,2019.csv,2019,0.0,1.0
29559,Crespo (La continuidad de la memoria),216,0,216,2016.csv,2016,0.0,1.0
29560,Soma #301,215,0,215,2015.csv,2015,0.0,1.0
29561,The Man in the White Suit 2020 Re-release,215,0,215,2020.csv,2020,0.0,1.0
29562,Song of the Sea 2019 Re-release,214,0,214,2019.csv,2019,0.0,1.0
29563,Rúnturinn I,214,0,214,2016.csv,2016,0.0,1.0
29564,Rajaratha,214,0,214,2018.csv,2018,0.0,1.0
29565,The Devil Wears Prada 2020 Re-release,213,0,213,2020.csv,2020,0.0,1.0
29566,La cooperativa,209,0,209,2016.csv,2016,0.0,1.0
29567,Agustos böcekleri ve karincalar,208,0,208,2017.csv,2017,0.0,1.0
29568,Asia,207,0,207,2020.csv,2020,0.0,1.0
29569,A Holy Venetian Family,206,0,206,2016.csv,2016,0.0,1.0
29570,JT LeRoy,205,0,205,2020.csv,2020,0.0,1.0
29571,Dr. Ehrlich's Magic Bullet,205,0,205,2014.csv,2014,0.0,1.0
29572,El hermano de Miguel,204,0,204,2019.csv,2019,0.0,1.0
29573,Diario de viaje por España,204,0,204,2017.csv,2017,0.0,1.0
29574,Strawberry Fields,203,0,203,2012.csv,2012,0.0,1.0
29575,Everything Is Wonderful,202,0,202,2019.csv,2019,0.0,1.0
29576,Barbadozhkiny istorii,201,0,201,2017.csv,2017,0.0,1.0
29577,The Wind Journeys 2012 Re-release,200,0,200,2012.csv,2012,0.0,1.0
29578,The Color of Time,199,0,199,2016.csv,2016,0.0,1.0
29579,La familia chechena,199,0,199,2017.csv,2017,0.0,1.0
29580,The Servant 2020 Re-release,199,0,199,2020.csv,2020,0.0,1.0
29581,The Deep Blue Sea 2020 Re-release,198,0,198,2020.csv,2020,0.0,1.0
29582,St. Trinian's 2011 Re-release,198,0,198,2011.csv,2011,0.0,1.0
29583,Miguel Mirra: Un artesano,195,0,195,2016.csv,2016,0.0,1.0
29584,Äidin toive 2017 Re-release,195,0,195,2017.csv,2017,0.0,1.0
29585,El Llamado del Desierto (L'Appel du Désert),194,0,194,2018.csv,2018,0.0,1.0
29586,Anna's Life 2018 Re-release,194,0,194,2018.csv,2018,0.0,1.0
29587,Réquiem para Laura Martin,194,0,194,2013.csv,2013,0.0,1.0
29588,The Man of the Future,192,0,192,2019.csv,2019,0.0,1.0
29589,Heaven's Gate 2016 Re-release,192,0,192,2016.csv,2016,0.0,1.0
29590,Morocco 2020 Re-release,191,0,191,2020.csv,2020,0.0,1.0
29591,The Endless Film,190,0,190,2018.csv,2018,0.0,1.0
29592,A Faraway Land,189,0,189,2019.csv,2019,0.0,1.0
29593,The Tumbler,186,0,186,2010.csv,2010,0.0,1.0
29594,"Severn, la voix de nos enfants",185,0,185,2011.csv,2011,0.0,1.0
29595,Alright Now,184,0,184,2019.csv,2019,0.0,1.0
29596,Una aventura simple,183,0,183,2018.csv,2018,0.0,1.0
29597,A Poem Is a Naked Person 2016 Re-release,183,0,183,2016.csv,2016,0.0,1.0
29598,"A Woman, a Gun and a Noodle Shop 2013 Re-release",181,0,181,2013.csv,2013,0.0,1.0
29599,Oculto el sol,181,0,181,2016.csv,2016,0.0,1.0
29600,Kem Chho?,181,0,181,2020.csv,2020,0.0,1.0
29601,They Buried,180,0,180,2018.csv,2018,0.0,1.0
29602,Le premier rasta,180,0,180,2013.csv,2013,0.0,1.0
29603,Laz Kit,180,0,180,2020.csv,2020,0.0,1.0
29604,Outcast,179,0,179,2010.csv,2010,0.0,1.0
29605,Udanchhoo,178,0,178,2018.csv,2018,0.0,1.0
29606,Red White & Blue,177,0,177,2011.csv,2011,0.0,1.0
29607,Ugly Duckling,177,0,177,2017.csv,2017,0.0,1.0
29608,Eddie: The Sleepwalking Cannibal 2014 Re-release,174,0,174,2014.csv,2014,0.0,1.0
29609,No Filter 2017 Re-release,174,0,174,2017.csv,2017,0.0,1.0
29610,Umilinta,173,0,173,2011.csv,2011,0.0,1.0
29611,Meimiao de Hunli,173,0,173,2015.csv,2015,0.0,1.0
29612,SEED: The Untold Story 2020 Re-release,172,0,172,2020.csv,2020,0.0,1.0
29613,Nos veremos en el infierno,171,0,171,2013.csv,2013,0.0,1.0
29614,Gastronomic Education,171,0,171,2017.csv,2017,0.0,1.0
29615,Fascinacion,170,0,170,2016.csv,2016,0.0,1.0
29616,Ihtiyar Kurtlar,170,0,170,2019.csv,2019,0.0,1.0
29617,Pescado Rabioso Una utopía incurable,166,0,166,2015.csv,2015,0.0,1.0
29618,Bekçi,166,0,166,2019.csv,2019,0.0,1.0
29619,This Is Not a Movie,165,0,165,2020.csv,2020,0.0,1.0
29620,Book Week,165,0,165,2019.csv,2019,0.0,1.0
29621,Rashtraputra,162,0,162,2018.csv,2018,0.0,1.0
29622,Woman on the Beach 2021 Re-release,160,0,160,2021.csv,2021,0.0,1.0
29623,Vincent Van Gogh: A New Way of Seeing 2019 Re-release,159,0,159,2019.csv,2019,0.0,1.0
29624,Pauline at the Beach,159,0,159,2019.csv,2019,0.0,1.0
29625,Sükut Evi,159,0,159,2018.csv,2018,0.0,1.0
29626,"Aníbal, justo una muerte",159,0,159,2019.csv,2019,0.0,1.0
29627,The Heiress 2020 Re-release,158,0,158,2020.csv,2020,0.0,1.0
29628,A una legua,158,0,158,2019.csv,2019,0.0,1.0
29629,Derechos del hombre,152,0,152,2020.csv,2020,0.0,1.0
29630,Beyond the Horizon,152,0,152,2020.csv,2020,0.0,1.0
29631,Distorted 2021 Re-release,152,0,152,2021.csv,2021,0.0,1.0
29632,Puerto Almanza,150,0,150,2020.csv,2020,0.0,1.0
29633,Umakant Pandey Purush Ya,150,0,150,2019.csv,2019,0.0,1.0
29634,Postas de la memoria,149,0,149,2016.csv,2016,0.0,1.0
29635,"Water and Sugar: Carlo Di Palma, the Colours of Life",149,0,149,2019.csv,2019,0.0,1.0
29636,The house in Arguello,149,0,149,2020.csv,2020,0.0,1.0
29637,Streetdance Family,148,0,148,2016.csv,2016,0.0,1.0
29638,Gangs of Wasseypur 2014 Re-release,148,0,148,2014.csv,2014,0.0,1.0
29639,Imagine: John Lennon 2010 Re-release,148,0,148,2010.csv,2010,0.0,1.0
29640,Rendezvous in Kiruna,148,0,148,2013.csv,2013,0.0,1.0
29641,Zebra Life,147,0,147,2020.csv,2020,0.0,1.0
29642,Ciudad sin sombra,146,0,146,2016.csv,2016,0.0,1.0
29643,The Hour of the Lynx 2014 Re-release,146,0,146,2014.csv,2014,0.0,1.0
29644,Lep pozdrav iz svobodnih gozdov,146,0,146,2019.csv,2019,0.0,1.0
29645,50 Chuseok,143,0,143,2019.csv,2019,0.0,1.0
29646,Granada y al Paraíso,142,0,142,2015.csv,2015,0.0,1.0
29647,"Love, Plastic and Noise",142,0,142,2020.csv,2020,0.0,1.0
29648,Escuela Monte,141,0,141,2019.csv,2019,0.0,1.0
29649,Mercedes Sosa: The Voice of Latin America 2015 Re-release,140,0,140,2015.csv,2015,0.0,1.0
29650,Corsarios,140,0,140,2015.csv,2015,0.0,1.0
29651,El Secreto de Julia,140,0,140,2019.csv,2019,0.0,1.0
29652,Deviation,140,0,140,2012.csv,2012,0.0,1.0
29653,Billie Eilish: The World's a Little Blurry,139,0,139,2021.csv,2021,0.0,1.0
29654,Estilo Libre,138,0,138,2017.csv,2017,0.0,1.0
29655,Whiskey with Vodka 2012 Re-release,137,0,137,2012.csv,2012,0.0,1.0
29656,Darling,137,0,137,2020.csv,2020,0.0,1.0
29657,Güller,134,0,134,2019.csv,2019,0.0,1.0
29658,Mataram meu irmão,134,0,134,2013.csv,2013,0.0,1.0
29659,Lemmy,131,0,131,2010.csv,2010,0.0,1.0
29660,Kid Kulafu,131,0,131,2016.csv,2016,0.0,1.0
29661,"Juana Azurduy, Guerrillera de la Patria Grande 2018 Re-release",130,0,130,2018.csv,2018,0.0,1.0
29662,Sweet Alibis 2016 Re-release,129,0,129,2016.csv,2016,0.0,1.0
29663,Miss Kicki,129,0,129,2011.csv,2011,0.0,1.0
29664,Onun Filmi,126,0,126,2019.csv,2019,0.0,1.0
29665,Diary of a Chambermaid 2020 Re-release,126,0,126,2020.csv,2020,0.0,1.0
29666,La siesta del tigre,124,0,124,2017.csv,2017,0.0,1.0
29667,Paddington 2 2020 Re-release,122,0,122,2020.csv,2020,0.0,1.0
29668,Hard Paint,122,0,122,2019.csv,2019,0.0,1.0
29669,"Mummy, I'm A Zombie",120,120,0,2014.csv,2014,1.0,0.0
29670,The Devil Is a Woman 2020 Re-release,120,0,120,2020.csv,2020,0.0,1.0
29671,Robotropolis,118,0,118,2011.csv,2011,0.0,1.0
29672,C'est l'amour,118,0,118,2016.csv,2016,0.0,1.0
29673,Coincoin and the Extra-Humans,117,0,117,2019.csv,2019,0.0,1.0
29674,Searching for Sugar Man 2020 Re-release,115,0,115,2020.csv,2020,0.0,1.0
29675,The Future Perfect,115,0,115,2017.csv,2017,0.0,1.0
29676,Damn Summer,114,0,114,2011.csv,2011,0.0,1.0
29677,Some Guy Who Kills People,113,0,113,2012.csv,2012,0.0,1.0
29678,Wik,113,0,113,2017.csv,2017,0.0,1.0
29679,Reverberatsiya,112,0,112,2017.csv,2017,0.0,1.0
29680,Sao Paulo Companhia De Danca,108,0,108,2012.csv,2012,0.0,1.0
29681,Diapason,107,0,107,2020.csv,2020,0.0,1.0
29682,The Ivory Game,105,0,105,2016.csv,2016,0.0,1.0
29683,Young Wrestlers,105,0,105,2016.csv,2016,0.0,1.0
29684,Porno Melodrama,105,0,105,2011.csv,2011,0.0,1.0
29685,Luz en la copa,104,0,104,2017.csv,2017,0.0,1.0
29686,The Clowns,102,0,102,2020.csv,2020,0.0,1.0
29687,El hombre que quiso ser Segundo,102,0,102,2015.csv,2015,0.0,1.0
29688,Cherry Pie,102,0,102,2015.csv,2015,0.0,1.0
29689,The Boss: Anatomy of a Crime,102,0,102,2015.csv,2015,0.0,1.0
29690,Rezo 2020 Re-release,101,0,101,2020.csv,2020,0.0,1.0
29691,Elementa,101,0,101,2020.csv,2020,0.0,1.0
29692,Hugo Paco Luis y tres chicas de rosa,100,0,100,2018.csv,2018,0.0,1.0
29693,Brothers 2020 Re-release,100,0,100,2020.csv,2020,0.0,1.0
29694,Pagliacci,99,0,99,2019.csv,2019,0.0,1.0
29695,Fists of Righteous Harmony,95,0,95,2020.csv,2020,0.0,1.0
29696,The Comedian's Guide to Survival,95,0,95,2016.csv,2016,0.0,1.0
29697,Swchwrm,94,0,94,2012.csv,2012,0.0,1.0
29698,We're No Angels,94,0,94,2020.csv,2020,0.0,1.0
29699,The Chills: The Triumph and Tragedy of Martin Phillipps,92,0,92,2019.csv,2019,0.0,1.0
29700,Pappa pia,92,0,92,2020.csv,2020,0.0,1.0
29701,Vanishing Waves,91,0,91,2015.csv,2015,0.0,1.0
29702,Zip & Zap and the Marble Gang 2017 Re-release,88,0,88,2017.csv,2017,0.0,1.0
29703,Canción perdida en la nieve,88,0,88,2016.csv,2016,0.0,1.0
29704,Billy Liar 2020 Re-release,87,0,87,2020.csv,2020,0.0,1.0
29705,Amor Viajero,87,0,87,2018.csv,2018,0.0,1.0
29706,Cycles,86,0,86,2019.csv,2019,0.0,1.0
29707,Lapsus,84,0,84,2017.csv,2017,0.0,1.0
29708,The Missing Picture 2018 Re-release,83,0,83,2018.csv,2018,0.0,1.0
29709,The Whiskey Bandit 2020 Re-release,82,0,82,2020.csv,2020,0.0,1.0
29710,Opera Australia: Aida,80,0,80,2020.csv,2020,0.0,1.0
29711,Paranoid Girls,78,78,0,2015.csv,2015,1.0,0.0
29712,Superman 2020 Re-release,78,0,78,2020.csv,2020,0.0,1.0
29713,Story of My Death,77,0,77,2016.csv,2016,0.0,1.0
29714,Malaal,76,0,76,2019.csv,2019,0.0,1.0
29715,Ice Station Zebra,76,0,76,2020.csv,2020,0.0,1.0
29716,A Chef's Voyage,75,0,75,2020.csv,2020,0.0,1.0
29717,Little White Lie,74,0,74,2017.csv,2017,0.0,1.0
29718,Atrocious,74,0,74,2018.csv,2018,0.0,1.0
29719,Confession of a Child of the Century 2015 Re-release,74,74,0,2015.csv,2015,1.0,0.0
29720,Un Film Dramatique,73,0,73,2020.csv,2020,0.0,1.0
29721,In Their Sleep,73,0,73,2011.csv,2011,0.0,1.0
29722,Better Things,72,0,72,2018.csv,2018,0.0,1.0
29723,Capture Kill Release,72,0,72,2016.csv,2016,0.0,1.0
29724,Ma 2020 Re-release,72,0,72,2020.csv,2020,0.0,1.0
29725,True Romance 2020 Re-release,72,0,72,2020.csv,2020,0.0,1.0
29726,Casa Grande 2020 Re-release,71,0,71,2020.csv,2020,0.0,1.0
29727,La Memoria de mi Padre,69,0,69,2018.csv,2018,0.0,1.0
29728,The Sweet Sins of Sexy Susan 2016 Re-release,68,0,68,2016.csv,2016,0.0,1.0
29729,October Sky 2020 Re-release,68,0,68,2020.csv,2020,0.0,1.0
29730,Darkest Hour 2020 Re-release,67,0,67,2020.csv,2020,0.0,1.0
29731,Bros: After The Screaming Stops,64,0,64,2018.csv,2018,0.0,1.0
29732,La vida que te agenciaste,63,0,63,2018.csv,2018,0.0,1.0
29733,The Colony 2016 Re-release,62,0,62,2016.csv,2016,0.0,1.0
29734,Leo's Room 2012 Re-release,62,0,62,2012.csv,2012,0.0,1.0
29735,Amazona 2019 Re-release,61,0,61,2019.csv,2019,0.0,1.0
29736,Sunt însarcinatá în România (Pregnant in Romania),60,0,60,2018.csv,2018,0.0,1.0
29737,Destination Wedding 2020 Re-release,60,0,60,2020.csv,2020,0.0,1.0
29738,Detrás del mito,59,0,59,2016.csv,2016,0.0,1.0
29739,400 Days,58,0,58,2016.csv,2016,0.0,1.0
29740,The Australian Ballet: Spartacus,57,0,57,2020.csv,2020,0.0,1.0
29741,Trilece,55,0,55,2018.csv,2018,0.0,1.0
29742,The Scarlet Empress 2020 Re-release,54,0,54,2020.csv,2020,0.0,1.0
29743,Against the Sun 2016 Re-release,52,0,52,2016.csv,2016,0.0,1.0
29744,7 Lives,51,0,51,2011.csv,2011,0.0,1.0
29745,Dangerous Game,50,0,50,2017.csv,2017,0.0,1.0
29746,Güzel Ask,50,0,50,2019.csv,2019,0.0,1.0
29747,Lawless 2015 Re-release,48,0,48,2015.csv,2015,0.0,1.0
29748,Doua lumi in muzica,46,0,46,2011.csv,2011,0.0,1.0
29749,Sunshine Family,43,0,43,2019.csv,2019,0.0,1.0
29750,Thunderball 2020 Re-release,43,0,43,2020.csv,2020,0.0,1.0
29751,The Black Forest,43,0,43,2019.csv,2019,0.0,1.0
29752,La caja de arriba del ropero,43,0,43,2017.csv,2017,0.0,1.0
29753,Urvi,42,0,42,2017.csv,2017,0.0,1.0
29754,The Metropolitan Opera HD Live: Met Opera: Tosca,41,0,41,2020.csv,2020,0.0,1.0
29755,Ensayo de despedida,41,0,41,2017.csv,2017,0.0,1.0
29756,The Movement,40,0,40,2016.csv,2016,0.0,1.0
29757,Allure,39,0,39,2018.csv,2018,0.0,1.0
29758,Mist,39,0,39,2018.csv,2018,0.0,1.0
29759,Ayaz,38,0,38,2017.csv,2017,0.0,1.0
29760,The Marker,37,0,37,2017.csv,2017,0.0,1.0
29761,Fearing Future,35,0,35,2019.csv,2019,0.0,1.0
29762,Older Than America,32,0,32,2012.csv,2012,0.0,1.0
29763,Alien 2017 Re-release,32,0,32,2017.csv,2017,0.0,1.0
29764,The Prime of Miss Jean Brodie,30,0,30,2020.csv,2020,0.0,1.0
29765,Ramta Jogi,29,0,29,2015.csv,2015,0.0,1.0
29766,Santikhiri Sonata,28,0,28,2020.csv,2020,0.0,1.0
29767,When Death Plays Dice,28,0,28,2016.csv,2016,0.0,1.0
29768,American Hero 2017 Re-release,27,0,27,2017.csv,2017,0.0,1.0
29769,Kaçis,26,0,26,2016.csv,2016,0.0,1.0
29770,Antrum: The Deadliest Film Ever Made,26,0,26,2020.csv,2020,0.0,1.0
29771,El Maltrecho,25,0,25,2016.csv,2016,0.0,1.0
29772,Inbred,24,0,24,2012.csv,2012,0.0,1.0
29773,Eagle Hunter's Son,23,0,23,2010.csv,2010,0.0,1.0
29774,Flamingo,21,0,21,2020.csv,2020,0.0,1.0
29775,Ebedi Uykusuz,20,0,20,2019.csv,2019,0.0,1.0
29776,Up 2020 Re-release,20,0,20,2020.csv,2020,0.0,1.0
29777,Pelican Blood,19,0,19,2020.csv,2020,0.0,1.0
29778,Kan Parasi,17,0,17,2018.csv,2018,0.0,1.0
29779,Road to La Paz,17,0,17,2016.csv,2016,0.0,1.0
29780,Kirikou and the Men and Women 2015 Re-release,17,0,17,2015.csv,2015,0.0,1.0
29781,La gracia del muerto,15,0,15,2016.csv,2016,0.0,1.0
29782,Deep 2020 Re-release,15,0,15,2020.csv,2020,0.0,1.0
29783,Dead Heart,13,0,13,2016.csv,2016,0.0,1.0
29784,Time Freak 2020 Re-release,12,0,12,2020.csv,2020,0.0,1.0
29785,Eva,10,0,10,2020.csv,2020,0.0,1.0
29786,Stalker 2020 Re-release,9,0,9,2020.csv,2020,0.0,1.0
29787,Before Everest,9,0,9,2020.csv,2020,0.0,1.0
29788,Solaris 2020 Re-release,6,0,6,2020.csv,2020,0.0,1.0
29789,ASYA,2,0,2,2017.csv,2017,0.0,1.0
